Game Id;PlayerId;TeamId;Game Rating;SA;GA;SV;SV%;TOI;PIM
49179;1222;10;74;38;4;34;.895;3589700;0
49179;1664;31;96;35;2;33;.943;3600000;0
49179;2965;31;0;0;0;0;.00nan;0;0
49179;6527;10;0;0;0;0;.00nan;0;0
50166;442;12;93;30;1;29;.967;3600000;0
50166;879;124;0;0;0;0;.00nan;0;0
50166;1658;124;92;48;4;44;.917;3600000;0
50166;5889;12;0;0;0;0;.00nan;0;0
49167;150;26;79;29;2;27;.931;3811250;0
49167;830;26;0;0;0;0;.00nan;0;0
49167;864;3;94;51;3;48;.941;3811250;0
49167;1893;3;0;0;0;0;.00nan;0;0
50167;384;21;75;39;4;35;.897;3600000;0
50167;540;21;0;0;0;0;.00nan;0;0
50167;904;29;85;25;1;24;.960;3600000;0
50167;3462;29;0;0;0;0;.00nan;0;0
49168;933;19;90;33;2;31;.939;3600000;0
49168;1615;19;0;0;0;0;.00nan;0;0
49168;5944;23;0;0;0;0;.00nan;0;0
49168;6515;23;77;40;4;36;.900;3585950;0
49165;530;28;0;0;0;0;.00nan;0;0
49165;862;2;72;18;1;17;.944;3600000;0
49165;1275;28;41;32;6;26;.813;3600000;0
49165;5935;2;0;0;0;0;.00nan;0;0
49198;945;30;78;26;2;24;.923;3600000;0
49198;1021;30;0;0;0;0;.00nan;0;0
49198;1294;9;0;0;0;0;.00nan;0;0
49198;5934;9;75;32;3;29;.906;3567800;0
50187;690;152;0;0;0;0;.00nan;0;0
50187;1652;0;0;0;0;0;.00nan;0;0
50187;5950;152;59;29;4;25;.862;3582500;0
50187;6446;0;78;33;3;30;.909;3600000;0
49174;613;20;0;0;0;0;.00nan;0;0
49174;762;25;81;47;5;42;.894;3600000;0
49174;952;20;76;25;2;23;.920;3600000;0
49174;3273;25;0;0;0;0;.00nan;0;0
49178;384;21;0;0;0;0;.00nan;0;0
49178;540;21;71;37;4;33;.892;3516350;0
49178;613;20;84;29;2;27;.931;3600000;0
49178;952;20;0;0;0;0;.00nan;0;0
49175;703;1;97;41;2;39;.951;3900000;0
49175;904;29;0;0;0;0;.00nan;0;0
49175;3462;29;100;38;2;36;.947;3900000;0
49175;3513;1;0;0;0;0;.00nan;0;0
49195;442;12;0;0;0;0;.00nan;0;0
49195;567;24;0;0;0;0;.00nan;0;0
49195;1828;24;79;46;5;41;.891;3545850;0
49195;5889;12;78;39;4;35;.897;3600000;0
49189;1064;7;0;0;0;0;.00nan;0;0
49189;1294;9;81;46;5;41;.891;3900000;0
49189;1651;7;47;30;5;25;.833;3900000;0
49189;5934;9;0;0;0;0;.00nan;0;0
49185;929;8;60;30;4;26;.867;3525900;0
49185;2123;8;0;0;0;0;.00nan;0;0
49185;2664;17;0;0;0;0;.00nan;0;0
49185;5872;17;91;34;2;32;.941;3600000;0
49327;690;152;82;24;1;23;.958;3600000;0
49327;1652;0;54;33;5;28;.848;3600000;0
49327;5950;152;0;0;0;0;.00nan;0;0
49327;6446;0;0;0;0;0;.00nan;0;0
49164;668;14;65;32;4;28;.875;3600000;0
49164;862;2;0;0;0;0;.00nan;0;0
49164;1218;14;0;0;0;0;.00nan;0;0
49164;5935;2;100;22;0;22;1.000;3600000;0
49166;536;27;88;15;0;15;1.000;3600000;0
49166;879;124;52;32;5;27;.844;2122400;0
49166;1658;124;37;12;3;9;.750;1477600;0
49166;2062;27;0;0;0;0;.00nan;0;0
49190;864;3;0;0;0;0;.00nan;0;0
49190;1222;10;0;0;0;0;.00nan;0;0
49190;1893;3;50;36;6;30;.833;3575650;0
49190;6527;10;65;37;5;32;.865;3600000;0
49172;703;1;0;0;0;0;.00nan;0;0
49172;945;30;71;18;1;17;.944;3063250;0
49172;1021;30;32;9;3;6;.667;536750;0
49172;3513;1;100;25;0;25;1.000;3600000;0
49169;0;18;0;0;0;0;.00nan;0;0
49169;738;18;78;32;3;29;.906;3600000;0
49169;933;19;60;36;5;31;.861;3561800;0
49169;1615;19;0;0;0;0;.00nan;0;0
49410;567;24;66;32;4;28;.875;3600000;0
49410;929;8;0;0;0;0;.00nan;0;0
49410;1828;24;0;0;0;0;.00nan;0;0
49410;2123;8;46;28;5;23;.821;3558550;0
49210;150;26;0;0;0;0;.00nan;0;0
49210;830;26;100;35;1;34;.971;3600000;0
49210;5944;23;0;0;0;0;.00nan;0;0
49210;6515;23;75;31;3;28;.903;3533600;0
49186;613;20;57;29;4;25;.862;2471700;0
49186;945;30;67;15;1;14;.933;3600000;0
49186;952;20;25;11;4;7;.636;1128300;0
49186;1021;30;0;0;0;0;.00nan;0;0
49304;690;152;0;0;0;0;.00nan;0;0
49304;1222;10;94;44;2;42;.955;3744750;0
49304;5950;152;82;24;1;23;.958;3744750;0
49304;6527;10;0;0;0;0;.00nan;0;0
49209;384;21;67;21;2;19;.905;3600000;0
49209;540;21;0;0;0;0;.00nan;0;0
49209;879;124;70;36;4;32;.889;2571050;0
49209;1658;124;33;15;4;11;.733;1028950;0
49160;442;12;0;0;0;0;.00nan;0;0
49160;1064;7;0;0;0;0;.00nan;0;0
49160;1651;7;100;47;3;44;.936;3600000;0
49160;5889;12;61;30;4;26;.867;3587950;0
49170;862;2;0;0;0;0;.00nan;0;0
49170;904;29;74;32;3;29;.906;3555350;0
49170;3462;29;0;0;0;0;.00nan;0;0
49170;5935;2;88;32;2;30;.938;3600000;0
49162;0;18;77;33;3;30;.909;3546650;0
49162;738;18;0;0;0;0;.00nan;0;0
49162;762;25;100;46;2;44;.957;3600000;0
49162;3273;25;0;0;0;0;.00nan;0;0
49163;668;14;91;35;2;33;.943;3549550;0
49163;1218;14;0;0;0;0;.00nan;0;0
49163;2664;17;0;0;0;0;.00nan;0;0
49163;5872;17;100;38;1;37;.974;3600000;0
49171;530;28;93;35;2;33;.943;3600000;0
49171;1275;28;0;0;0;0;.00nan;0;0
49171;1664;31;0;0;0;0;.00nan;0;0
49171;2965;31;91;54;5;49;.907;3600000;0
49161;864;3;0;0;0;0;.00nan;0;0
49161;933;19;0;0;0;0;.00nan;0;0
49161;1615;19;44;27;5;22;.815;3551700;0
49161;1893;3;93;43;3;40;.930;3600000;0
49184;536;27;73;37;4;33;.892;3527650;0
49184;1652;0;0;0;0;0;.00nan;0;0
49184;2062;27;0;0;0;0;.00nan;0;0
49184;6446;0;76;32;3;29;.906;3600000;0
49214;668;14;0;0;0;0;.00nan;0;0
49214;904;29;0;0;0;0;.00nan;0;0
49214;1218;14;91;29;1;28;.966;3600000;0
49214;3462;29;89;39;2;37;.949;3559050;0
49236;1652;0;28;24;6;18;.750;3600000;0
49236;2664;17;100;38;2;36;.947;3600000;0
49236;5872;17;0;0;0;0;.00nan;0;0
49236;6446;0;0;0;0;0;.00nan;0;0
49323;929;8;0;0;0;0;.00nan;0;0
49323;1222;10;0;0;0;0;.00nan;0;0
49323;2123;8;46;21;4;17;.810;3626100;0
49323;6527;10;78;33;3;30;.909;3626100;0
49283;384;21;0;0;0;0;.00nan;0;0
49283;540;21;99;32;1;31;.969;3600000;0
49283;567;24;0;0;0;0;.00nan;0;0
49283;1828;24;74;38;4;34;.895;3600000;0
49177;1294;9;88;27;1;26;.963;3600000;0
49177;1664;31;98;38;2;36;.947;3600000;0
49177;2965;31;0;0;0;0;.00nan;0;0
49177;5934;9;0;0;0;0;.00nan;0;0
49183;442;12;69;16;1;15;.938;3600000;0
49183;879;124;0;0;0;0;.00nan;0;0
49183;1658;124;56;40;6;34;.850;3600000;0
49183;5889;12;0;0;0;0;.00nan;0;0
49188;536;27;0;0;0;0;.00nan;0;0
49188;1064;7;94;36;2;34;.944;3600000;0
49188;1651;7;0;0;0;0;.00nan;0;0
49188;2062;27;96;44;3;41;.932;3561850;0
49181;690;152;75;33;3;30;.909;3597750;0
49181;703;1;0;0;0;0;.00nan;0;0
49181;3513;1;75;26;2;24;.923;3600000;0
49181;5950;152;0;0;0;0;.00nan;0;0
50151;567;24;96;35;1;34;.971;3900000;0
50151;1294;9;0;0;0;0;.00nan;0;0
50151;1828;24;0;0;0;0;.00nan;0;0
50151;5934;9;88;27;1;26;.963;3900000;0
49192;0;18;0;0;0;0;.00nan;0;0
49192;530;28;55;39;6;33;.846;2523550;0
49192;738;18;62;30;4;26;.867;3600000;0
49192;982;28;62;8;0;8;1.000;1046850;0
49219;762;25;88;45;2;43;.956;3881750;0
49219;3273;25;0;0;0;0;.00nan;0;0
49219;5944;23;0;0;0;0;.00nan;0;0
49219;6515;23;61;25;3;22;.880;3881750;0
49610;862;2;0;0;0;0;.00nan;0;0
49610;864;3;53;26;4;22;.846;3600000;0
49610;1893;3;0;0;0;0;.00nan;0;0
49610;5935;2;95;31;1;30;.968;3600000;0
49672;668;14;78;21;1;20;.952;3600000;0
49672;933;19;65;33;4;29;.879;3600000;0
49672;1218;14;0;0;0;0;.00nan;0;0
49672;1615;19;0;0;0;0;.00nan;0;0
50195;2664;17;47;47;8;39;.830;3600000;0
50195;5872;17;0;0;0;0;.00nan;0;0
50195;5944;23;55;25;4;21;.840;3600000;0
50195;6515;23;0;0;0;0;.00nan;0;0
50165;0;18;66;39;5;34;.872;3629800;0
50165;738;18;0;0;0;0;.00nan;0;0
50165;1064;7;0;0;0;0;.00nan;0;0
50165;1651;7;66;43;6;37;.860;3629800;0
49213;384;21;53;15;2;13;.867;2167600;0
49213;540;21;28;25;6;19;.760;1432400;0
49213;1664;31;43;26;5;21;.808;3600000;0
49213;2965;31;0;0;0;0;.00nan;0;0
49223;530;28;100;44;1;43;.977;3600000;0
49223;929;8;0;0;0;0;.00nan;0;0
49223;982;28;0;0;0;0;.00nan;0;0
49223;2123;8;60;24;3;21;.875;3520200;0
50161;567;24;0;0;0;0;.00nan;0;0
50161;864;3;0;0;0;0;.00nan;0;0
50161;1828;24;81;23;1;22;.957;3565900;0
50161;1893;3;100;27;0;27;1.000;3600000;0
49231;945;30;0;0;0;0;.00nan;0;0
49231;1021;30;69;29;3;26;.897;3572150;0
49231;2664;17;0;0;0;0;.00nan;0;0
49231;5872;17;63;18;2;16;.889;3600000;0
49187;613;20;62;13;1;12;.923;1159250;0
49187;952;20;37;30;6;24;.800;2397900;0
49187;1064;7;39;29;6;23;.793;3276400;0
49187;1651;7;59;5;0;5;1.000;323600;0
49206;690;152;0;0;0;0;.00nan;0;0
49206;1294;9;84;31;2;29;.935;3600000;0
49206;5934;9;0;0;0;0;.00nan;0;0
49206;5950;152;79;32;3;29;.906;3600000;0
49196;442;12;91;26;1;25;.962;3600000;0
49196;703;1;32;15;4;11;.733;1122850;0
49196;3513;1;38;24;5;19;.792;2477150;0
49196;5889;12;0;0;0;0;.00nan;0;0
49207;536;27;0;0;0;0;.00nan;0;0
49207;1222;10;53;44;7;37;.841;3600000;0
49207;2062;27;78;27;2;25;.926;3600000;0
49207;6527;10;0;0;0;0;.00nan;0;0
49239;879;124;100;30;0;30;1.000;3600000;0
49239;1652;0;0;0;0;0;.00nan;0;0
49239;1658;124;0;0;0;0;.00nan;0;0
49239;6446;0;74;31;3;28;.903;3600000;0
49194;567;24;46;22;4;18;.818;3600000;0
49194;703;1;100;35;1;34;.971;3600000;0
49194;1828;24;0;0;0;0;.00nan;0;0
49194;3513;1;0;0;0;0;.00nan;0;0
49232;929;8;89;36;2;34;.944;3594050;0
49232;1294;9;0;0;0;0;.00nan;0;0
49232;2123;8;0;0;0;0;.00nan;0;0
49232;5934;9;84;25;1;24;.960;3600000;0
49335;762;25;73;24;2;22;.917;3600000;0
49335;879;124;0;0;0;0;.00nan;0;0
49335;1658;124;70;34;4;30;.882;3599800;0
49335;3273;25;0;0;0;0;.00nan;0;0
49191;384;21;72;37;4;33;.892;3510250;0
49191;540;21;0;0;0;0;.00nan;0;0
49191;933;19;81;29;2;27;.931;3600000;0
49191;1615;19;0;0;0;0;.00nan;0;0
49203;904;29;0;0;0;0;.00nan;0;0
49203;945;30;99;33;1;32;.970;3600000;0
49203;1021;30;0;0;0;0;.00nan;0;0
49203;3462;29;78;28;2;26;.929;3554350;0
49173;862;2;57;16;2;14;.875;3600000;0
49173;5935;2;0;0;0;0;.00nan;0;0
49173;5944;23;0;0;0;0;.00nan;0;0
49173;6515;23;65;33;4;29;.879;3600000;0
49211;442;12;0;0;0;0;.00nan;0;0
49211;536;27;97;37;2;35;.946;3600000;0
49211;2062;27;0;0;0;0;.00nan;0;0
49211;5889;12;76;39;4;35;.897;3522900;0
49200;613;20;91;40;3;37;.925;3600000;0
49200;668;14;0;0;0;0;.00nan;0;0
49200;952;20;0;0;0;0;.00nan;0;0
49200;1218;14;77;38;4;34;.895;3588000;0
49212;530;28;0;0;0;0;.00nan;0;0
49212;690;152;22;9;4;5;.556;1108950;0
49212;982;28;100;42;2;40;.952;3600000;0
49212;5950;152;47;23;4;19;.826;2491050;0
49182;933;19;0;0;0;0;.00nan;0;0
49182;1222;10;98;41;2;39;.951;3600000;0
49182;1615;19;95;18;0;18;1.000;3600000;0
49182;6527;10;0;0;0;0;.00nan;0;0
49201;0;18;0;0;0;0;.00nan;0;0
49201;738;18;25;28;7;21;.750;3600000;0
49201;1652;0;0;0;0;0;.00nan;0;0
49201;6446;0;61;23;3;20;.870;3600000;0
49180;150;26;0;0;0;0;.00nan;0;0
49180;830;26;93;36;2;34;.944;3600000;0
49180;862;2;0;0;0;0;.00nan;0;0
49180;5935;2;56;27;4;23;.852;3540100;0
49199;0;18;74;37;4;33;.892;3600000;0
49199;150;26;90;51;5;46;.902;3562250;0
49199;738;18;0;0;0;0;.00nan;0;0
49199;830;26;0;0;0;0;.00nan;0;0
49193;384;21;0;0;0;0;.00nan;0;0
49193;443;3;97;44;3;41;.932;3600000;0
49193;540;21;71;36;4;32;.889;3558550;0
49193;1893;3;0;0;0;0;.00nan;0;0
49176;703;1;0;0;0;0;.00nan;0;0
49176;904;29;75;25;2;23;.920;3600000;0
49176;3462;29;0;0;0;0;.00nan;0;0
49176;3513;1;93;46;3;43;.935;3562050;0
49216;530;28;64;38;5;33;.868;3600000;0
49216;762;25;0;0;0;0;.00nan;0;0
49216;982;28;0;0;0;0;.00nan;0;0
49216;3273;25;96;35;2;33;.943;3600000;0
49224;613;20;0;0;0;0;.00nan;0;0
49224;952;20;55;29;4;25;.862;3900000;0
49224;1064;7;0;0;0;0;.00nan;0;0
49224;1651;7;78;37;4;33;.892;3900000;0
49248;1652;0;57;40;6;34;.850;3600000;0
49248;5944;23;76;26;2;24;.923;3600000;0
49248;6446;0;0;0;0;0;.00nan;0;0
49248;6515;23;0;0;0;0;.00nan;0;0
49208;567;24;0;0;0;0;.00nan;0;0
49208;1664;31;0;0;0;0;.00nan;0;0
49208;1828;24;60;36;5;31;.861;3600000;0
49208;2965;31;100;39;0;39;1.000;3600000;0
49332;1222;10;42;38;7;31;.816;2321450;0
49332;2664;17;0;0;0;0;.00nan;0;0
49332;5872;17;74;24;2;22;.917;3600000;0
49332;6527;10;68;11;0;11;1.000;1278550;0
49242;690;152;93;34;2;32;.941;3600000;0
49242;1064;7;80;36;3;33;.917;3540900;0
49242;1651;7;0;0;0;0;.00nan;0;0
49242;5950;152;0;0;0;0;.00nan;0;0
49197;862;2;90;28;1;27;.964;3600000;0
49197;929;8;20;25;7;18;.720;3600000;0
49197;2123;8;0;0;0;0;.00nan;0;0
49197;5935;2;0;0;0;0;.00nan;0;0
49226;443;3;92;34;2;32;.941;1898000;0
49226;668;14;43;39;7;32;.821;3738200;0
49226;1218;14;0;0;0;0;.00nan;0;0
49226;1893;3;34;28;6;22;.786;1840200;0
49271;1294;9;91;44;3;41;.932;3900000;0
49271;1664;31;84;38;3;35;.921;3900000;0
49271;2965;31;0;0;0;0;.00nan;0;0
49271;5934;9;0;0;0;0;.00nan;0;0
49222;536;27;94;52;4;48;.923;3600000;0
49222;904;29;0;0;0;0;.00nan;0;0
49222;2062;27;0;0;0;0;.00nan;0;0
49222;3462;29;100;34;1;33;.971;3600000;0
49204;442;12;42;26;5;21;.808;3600000;0
49204;933;19;100;33;0;33;1.000;3600000;0
49204;1615;19;0;0;0;0;.00nan;0;0
49204;5889;12;0;0;0;0;.00nan;0;0
49217;0;18;0;0;0;0;.00nan;0;0
49217;738;18;81;29;2;27;.931;3559200;0
49217;945;30;93;30;1;29;.967;3600000;0
49217;1021;30;0;0;0;0;.00nan;0;0
49549;150;26;0;0;0;0;.00nan;0;0
49549;830;26;84;43;4;39;.907;3900000;0
49549;5944;23;0;0;0;0;.00nan;0;0
49549;6515;23;69;33;4;29;.879;3900000;0
49329;567;24;0;0;0;0;.00nan;0;0
49329;1828;24;77;21;1;20;.952;3600000;0
49329;2664;17;64;42;6;36;.857;3600000;0
49329;5872;17;0;0;0;0;.00nan;0;0
49724;703;1;84;20;0;20;1.000;2683900;0
49724;929;8;89;27;1;26;.963;3600000;0
49724;2123;8;0;0;0;0;.00nan;0;0
49724;3513;1;31;14;4;10;.714;916100;0
49383;762;25;54;41;6;35;.854;3787750;0
49383;879;124;0;0;0;0;.00nan;0;0
49383;1658;124;52;41;7;34;.829;3809700;0
49383;3273;25;0;0;0;0;.00nan;0;0
50186;384;21;0;0;0;0;.00nan;0;0
50186;442;12;70;29;3;26;.897;3600000;0
50186;540;21;62;37;5;32;.865;3575200;0
50186;5889;12;0;0;0;0;.00nan;0;0
50182;879;124;89;39;3;36;.923;3600000;0
50182;1652;0;0;0;0;0;.00nan;0;0
50182;1658;124;0;0;0;0;.00nan;0;0
50182;6446;0;48;30;5;25;.833;3532600;0
49220;443;3;60;36;5;31;.861;3570050;0
49220;668;14;0;0;0;0;.00nan;0;0
49220;1218;14;79;34;3;31;.912;3600000;0
49220;1893;3;0;0;0;0;.00nan;0;0
49991;862;2;60;36;5;31;.861;3600000;0
49991;933;19;100;36;1;35;.972;3600000;0
49991;1615;19;0;0;0;0;.00nan;0;0
49991;5935;2;0;0;0;0;.00nan;0;0
50178;613;20;57;21;3;18;.857;3599200;0
50178;762;25;0;0;0;0;.00nan;0;0
50178;952;20;0;0;0;0;.00nan;0;0
50178;3273;25;88;33;2;31;.939;3608750;0
49259;929;8;74;22;1;21;.955;2812400;0
49259;1064;7;0;0;0;0;.00nan;0;0
49259;1651;7;73;40;5;35;.875;3900000;0
49259;2123;8;35;17;4;13;.765;1087600;0
49277;530;28;91;36;2;34;.944;3568150;0
49277;945;30;0;0;0;0;.00nan;0;0
49277;982;28;0;0;0;0;.00nan;0;0
49277;1021;30;73;18;1;17;.944;3600000;0
49289;536;27;0;0;0;0;.00nan;0;0
49289;1222;10;0;0;0;0;.00nan;0;0
49289;2062;27;68;34;4;30;.882;3900000;0
49289;6527;10;89;45;4;41;.911;3900000;0
50214;442;12;74;31;3;28;.903;3600000;0
50214;904;29;100;31;0;31;1.000;3600000;0
50214;3462;29;0;0;0;0;.00nan;0;0
50214;5889;12;0;0;0;0;.00nan;0;0
49298;384;21;0;0;0;0;.00nan;0;0
49298;540;21;86;32;2;30;.938;3600000;0
49298;2664;17;0;0;0;0;.00nan;0;0
49298;5872;17;85;36;3;33;.917;3540200;0
49246;690;152;0;0;0;0;.00nan;0;0
49246;5944;23;70;29;3;26;.897;3572100;0
49246;5950;152;100;35;1;34;.971;3600000;0
49246;6515;23;0;0;0;0;.00nan;0;0
49237;443;3;97;27;0;27;1.000;2400200;0
49237;1664;31;0;0;0;0;.00nan;0;0
49237;1893;3;26;12;4;8;.667;1181200;0
49237;2965;31;66;20;2;18;.900;3600000;0
49221;567;24;0;0;0;0;.00nan;0;0
49221;703;1;0;0;0;0;.00nan;0;0
49221;1828;24;100;27;0;27;1.000;3600000;0
49221;3513;1;67;22;2;20;.909;3495550;0
50203;530;28;0;0;0;0;.00nan;0;0
50203;982;28;81;42;4;38;.905;3900000;0
50203;5944;23;0;0;0;0;.00nan;0;0
50203;6515;23;86;44;4;40;.909;3900000;0
49309;442;12;0;0;0;0;.00nan;0;0
49309;879;124;0;0;0;0;.00nan;0;0
49309;1658;124;52;38;6;32;.842;3600000;0
49309;5889;12;67;21;2;19;.905;3600000;0
49240;150;26;0;0;0;0;.00nan;0;0
49240;384;21;100;40;0;40;1.000;3600000;0
49240;540;21;0;0;0;0;.00nan;0;0
49240;830;26;98;39;2;37;.949;3563100;0
49225;613;20;58;29;4;25;.862;3585450;0
49225;703;1;100;44;2;42;.955;3600000;0
49225;952;20;0;0;0;0;.00nan;0;0
49225;3513;1;0;0;0;0;.00nan;0;0
49228;668;14;77;27;2;25;.926;3600000;0
49228;1218;14;0;0;0;0;.00nan;0;0
49228;1222;10;57;41;6;35;.854;3600000;0
49228;6527;10;0;0;0;0;.00nan;0;0
49257;762;25;78;34;3;31;.912;3513900;0
49257;929;8;88;32;2;30;.938;3600000;0
49257;2123;8;0;0;0;0;.00nan;0;0
49257;3273;25;0;0;0;0;.00nan;0;0
49247;0;18;81;35;3;32;.914;3578000;0
49247;738;18;0;0;0;0;.00nan;0;0
49247;1294;9;93;34;2;32;.941;3600000;0
49247;5934;9;0;0;0;0;.00nan;0;0
49261;690;152;43;33;6;27;.818;3600000;0
49261;1652;0;0;0;0;0;.00nan;0;0
49261;5950;152;0;0;0;0;.00nan;0;0
49261;6446;0;68;34;4;30;.882;3600000;0
49255;536;27;97;32;1;31;.969;3600000;0
49255;904;29;0;0;0;0;.00nan;0;0
49255;2062;27;0;0;0;0;.00nan;0;0
49255;3462;29;80;41;4;37;.902;3600000;0
49202;567;24;0;0;0;0;.00nan;0;0
49202;862;2;92;36;2;34;.944;3553100;0
49202;1828;24;100;34;0;34;1.000;3600000;0
49202;5935;2;0;0;0;0;.00nan;0;0
49241;933;19;34;16;4;12;.750;718600;0
49241;1615;19;80;35;3;32;.914;2881400;0
49241;1664;31;87;25;1;24;.960;3600000;0
49241;2965;31;0;0;0;0;.00nan;0;0
49366;879;124;66;38;5;33;.868;3600000;0
49366;1064;7;0;0;0;0;.00nan;0;0
49366;1651;7;100;25;0;25;1.000;3600000;0
49366;1658;124;0;0;0;0;.00nan;0;0
49258;150;26;0;0;0;0;.00nan;0;0
49258;703;1;0;0;0;0;.00nan;0;0
49258;830;26;92;17;0;17;1.000;3600000;0
49258;3513;1;64;25;3;22;.880;3600000;0
49229;443;3;0;0;0;0;.00nan;0;0
49229;762;25;80;28;2;26;.929;3600000;0
49229;1893;3;78;34;3;31;.912;3593900;0
49229;3273;25;0;0;0;0;.00nan;0;0
50130;567;24;0;0;0;0;.00nan;0;0
50130;1064;7;0;0;0;0;.00nan;0;0
50130;1651;7;59;29;4;25;.862;3600000;0
50130;1828;24;91;28;1;27;.964;3600000;0
49233;668;14;71;35;4;31;.886;3547100;0
49233;1218;14;0;0;0;0;.00nan;0;0
49233;1294;9;72;30;3;27;.900;3600000;0
49233;5934;9;0;0;0;0;.00nan;0;0
49249;442;12;0;0;0;0;.00nan;0;0
49249;690;152;0;0;0;0;.00nan;0;0
49249;5889;12;61;18;2;16;.889;3600000;0
49249;5950;152;51;31;5;26;.839;3600000;0
49265;384;21;88;40;3;37;.925;3740100;0
49265;540;21;0;0;0;0;.00nan;0;0
49265;945;30;0;0;0;0;.00nan;0;0
49265;1021;30;76;26;2;24;.923;3740100;0
49205;862;2;70;23;2;21;.913;3600000;0
49205;933;19;82;36;3;33;.917;3551800;0
49205;1615;19;0;0;0;0;.00nan;0;0
49205;5935;2;0;0;0;0;.00nan;0;0
49320;1664;31;0;0;0;0;.00nan;0;0
49320;2664;17;45;27;5;22;.815;2256150;0
49320;2965;31;60;17;2;15;.882;3600000;0
49320;5872;17;43;9;2;7;.778;1343850;0
49251;0;18;97;44;3;41;.932;3600000;0
49251;530;28;73;37;4;33;.892;3562800;0
49251;738;18;0;0;0;0;.00nan;0;0
49251;982;28;0;0;0;0;.00nan;0;0
49227;904;29;25;11;4;7;.636;517550;0
49227;1652;0;61;23;3;20;.870;3600000;0
49227;3462;29;62;20;2;18;.900;3082450;0
49227;6446;0;0;0;0;0;.00nan;0;0
49267;613;20;0;0;0;0;.00nan;0;0
49267;762;25;0;0;0;0;.00nan;0;0
49267;952;20;69;35;4;31;.886;3597700;0
49267;3273;25;73;29;3;26;.897;3600000;0
49215;862;2;0;0;0;0;.00nan;0;0
49215;1652;0;0;0;0;0;.00nan;0;0
49215;5935;2;62;32;4;28;.875;3600000;0
49215;6446;0;83;30;2;28;.933;3600000;0
49307;536;27;67;28;3;25;.893;3600000;0
49307;2062;27;0;0;0;0;.00nan;0;0
49307;2664;17;0;0;0;0;.00nan;0;0
49307;5872;17;100;41;2;39;.951;3600000;0
49621;879;124;0;0;0;0;.00nan;0;0
49621;1658;124;82;47;5;42;.894;3600000;0
49621;5944;23;68;22;2;20;.909;3600000;0
49621;6515;23;0;0;0;0;.00nan;0;0
49256;443;3;80;47;5;42;.894;3600000;0
49256;929;8;67;33;4;29;.879;3600000;0
49256;1893;3;0;0;0;0;.00nan;0;0
49256;2123;8;0;0;0;0;.00nan;0;0
49245;442;12;83;47;5;42;.894;3900000;0
49245;530;28;61;18;1;17;.944;969900;0
49245;982;28;64;32;4;28;.875;2930100;0
49245;5889;12;0;0;0;0;.00nan;0;0
49244;668;14;0;0;0;0;.00nan;0;0
49244;945;30;54;26;4;22;.846;3600000;0
49244;1021;30;0;0;0;0;.00nan;0;0
49244;1218;14;67;39;5;34;.872;3546750;0
49300;150;26;0;0;0;0;.00nan;0;0
49300;830;26;65;27;3;24;.889;3561100;0
49300;1064;7;0;0;0;0;.00nan;0;0
49300;1651;7;78;27;2;25;.926;3600000;0
50193;690;152;0;0;0;0;.00nan;0;0
50193;879;124;87;43;4;39;.907;3900000;0
50193;1658;124;0;0;0;0;.00nan;0;0
50193;5950;152;65;30;4;26;.867;3900000;0
49234;567;24;0;0;0;0;.00nan;0;0
49234;933;19;58;28;4;24;.857;3555050;0
49234;1615;19;0;0;0;0;.00nan;0;0
49234;1828;24;59;23;3;20;.870;3600000;0
50171;536;27;0;0;0;0;.00nan;0;0
50171;703;1;0;0;0;0;.00nan;0;0
50171;2062;27;86;32;2;30;.938;3600000;0
50171;3513;1;68;35;4;31;.886;3525100;0
49279;0;18;100;25;0;25;1.000;3600000;0
49279;738;18;0;0;0;0;.00nan;0;0
49279;1222;10;50;31;5;26;.839;3600000;0
49279;6527;10;0;0;0;0;.00nan;0;0
49238;613;20;83;54;5;49;.907;3572400;0
49238;904;29;0;0;0;0;.00nan;0;0
49238;952;20;0;0;0;0;.00nan;0;0
49238;3462;29;66;25;3;22;.880;3600000;0
49416;1294;9;75;31;3;28;.903;3600000;0
49416;5934;9;0;0;0;0;.00nan;0;0
49416;5944;23;0;0;0;0;.00nan;0;0
49416;6515;23;61;37;5;32;.865;3600000;0
50215;933;19;68;28;3;25;.893;3600000;0
50215;1615;19;0;0;0;0;.00nan;0;0
50215;2664;17;48;6;1;5;.833;833550;0
50215;5872;17;31;25;6;19;.760;2766450;0
50218;762;25;89;51;4;47;.922;3450200;0
50218;929;8;70;23;2;21;.913;3600000;0
50218;3273;25;0;0;0;0;.00nan;0;0
50218;5430;8;0;0;0;0;.00nan;0;0
50204;862;2;72;30;3;27;.900;3600000;0
50204;945;30;100;34;0;34;1.000;3600000;0
50204;1021;30;0;0;0;0;.00nan;0;0
50204;5935;2;0;0;0;0;.00nan;0;0
49314;150;26;50;7;1;6;.857;1343350;0
49314;830;26;40;30;6;24;.800;2256650;0
49314;1294;9;0;0;0;0;.00nan;0;0
49314;5934;9;74;19;1;18;.947;3600000;0
49286;384;21;70;42;5;37;.881;3279050;0
49286;442;12;99;32;1;31;.969;3600000;0
49286;540;21;21;3;3;0;.000;320950;0
49286;5889;12;0;0;0;0;.00nan;0;0
49260;668;14;0;0;0;0;.00nan;0;0
49260;1218;14;80;47;5;42;.894;3600000;0
49260;5944;23;0;0;0;0;.00nan;0;0
49260;6515;23;71;35;4;31;.886;3600000;0
49471;613;20;0;0;0;0;.00nan;0;0
49471;952;20;70;28;3;25;.893;3600000;0
49471;1222;10;50;7;1;6;.857;881650;0
49471;6527;10;32;26;6;20;.769;2718350;0
50169;443;3;72;23;2;21;.913;3600000;0
50169;1064;7;58;46;7;39;.848;3600000;0
50169;1651;7;0;0;0;0;.00nan;0;0
49297;703;1;36;46;9;37;.804;3162550;0
49297;904;29;48;29;5;24;.828;3600000;0
49297;3462;29;0;0;0;0;.00nan;0;0
49297;3513;1;55;4;0;4;1.000;437450;0
49395;879;124;48;36;6;30;.833;2359000;0
49395;1658;124;40;7;2;5;.714;1241000;0
49395;1664;31;85;25;1;24;.960;3600000;0
49395;2965;31;0;0;0;0;.00nan;0;0
49312;0;18;100;23;0;23;1.000;3600000;0
49312;690;152;0;0;0;0;.00nan;0;0
49312;738;18;0;0;0;0;.00nan;0;0
49312;5950;152;38;41;8;33;.805;3600000;0
49218;862;2;68;32;4;28;.875;3900000;0
49218;1064;7;0;0;0;0;.00nan;0;0
49218;1651;7;82;45;4;41;.911;3900000;0
49218;5935;2;0;0;0;0;.00nan;0;0
49230;904;29;50;13;2;11;.846;1567100;0
49230;1652;0;67;33;4;29;.879;3600000;0
49230;3462;29;22;21;6;15;.714;2032900;0
49230;6446;0;0;0;0;0;.00nan;0;0
50129;1222;10;30;26;6;20;.769;2163750;0
50129;2664;17;0;0;0;0;.00nan;0;0
50129;5872;17;79;22;1;21;.955;3600000;0
50129;6527;10;51;7;1;6;.857;1436250;0
49252;668;14;87;43;4;39;.907;3600000;0
49252;690;152;25;5;3;2;.400;564550;0
49252;1218;14;0;0;0;0;.00nan;0;0
49252;5950;152;95;37;2;35;.946;2999650;0
49262;443;3;94;42;3;39;.929;3566150;0
49262;879;124;0;0;0;0;.00nan;0;0
49262;1658;124;95;37;2;35;.946;3600000;0
49266;530;28;82;42;4;38;.905;3583800;0
49266;929;8;84;30;2;28;.933;3600000;0
49266;982;28;0;0;0;0;.00nan;0;0
49266;5430;8;0;0;0;0;.00nan;0;0
49299;384;21;0;0;0;0;.00nan;0;0
49299;540;21;25;35;8;27;.771;3600000;0
49299;567;24;0;0;0;0;.00nan;0;0
49299;1828;24;97;38;2;36;.947;3600000;0
49264;933;19;53;20;3;17;.850;3560300;0
49264;945;30;0;0;0;0;.00nan;0;0
49264;1021;30;61;18;2;16;.889;3600000;0
49264;1615;19;0;0;0;0;.00nan;0;0
49278;536;27;64;31;4;27;.871;3600000;0
49278;762;25;17;25;7;18;.720;2715050;0
49278;2062;27;0;0;0;0;.00nan;0;0
49278;3273;25;48;6;1;5;.833;884950;0
49284;613;20;89;43;3;40;.930;3571750;0
49284;952;20;0;0;0;0;.00nan;0;0
49284;1664;31;0;0;0;0;.00nan;0;0
49284;2965;31;86;26;1;25;.962;3600000;0
49272;442;12;0;0;0;0;.00nan;0;0
49272;1652;0;0;0;0;0;.00nan;0;0
49272;5889;12;64;37;5;32;.865;3600000;0
49272;6446;0;27;36;8;28;.778;3600000;0
49642;567;24;26;12;4;8;.667;1953100;0
49642;1828;24;57;17;2;15;.882;1610300;0
49642;2664;17;48;22;4;18;.818;3600000;0
49642;5872;17;0;0;0;0;.00nan;0;0
49269;879;124;35;23;5;18;.783;2185450;0
49269;929;8;0;0;0;0;.00nan;0;0
49269;1658;124;55;16;2;14;.875;1414550;0
49269;5430;8;71;23;2;21;.913;3600000;0
49285;536;27;85;24;1;23;.958;3600000;0
49285;690;152;44;40;7;33;.825;2592700;0
49285;2062;27;0;0;0;0;.00nan;0;0
49285;5950;152;43;9;2;7;.778;1007300;0
49378;0;18;49;29;5;24;.828;3536550;0
49378;738;18;0;0;0;0;.00nan;0;0
49378;1664;31;93;41;3;38;.927;3600000;0
49378;2965;31;0;0;0;0;.00nan;0;0
49254;862;2;88;39;3;36;.923;3600000;0
49254;5935;2;0;0;0;0;.00nan;0;0
49254;5944;23;20;26;7;19;.731;2760800;0
49254;6515;23;35;11;3;8;.727;839200;0
49243;443;3;69;28;3;25;.893;3600000;0
49243;933;19;26;23;6;17;.739;2323050;0
49243;1615;19;62;14;1;13;.929;1276950;0
49280;703;1;0;0;0;0;.00nan;0;0
49280;1294;9;45;22;4;18;.818;3600000;0
49280;3513;1;82;36;3;33;.917;3600000;0
49280;5934;9;0;0;0;0;.00nan;0;0
49414;150;26;53;9;1;8;.889;1474600;0
49414;830;26;30;26;6;20;.769;2125400;0
49414;1222;10;0;0;0;0;.00nan;0;0
49414;6527;10;79;22;1;21;.955;3600000;0
49291;442;12;94;45;3;42;.933;3900000;0
49291;762;25;100;46;3;43;.935;3900000;0
49291;3273;25;0;0;0;0;.00nan;0;0
49291;5889;12;0;0;0;0;.00nan;0;0
49250;933;19;50;7;1;6;.857;391600;0
49250;1064;7;0;0;0;0;.00nan;0;0
49250;1615;19;80;50;5;45;.900;3208400;0
49250;1651;7;76;25;2;23;.920;3600000;0
49287;703;1;80;35;3;32;.914;3600000;0
49287;1652;0;0;0;0;0;.00nan;0;0
49287;3513;1;0;0;0;0;.00nan;0;0
49287;6446;0;76;26;2;24;.923;3600000;0
49554;613;20;0;0;0;0;.00nan;0;0
49554;952;20;66;33;4;29;.879;3722500;0
49554;1664;31;0;0;0;0;.00nan;0;0
49554;2965;31;81;46;5;41;.891;3722500;0
49324;762;25;0;0;0;0;.00nan;0;0
49324;2664;17;0;0;0;0;.00nan;0;0
49324;3273;25;83;29;2;27;.931;3600000;0
49324;5872;17;73;38;4;34;.895;3580800;0
49322;384;21;52;19;3;16;.842;3600000;0
49322;540;21;0;0;0;0;.00nan;0;0
49322;1222;10;74;38;4;34;.895;3548800;0
49322;6527;10;0;0;0;0;.00nan;0;0
49274;443;3;100;29;0;29;1.000;3600000;0
49274;530;28;19;13;5;8;.615;1419250;0
49274;982;28;74;32;3;29;.906;2180750;0
49253;567;24;43;3;1;2;.667;650050;0
49253;945;30;0;0;0;0;.00nan;0;0
49253;1021;30;61;17;2;15;.882;3600000;0
49253;1828;24;32;27;6;21;.778;2949950;0
49263;668;14;0;0;0;0;.00nan;0;0
49263;1218;14;91;41;3;38;.927;3600000;0
49263;5944;23;0;0;0;0;.00nan;0;0
49263;6515;23;55;40;6;34;.850;3600000;0
49268;0;18;0;0;0;0;.00nan;0;0
49268;738;18;93;40;2;38;.950;3600000;0
49268;904;29;0;0;0;0;.00nan;0;0
49268;3462;29;82;37;3;34;.919;3528900;0
49235;536;27;66;32;4;28;.875;3600000;0
49235;862;2;81;23;1;22;.957;3600000;0
49235;2062;27;0;0;0;0;.00nan;0;0
49235;5935;2;0;0;0;0;.00nan;0;0
49368;530;28;100;35;1;34;.971;3600000;0
49368;982;28;0;0;0;0;.00nan;0;0
49368;2664;17;76;39;4;35;.897;3600000;0
49368;5872;17;0;0;0;0;.00nan;0;0
49442;150;26;35;22;5;17;.773;3518700;0
49442;613;20;80;34;3;31;.912;3600000;0
49442;830;26;0;0;0;0;.00nan;0;0
49442;952;20;0;0;0;0;.00nan;0;0
49276;929;8;76;26;2;24;.923;3600000;0
49276;1064;7;44;33;6;27;.818;2607100;0
49276;1651;7;56;16;2;14;.875;992900;0
49276;5430;8;0;0;0;0;.00nan;0;0
50191;384;21;0;0;0;0;.00nan;0;0
50191;540;21;70;23;2;21;.913;3600000;0
50191;762;25;83;36;3;33;.917;3516050;0
50191;3273;25;0;0;0;0;.00nan;0;0
50174;879;124;55;34;5;29;.853;3576050;0
50174;1658;124;0;0;0;0;.00nan;0;0
50174;5944;23;0;0;0;0;.00nan;0;0
50174;6515;23;57;19;3;16;.842;3600000;0
49293;945;30;35;23;5;18;.783;3540900;0
49293;1021;30;0;0;0;0;.00nan;0;0
49293;1294;9;70;29;3;26;.897;3600000;0
49293;5934;9;0;0;0;0;.00nan;0;0
50185;0;18;100;33;1;32;.970;3600000;0
50185;567;24;0;0;0;0;.00nan;0;0
50185;738;18;0;0;0;0;.00nan;0;0
50185;1828;24;71;37;4;33;.892;3600000;0
49275;536;27;78;45;5;40;.889;3900000;0
49275;864;3;0;0;0;0;.00nan;0;0
49275;1064;3;69;43;5;38;.884;3900000;0
49275;2062;27;0;0;0;0;.00nan;0;0
49379;150;26;59;27;4;23;.852;3900000;0
49379;442;12;0;0;0;0;.00nan;0;0
49379;830;26;0;0;0;0;.00nan;0;0
49379;5889;12;63;34;4;30;.882;3900000;0
49288;904;29;0;0;0;0;.00nan;0;0
49288;3462;29;100;33;1;32;.970;3600000;0
49288;5944;23;82;36;3;33;.917;3571000;0
49288;6515;23;0;0;0;0;.00nan;0;0
49423;384;21;65;39;5;34;.872;3527950;0
49423;530;28;76;29;3;26;.897;3600000;0
49423;540;21;0;0;0;0;.00nan;0;0
49423;982;28;0;0;0;0;.00nan;0;0
49296;690;152;0;0;0;0;.00nan;0;0
49296;945;30;0;0;0;0;.00nan;0;0
49296;1021;30;83;12;0;12;1.000;3600000;0
49296;5950;152;52;28;5;23;.821;3600000;0
49311;862;2;0;0;0;0;.00nan;0;0
49311;1222;10;52;37;6;31;.838;3208300;0
49311;5935;2;95;39;2;37;.949;3600000;0
49311;6527;10;60;6;0;6;1.000;391700;0
49310;668;14;0;0;0;0;.00nan;0;0
49310;1218;14;68;34;4;30;.882;3600000;0
49310;1664;31;48;30;5;25;.833;3581350;0
49310;2965;31;0;0;0;0;.00nan;0;0
49326;443;7;0;0;0;0;.00nan;0;0
49326;1651;7;100;42;2;40;.952;3600000;0
49326;2664;17;0;0;0;0;.00nan;0;0
49326;5872;17;83;37;3;34;.919;3543150;0
49303;762;25;0;0;0;0;.00nan;0;0
49303;1652;0;98;48;3;45;.938;3532300;0
49303;3273;25;81;29;2;27;.931;3600000;0
49303;6446;0;0;0;0;0;.00nan;0;0
49305;442;12;80;41;4;37;.902;3583200;0
49305;613;20;0;0;0;0;.00nan;0;0
49305;952;20;95;43;2;41;.953;3600000;0
49305;5889;12;0;0;0;0;.00nan;0;0
49270;879;124;0;0;0;0;.00nan;0;0
49270;933;19;62;36;5;31;.861;3621450;0
49270;1615;19;0;0;0;0;.00nan;0;0
49270;1658;124;81;52;6;46;.885;3647400;0
49440;150;26;0;0;0;0;.00nan;0;0
49440;530;28;0;0;0;0;.00nan;0;0
49440;830;26;62;38;5;33;.868;3588500;0
49440;982;28;96;43;3;40;.930;3600000;0
49347;567;24;0;0;0;0;.00nan;0;0
49347;904;29;96;36;2;34;.944;3600000;0
49347;1828;24;80;40;4;36;.900;3556600;0
49347;3462;29;0;0;0;0;.00nan;0;0
49273;0;18;76;26;2;24;.923;3600000;0
49273;738;18;0;0;0;0;.00nan;0;0
49273;862;2;50;31;5;26;.839;3600000;0
49273;5935;2;0;0;0;0;.00nan;0;0
49282;864;3;41;32;6;26;.813;3600000;0
49282;1064;3;0;0;0;0;.00nan;0;0
49282;1652;0;0;0;0;0;.00nan;0;0
49282;6446;0;77;21;1;20;.952;3600000;0
49318;703;1;0;0;0;0;.00nan;0;0
49318;1222;10;0;0;0;0;.00nan;0;0
49318;3513;1;94;35;2;33;.943;3600000;0
49318;6527;10;72;42;5;37;.881;3600000;0
49497;443;7;90;28;1;27;.964;3600000;0
49497;1651;7;0;0;0;0;.00nan;0;0
49497;2664;17;42;26;5;21;.808;2385850;0
49497;5872;17;21;9;4;5;.556;1214150;0
49295;668;14;69;34;4;30;.882;3900000;0
49295;1218;14;0;0;0;0;.00nan;0;0
49295;1294;9;54;29;4;25;.862;3900000;0
49295;5934;9;0;0;0;0;.00nan;0;0
50211;762;25;70;31;3;28;.903;3815450;0
50211;1294;9;0;0;0;0;.00nan;0;0
50211;3273;25;0;0;0;0;.00nan;0;0
50211;5934;9;66;26;3;23;.885;3900000;0
49393;442;12;81;33;3;30;.909;3900000;0
49393;5889;12;0;0;0;0;.00nan;0;0
49393;5944;23;0;0;0;0;.00nan;0;0
49393;6515;23;98;59;3;56;.949;3900000;0
49290;536;27;61;42;6;36;.857;2858300;0
49290;864;3;0;0;0;0;.00nan;0;0
49290;1064;3;91;28;1;27;.964;3600000;0
49290;2062;27;44;4;1;3;.750;741700;0
49452;150;26;94;49;4;45;.918;3721900;0
49452;830;26;0;0;0;0;.00nan;0;0
49452;1664;31;0;0;0;0;.00nan;0;0
49452;2965;31;52;28;5;23;.821;3684450;0
49342;613;20;67;38;5;33;.868;3222250;0
49342;703;1;0;0;0;0;.00nan;0;0
49342;952;20;53;3;0;3;1.000;377750;0
49342;3513;1;94;36;2;34;.944;3600000;0
49281;0;18;62;38;5;33;.868;3513500;0
49281;738;18;0;0;0;0;.00nan;0;0
49281;1652;0;88;38;3;35;.921;3600000;0
49281;6446;0;0;0;0;0;.00nan;0;0
49341;690;152;24;34;8;26;.765;3600000;0
49341;1222;10;73;36;4;32;.889;3600000;0
49341;5950;152;0;0;0;0;.00nan;0;0
49341;6527;10;0;0;0;0;.00nan;0;0
49413;929;8;0;0;0;0;.00nan;0;0
49413;933;19;0;0;0;0;.00nan;0;0
49413;1615;19;100;51;4;47;.922;3900000;0
49413;5430;8;51;27;4;23;.852;3900000;0
49502;443;7;0;0;0;0;.00nan;0;0
49502;530;28;83;23;1;22;.957;3600000;0
49502;982;28;0;0;0;0;.00nan;0;0
49502;1651;7;95;42;3;39;.929;3511600;0
49302;567;24;0;0;0;0;.00nan;0;0
49302;945;30;61;17;2;15;.882;3600000;0
49302;1021;30;0;0;0;0;.00nan;0;0
49302;1828;24;55;28;4;24;.857;3550200;0
49319;668;14;0;0;0;0;.00nan;0;0
49319;879;124;0;0;0;0;.00nan;0;0
49319;1218;14;71;23;2;21;.913;3600000;0
49319;1658;124;93;47;3;44;.936;3576100;0
49331;904;29;0;0;0;0;.00nan;0;0
49331;1294;9;55;32;5;27;.844;3574450;0
49331;3462;29;64;26;3;23;.885;3600000;0
49331;5934;9;0;0;0;0;.00nan;0;0
50176;150;26;0;0;0;0;.00nan;0;0
50176;668;14;73;25;2;23;.920;3600000;0
50176;830;26;82;48;5;43;.896;3600000;0
50176;1218;14;0;0;0;0;.00nan;0;0
49292;0;18;0;0;0;0;.00nan;0;0
49292;536;27;94;38;1;37;.974;3532900;0
49292;738;18;100;36;0;36;1.000;3600000;0
49292;2062;27;0;0;0;0;.00nan;0;0
49315;384;21;0;0;0;0;.00nan;0;0
49315;540;21;43;32;5;27;.844;3900000;0
49315;945;30;0;0;0;0;.00nan;0;0
49315;1021;30;79;43;5;38;.884;3900000;0
49547;929;8;19;25;7;18;.720;3600000;0
49547;2664;17;0;0;0;0;.00nan;0;0
49547;5430;8;0;0;0;0;.00nan;0;0
49547;5872;17;100;44;2;42;.955;3600000;0
50184;443;7;100;42;2;40;.952;3600000;0
50184;1651;7;0;0;0;0;.00nan;0;0
50184;1652;0;0;0;0;0;.00nan;0;0
50184;6446;0;89;40;3;37;.925;3556750;0
49355;703;1;100;40;1;39;.975;3600000;0
49355;1664;31;58;28;4;24;.857;3600000;0
49355;2965;31;0;0;0;0;.00nan;0;0
49355;3513;1;0;0;0;0;.00nan;0;0
50179;904;29;56;34;5;29;.853;3600000;0
50179;1222;10;100;24;0;24;1.000;3600000;0
50179;3462;29;0;0;0;0;.00nan;0;0
50179;6527;10;0;0;0;0;.00nan;0;0
49294;690;152;0;0;0;0;.00nan;0;0
49294;5944;23;73;24;2;22;.917;3600000;0
49294;5950;152;90;40;3;37;.925;3567800;0
49294;6515;23;0;0;0;0;.00nan;0;0
49321;862;2;0;0;0;0;.00nan;0;0
49321;879;124;71;34;4;30;.882;3566850;0
49321;1658;124;0;0;0;0;.00nan;0;0
49321;5935;2;45;15;3;12;.800;3600000;0
49391;613;20;65;36;5;31;.861;3900000;0
49391;762;25;57;38;5;33;.868;3900000;0
49391;952;20;0;0;0;0;.00nan;0;0
49391;3273;25;0;0;0;0;.00nan;0;0
49316;384;21;40;25;5;20;.800;3547350;0
49316;540;21;0;0;0;0;.00nan;0;0
49316;933;19;0;0;0;0;.00nan;0;0
49316;1615;19;97;43;3;40;.930;3600000;0
49369;567;24;0;0;0;0;.00nan;0;0
49369;762;25;0;0;0;0;.00nan;0;0
49369;1828;24;77;27;2;25;.926;3600000;0
49369;3273;25;98;49;3;46;.939;3579600;0
50190;530;28;68;34;4;30;.882;3600000;0
50190;613;20;0;0;0;0;.00nan;0;0
50190;952;20;56;34;5;29;.853;3572450;0
50190;982;28;0;0;0;0;.00nan;0;0
49910;1294;9;51;24;4;20;.833;3600000;0
49910;2664;17;0;0;0;0;.00nan;0;0
49910;5872;17;4;35;10;25;.714;3600000;0
49910;5934;9;0;0;0;0;.00nan;0;0
50192;0;18;0;0;0;0;.00nan;0;0
50192;738;18;85;38;3;35;.921;3583650;0
50192;864;3;82;22;1;21;.955;3600000;0
50192;1064;3;0;0;0;0;.00nan;0;0
49352;442;12;66;34;4;30;.882;2754700;0
49352;904;29;0;0;0;0;.00nan;0;0
49352;3462;29;79;28;2;26;.929;3600000;0
49352;5889;12;17;7;4;3;.429;845300;0
49359;443;7;0;0;0;0;.00nan;0;0
49359;862;2;0;0;0;0;.00nan;0;0
49359;1651;7;84;38;3;35;.921;3577300;0
49359;5935;2;81;29;2;27;.931;3600000;0
49362;0;18;52;43;7;36;.837;3521400;0
49362;384;21;0;0;0;0;.00nan;0;0
49362;540;21;75;44;5;39;.886;3600000;0
49362;738;18;0;0;0;0;.00nan;0;0
49738;530;28;0;0;0;0;.00nan;0;0
49738;879;124;0;0;0;0;.00nan;0;0
49738;982;28;60;31;4;27;.871;3900000;0
49738;1658;124;100;56;4;52;.929;3900000;0
49333;929;8;56;4;0;4;1.000;819500;0
49333;945;30;0;0;0;0;.00nan;0;0
49333;1021;30;91;17;0;17;1.000;3600000;0
49333;5430;8;35;29;6;23;.793;2780500;0
50208;150;26;0;0;0;0;.00nan;0;0
50208;668;14;0;0;0;0;.00nan;0;0
50208;830;26;88;50;5;45;.900;3600000;0
50208;1218;14;99;21;0;21;1.000;3600000;0
49334;536;27;0;0;0;0;.00nan;0;0
49334;613;20;75;43;5;38;.884;3708000;0
49334;952;20;0;0;0;0;.00nan;0;0
49334;2062;27;50;35;6;29;.829;3663400;0
49408;567;24;0;0;0;0;.00nan;0;0
49408;1828;24;88;33;2;31;.939;3900000;0
49408;5944;23;0;0;0;0;.00nan;0;0
49408;6515;23;82;28;2;26;.929;3900000;0
49306;864;3;0;0;0;0;.00nan;0;0
49306;1064;3;65;20;2;18;.900;3558000;0
49306;1294;9;81;23;1;22;.957;3600000;0
49306;5934;9;0;0;0;0;.00nan;0;0
49325;933;19;0;0;0;0;.00nan;0;0
49325;1615;19;90;28;1;27;.964;3563000;0
49325;1652;0;100;23;0;23;1.000;3600000;0
49325;6446;0;0;0;0;0;.00nan;0;0
49404;150;26;0;0;0;0;.00nan;0;0
49404;830;26;88;46;4;42;.913;3600000;0
49404;904;29;0;0;0;0;.00nan;0;0
49404;3462;29;82;22;1;21;.955;3600000;0
49392;762;25;42;38;7;31;.816;3600000;0
49392;1664;31;0;0;0;0;.00nan;0;0
49392;2965;31;79;28;2;26;.929;3600000;0
49392;3273;25;0;0;0;0;.00nan;0;0
49398;443;7;100;33;1;32;.970;3600000;0
49398;1222;10;89;35;2;33;.943;3575500;0
49398;1651;7;0;0;0;0;.00nan;0;0
49398;6527;10;0;0;0;0;.00nan;0;0
49343;442;12;65;28;4;24;.857;3862100;0
49343;945;30;78;32;3;29;.906;3862100;0
49343;1021;30;0;0;0;0;.00nan;0;0
49343;3756;12;0;0;0;0;.00nan;0;0
49351;690;152;63;25;3;22;.880;3556950;0
49351;2664;17;0;0;0;0;.00nan;0;0
49351;5872;17;82;24;1;23;.958;3600000;0
49351;5950;152;0;0;0;0;.00nan;0;0
49344;668;14;78;33;3;30;.909;3600000;0
49344;929;8;68;35;4;31;.886;3576250;0
49344;1218;14;0;0;0;0;.00nan;0;0
49344;5430;8;0;0;0;0;.00nan;0;0
49337;862;2;53;27;4;23;.852;3600000;0
49337;2664;17;100;34;1;33;.971;3600000;0
49337;5872;17;0;0;0;0;.00nan;0;0
49337;5935;2;0;0;0;0;.00nan;0;0
50217;567;24;65;32;4;28;.875;3579650;0
50217;1294;9;0;0;0;0;.00nan;0;0
50217;1828;24;0;0;0;0;.00nan;0;0
50217;5934;9;79;33;3;30;.909;3600000;0
49518;530;28;65;27;3;24;.889;3600000;0
49518;982;28;0;0;0;0;.00nan;0;0
49518;1664;31;100;32;0;32;1.000;3600000;0
49518;2965;31;0;0;0;0;.00nan;0;0
49308;536;27;54;32;5;27;.844;3583100;0
49308;864;3;73;29;3;26;.897;3600000;0
49308;1064;3;0;0;0;0;.00nan;0;0
49308;2062;27;0;0;0;0;.00nan;0;0
49301;0;18;0;0;0;0;.00nan;0;0
49301;738;18;67;39;5;34;.872;3600000;0
49301;929;8;100;35;1;34;.971;3600000;0
49301;5430;8;0;0;0;0;.00nan;0;0
49439;384;21;0;0;0;0;.00nan;0;0
49439;540;21;100;35;1;34;.971;3600000;0
49439;762;25;68;28;3;25;.893;3549100;0
49439;3273;25;0;0;0;0;.00nan;0;0
49360;150;26;44;4;1;3;.750;825250;0
49360;830;26;38;35;7;28;.800;2774750;0
49360;1652;0;64;31;4;27;.871;3600000;0
49360;6446;0;0;0;0;0;.00nan;0;0
49348;1222;10;81;45;5;40;.889;3782550;0
49348;5944;23;0;0;0;0;.00nan;0;0
49348;6515;23;54;27;4;23;.852;3782550;0
49348;6527;10;0;0;0;0;.00nan;0;0
49409;443;7;0;0;0;0;.00nan;0;0
49409;879;124;0;0;0;0;.00nan;0;0
49409;1651;7;21;27;7;20;.741;3600000;0
49409;1658;124;91;28;1;27;.964;3600000;0
49357;668;14;46;5;1;4;.800;397150;0
49357;904;29;0;0;0;0;.00nan;0;0
49357;1218;14;61;40;6;34;.850;3202850;0
49357;3462;29;58;22;3;19;.864;3600000;0
49411;613;20;0;0;0;0;.00nan;0;0
49411;703;1;0;0;0;0;.00nan;0;0
49411;952;20;85;25;1;24;.960;3600000;0
49411;3513;1;76;27;2;25;.926;3597800;0
49330;690;152;0;0;0;0;.00nan;0;0
49330;933;19;63;29;4;25;.862;3616950;0
49330;1615;19;0;0;0;0;.00nan;0;0
49330;5950;152;92;40;3;37;.925;3616950;0
49370;567;24;0;0;0;0;.00nan;0;0
49370;1828;24;61;30;4;26;.867;3574700;0
49370;2664;17;0;0;0;0;.00nan;0;0
49370;5872;17;67;26;3;23;.885;3600000;0
49616;762;25;0;0;0;0;.00nan;0;0
49616;1294;9;73;23;2;21;.913;3600000;0
49616;3273;25;77;40;4;36;.900;3546300;0
49616;5934;9;0;0;0;0;.00nan;0;0
49346;457;23;74;26;2;24;.923;3600000;0
49346;945;30;97;32;1;31;.969;3600000;0
49346;1021;30;0;0;0;0;.00nan;0;0
49346;6515;23;0;0;0;0;.00nan;0;0
49339;703;1;89;27;1;26;.963;3600000;0
49339;879;124;67;40;5;35;.875;3600000;0
49339;1658;124;0;0;0;0;.00nan;0;0
49339;3513;1;0;0;0;0;.00nan;0;0
49313;0;18;0;0;0;0;.00nan;0;0
49313;864;3;0;0;0;0;.00nan;0;0
49313;1064;3;100;36;1;35;.972;3600000;0
49313;1247;18;41;31;6;25;.806;3600000;0
49412;150;26;43;3;1;2;.667;312400;0
49412;442;12;27;5;3;2;.400;146900;0
49412;830;26;58;53;8;45;.849;3287600;0
49412;3756;12;99;32;1;31;.969;3453100;0
49328;1652;0;0;0;0;0;.00nan;0;0
49328;1664;31;64;26;3;23;.885;3600000;0
49328;2965;31;0;0;0;0;.00nan;0;0
49328;6446;0;92;58;6;52;.897;3600000;0
49336;536;27;0;0;0;0;.00nan;0;0
49336;613;20;100;46;2;44;.957;3600000;0
49336;952;20;0;0;0;0;.00nan;0;0
49336;2062;27;66;34;4;30;.882;3450350;0
49373;668;14;0;0;0;0;.00nan;0;0
49373;1218;14;100;34;1;33;.971;3600000;0
49373;1222;10;49;30;5;25;.833;3600000;0
49373;6527;10;0;0;0;0;.00nan;0;0
50220;945;30;0;0;0;0;.00nan;0;0
50220;1021;30;97;38;2;36;.947;3900000;0
50220;1664;31;0;0;0;0;.00nan;0;0
50220;2965;31;74;19;2;17;.895;3900000;0
49345;862;2;68;32;4;28;.875;3900000;0
49345;933;19;0;0;0;0;.00nan;0;0
49345;1615;19;80;37;4;33;.892;3900000;0
49345;5935;2;0;0;0;0;.00nan;0;0
49457;567;24;93;39;2;37;.949;3600000;0
49457;1294;9;0;0;0;0;.00nan;0;0
49457;1828;24;0;0;0;0;.00nan;0;0
49457;5934;9;65;27;3;24;.889;3544050;0
49429;690;152;90;46;4;42;.913;3550050;0
49429;703;1;0;0;0;0;.00nan;0;0
49429;3513;1;75;31;3;28;.903;3600000;0
49429;5950;152;0;0;0;0;.00nan;0;0
49407;904;29;0;0;0;0;.00nan;0;0
49407;929;8;94;42;3;39;.929;3624550;0
49407;3462;29;100;49;2;47;.959;3624550;0
49407;5430;8;0;0;0;0;.00nan;0;0
49576;384;21;0;0;0;0;.00nan;0;0
49576;530;28;64;26;3;23;.885;3563000;0
49576;540;21;100;38;1;37;.974;3600000;0
49576;982;28;0;0;0;0;.00nan;0;0
49367;0;18;78;33;3;30;.909;3600000;0
49367;443;7;77;40;4;36;.900;3549300;0
49367;1247;18;0;0;0;0;.00nan;0;0
49367;1651;7;0;0;0;0;.00nan;0;0
49477;530;28;0;0;0;0;.00nan;0;0
49477;613;20;0;0;0;0;.00nan;0;0
49477;952;20;81;29;2;27;.931;3600000;0
49477;982;28;82;37;3;34;.919;3573750;0
49372;457;23;75;25;2;23;.920;3600000;0
49372;536;27;78;34;3;31;.912;3564050;0
49372;2062;27;0;0;0;0;.00nan;0;0
49372;6515;23;0;0;0;0;.00nan;0;0
49371;668;14;0;0;0;0;.00nan;0;0
49371;862;2;0;0;0;0;.00nan;0;0
49371;1218;14;74;37;4;33;.892;3600000;0
49371;5935;2;91;39;3;36;.923;3600000;0
49485;762;25;100;31;0;31;1.000;3600000;0
49485;1222;10;35;22;5;17;.773;3600000;0
49485;3273;25;0;0;0;0;.00nan;0;0
49485;6527;10;0;0;0;0;.00nan;0;0
49374;879;124;0;0;0;0;.00nan;0;0
49374;945;30;82;29;2;27;.931;3600000;0
49374;1021;30;0;0;0;0;.00nan;0;0
49374;1658;124;64;45;6;39;.867;3600000;0
49317;864;3;74;25;2;23;.920;3600000;0
49317;879;124;93;53;4;49;.925;3522200;0
49317;1064;3;0;0;0;0;.00nan;0;0
49317;1658;124;0;0;0;0;.00nan;0;0
49354;929;8;76;26;2;24;.923;3600000;0
49354;1652;0;91;42;3;39;.929;3600000;0
49354;5430;8;0;0;0;0;.00nan;0;0
49354;6446;0;0;0;0;0;.00nan;0;0
49350;0;18;0;0;0;0;.00nan;0;0
49350;536;27;81;34;3;31;.912;3600000;0
49350;1247;18;66;44;6;38;.864;3600000;0
49350;2062;27;0;0;0;0;.00nan;0;0
49361;150;26;93;57;3;54;.947;3512700;0
49361;830;26;0;0;0;0;.00nan;0;0
49361;862;2;82;23;1;22;.957;3600000;0
49361;5935;2;0;0;0;0;.00nan;0;0
50040;567;24;0;0;0;0;.00nan;0;0
50040;1664;31;69;34;4;30;.882;3900000;0
50040;1828;24;73;39;4;35;.897;3900000;0
50040;2965;31;0;0;0;0;.00nan;0;0
49427;933;19;52;2;0;2;1.000;504650;0
49427;1615;19;41;30;6;24;.800;3095350;0
49427;2664;17;0;0;0;0;.00nan;0;0
49427;5872;17;77;27;2;25;.926;3600000;0
49433;703;1;0;0;0;0;.00nan;0;0
49433;1222;10;57;33;5;28;.848;3591650;0
49433;3513;1;63;31;4;27;.871;3637650;0
49433;6527;10;0;0;0;0;.00nan;0;0
49375;668;14;52;19;3;16;.842;3600000;0
49375;762;25;77;45;5;40;.889;3564850;0
49375;1218;14;0;0;0;0;.00nan;0;0
49375;3273;25;0;0;0;0;.00nan;0;0
49402;384;21;60;33;4;29;.879;3900000;0
49402;540;21;0;0;0;0;.00nan;0;0
49402;945;30;0;0;0;0;.00nan;0;0
49402;1021;30;78;42;4;38;.905;3900000;0
49456;613;20;71;36;4;32;.889;3548750;0
49456;952;20;0;0;0;0;.00nan;0;0
49456;1294;9;93;36;2;34;.944;3600000;0
49456;5934;9;0;0;0;0;.00nan;0;0
49460;1664;31;0;0;0;0;.00nan;0;0
49460;2664;17;80;22;1;21;.955;3600000;0
49460;2965;31;79;34;3;31;.912;3545750;0
49460;5872;17;0;0;0;0;.00nan;0;0
49444;690;152;77;27;2;25;.926;3600000;0
49444;904;29;73;37;4;33;.892;3600000;0
49444;3462;29;0;0;0;0;.00nan;0;0
49444;5950;152;0;0;0;0;.00nan;0;0
50150;945;30;97;31;1;30;.968;3600000;0
50150;1021;30;0;0;0;0;.00nan;0;0
50150;1222;10;74;26;2;24;.923;3600000;0
50150;6527;10;0;0;0;0;.00nan;0;0
49432;443;7;43;3;1;2;.667;302000;0
49432;904;29;0;0;0;0;.00nan;0;0
49432;1651;7;69;47;6;41;.872;3298000;0
49432;3462;29;86;32;2;30;.938;3600000;0
49358;567;24;0;0;0;0;.00nan;0;0
49358;668;14;0;0;0;0;.00nan;0;0
49358;1218;14;81;28;2;26;.929;3600000;0
49358;1828;24;88;38;3;35;.921;3598700;0
49492;530;28;100;36;1;35;.972;3600000;0
49492;933;19;97;39;2;37;.949;3562600;0
49492;982;28;0;0;0;0;.00nan;0;0
49492;1615;19;0;0;0;0;.00nan;0;0
49356;690;152;0;0;0;0;.00nan;0;0
49356;929;8;68;16;1;15;.938;3600000;0
49356;5430;8;0;0;0;0;.00nan;0;0
49356;5950;152;55;39;6;33;.846;3600000;0
49363;384;21;0;0;0;0;.00nan;0;0
49363;540;21;93;36;2;34;.944;3600000;0
49363;1652;0;62;26;3;23;.885;3556300;0
49363;6446;0;0;0;0;0;.00nan;0;0
49488;457;23;28;19;5;14;.737;1916800;0
49488;613;20;0;0;0;0;.00nan;0;0
49488;952;20;51;36;6;30;.833;3600000;0
49488;6515;23;37;6;2;4;.667;1644100;0
49353;442;12;65;32;4;28;.875;3600000;0
49353;536;27;100;31;0;31;1.000;3600000;0
49353;2062;27;0;0;0;0;.00nan;0;0
49353;3756;12;0;0;0;0;.00nan;0;0
49572;150;26;0;0;0;0;.00nan;0;0
49572;830;26;100;43;2;41;.953;3900000;0
49572;1294;9;0;0;0;0;.00nan;0;0
49572;5934;9;91;36;2;34;.944;3900000;0
49340;442;12;0;0;0;0;.00nan;0;0
49340;864;3;0;0;0;0;.00nan;0;0
49340;1064;3;89;41;3;38;.927;3560600;0
49340;3756;12;71;23;2;21;.913;3600000;0
49420;703;1;0;0;0;0;.00nan;0;0
49420;879;124;44;34;6;28;.824;2974450;0
49420;1658;124;48;6;1;5;.833;625550;0
49420;3513;1;83;29;2;27;.931;3600000;0
49364;862;2;0;0;0;0;.00nan;0;0
49364;1652;0;0;0;0;0;.00nan;0;0
49364;5935;2;96;31;1;30;.968;3600000;0
49364;6446;0;64;39;5;34;.872;3600000;0
49400;762;25;76;31;2;29;.935;3896200;0
49400;2664;17;0;0;0;0;.00nan;0;0
49400;3273;25;0;0;0;0;.00nan;0;0
49400;5872;17;89;46;2;44;.957;3900000;0
49544;457;23;39;30;6;24;.800;3600000;0
49544;1294;9;97;33;1;32;.970;3600000;0
49544;5934;9;0;0;0;0;.00nan;0;0
49544;6515;23;0;0;0;0;.00nan;0;0
49405;384;21;0;0;0;0;.00nan;0;0
49405;540;21;70;23;2;21;.913;3600000;0
49405;945;30;0;0;0;0;.00nan;0;0
49405;1021;30;53;26;4;22;.846;3543350;0
49436;443;7;81;23;1;22;.957;3600000;0
49436;933;19;23;10;4;6;.600;1197500;0
49436;1615;19;82;24;1;23;.958;2402500;0
49436;1651;7;0;0;0;0;.00nan;0;0
49382;703;1;59;29;4;25;.862;3893700;0
49382;929;8;93;44;3;41;.932;3893700;0
49382;3513;1;0;0;0;0;.00nan;0;0
49382;5430;8;0;0;0;0;.00nan;0;0
50197;0;18;91;27;1;26;.963;3600000;0
50197;690;152;35;23;5;18;.783;3600000;0
50197;1247;18;0;0;0;0;.00nan;0;0
50197;5950;152;0;0;0;0;.00nan;0;0
49915;567;24;0;0;0;0;.00nan;0;0
49915;1664;31;0;0;0;0;.00nan;0;0
49915;1828;24;79;27;2;25;.926;3600000;0
49915;2965;31;75;37;4;33;.892;3529300;0
50180;536;27;59;29;4;25;.862;3571000;0
50180;762;25;0;0;0;0;.00nan;0;0
50180;2062;27;0;0;0;0;.00nan;0;0
50180;3273;25;91;42;3;39;.929;3600000;0
49531;530;28;71;17;1;16;.941;3600000;0
49531;982;28;0;0;0;0;.00nan;0;0
49531;1222;10;62;37;5;32;.865;3600000;0
49531;6527;10;0;0;0;0;.00nan;0;0
49338;864;3;77;57;7;50;.877;3600000;0
49338;904;29;0;0;0;0;.00nan;0;0
49338;1064;3;0;0;0;0;.00nan;0;0
49338;3462;29;67;33;4;29;.879;3600000;0
50183;613;20;89;33;2;31;.939;3600000;0
50183;879;124;0;0;0;0;.00nan;0;0
50183;952;20;0;0;0;0;.00nan;0;0
50183;1658;124;82;42;4;38;.905;3546100;0
49365;0;18;0;0;0;0;.00nan;0;0
49365;442;12;74;44;5;39;.886;3600000;0
49365;1247;18;100;47;2;45;.957;3600000;0
49365;3756;12;0;0;0;0;.00nan;0;0
50181;457;23;0;0;0;0;.00nan;0;0
50181;862;2;0;0;0;0;.00nan;0;0
50181;5935;2;96;39;2;37;.949;3600000;0
50181;6515;23;73;31;3;28;.903;3564800;0
49468;150;26;28;6;3;3;.500;532400;0
49468;690;152;0;0;0;0;.00nan;0;0
49468;830;26;72;25;2;23;.920;3326900;0
49468;5950;152;67;45;6;39;.867;3859300;0
49384;536;27;75;31;3;28;.903;3600000;0
49384;864;3;0;0;0;0;.00nan;0;0
49384;1064;3;79;40;4;36;.900;3572700;0
49384;2062;27;0;0;0;0;.00nan;0;0
49385;668;14;0;0;0;0;.00nan;0;0
49385;762;25;80;29;2;27;.931;3531500;0
49385;1218;14;100;32;0;32;1.000;3600000;0
49385;3273;25;0;0;0;0;.00nan;0;0
49388;613;20;73;36;4;32;.889;3600000;0
49388;952;20;0;0;0;0;.00nan;0;0
49388;1652;0;52;30;5;25;.833;3272450;0
49388;6446;0;50;1;0;1;1.000;272350;0
49394;567;24;0;0;0;0;.00nan;0;0
49394;929;8;50;37;6;31;.838;2900600;0
49394;1828;24;75;31;3;28;.903;3600000;0
49394;5430;8;62;7;0;7;1.000;699400;0
50152;1294;9;80;30;2;28;.933;3581700;0
50152;2664;17;0;0;0;0;.00nan;0;0
50152;5872;17;96;30;1;29;.967;3600000;0
50152;5934;9;0;0;0;0;.00nan;0;0
49434;879;124;0;0;0;0;.00nan;0;0
49434;945;30;0;0;0;0;.00nan;0;0
49434;1021;30;69;28;3;25;.893;3600000;0
49434;1658;124;62;29;4;25;.862;3523900;0
50199;384;21;71;36;4;32;.889;3582900;0
50199;540;21;0;0;0;0;.00nan;0;0
50199;703;1;0;0;0;0;.00nan;0;0
50199;3513;1;71;29;3;26;.897;3600000;0
49710;690;152;0;0;0;0;.00nan;0;0
49710;933;19;64;32;4;28;.875;3600000;0
49710;1615;19;0;0;0;0;.00nan;0;0
49710;5950;152;100;41;1;40;.976;3600000;0
49435;150;26;0;0;0;0;.00nan;0;0
49435;830;26;75;31;3;28;.903;3600000;0
49435;879;124;60;42;6;36;.857;3600000;0
49435;1658;124;0;0;0;0;.00nan;0;0
49396;442;12;0;0;0;0;.00nan;0;0
49396;929;8;0;0;0;0;.00nan;0;0
49396;3756;12;84;23;1;22;.957;3600000;0
49396;5430;8;68;34;4;30;.882;3600000;0
49386;0;18;55;39;6;33;.846;3600000;0
49386;536;27;80;34;3;31;.912;3600000;0
49386;1247;18;0;0;0;0;.00nan;0;0
49386;2062;27;0;0;0;0;.00nan;0;0
49376;762;25;0;0;0;0;.00nan;0;0
49376;862;2;0;0;0;0;.00nan;0;0
49376;3273;25;91;42;2;40;.952;3708900;0
49376;5935;2;76;33;3;30;.909;3705450;0
49875;457;23;71;43;5;38;.884;3562150;0
49875;567;24;80;32;3;29;.906;3600000;0
49875;1828;24;0;0;0;0;.00nan;0;0
49875;6515;23;0;0;0;0;.00nan;0;0
49380;530;28;36;33;7;26;.788;3637850;0
49380;668;14;70;47;6;41;.872;3637850;0
49380;982;28;0;0;0;0;.00nan;0;0
49380;1218;14;0;0;0;0;.00nan;0;0
49451;384;21;0;0;0;0;.00nan;0;0
49451;540;21;84;30;2;28;.933;3600000;0
49451;703;1;52;26;4;22;.846;2208100;0
49451;3513;1;42;14;3;11;.786;1391900;0
49467;443;7;0;0;0;0;.00nan;0;0
49467;1651;7;75;37;4;33;.892;3594900;0
49467;1664;31;68;37;5;32;.865;3618300;0
49467;2965;31;0;0;0;0;.00nan;0;0
49461;613;20;0;0;0;0;.00nan;0;0
49461;904;29;0;0;0;0;.00nan;0;0
49461;952;20;81;41;4;37;.902;3593050;0
49461;3462;29;73;30;3;27;.900;3600000;0
49503;443;7;82;29;2;27;.931;3600000;0
49503;904;29;0;0;0;0;.00nan;0;0
49503;1651;7;0;0;0;0;.00nan;0;0
49503;3462;29;65;27;3;24;.889;3562250;0
49421;862;2;100;45;1;44;.978;3600000;0
49421;1222;10;54;20;3;17;.850;3517750;0
49421;5935;2;0;0;0;0;.00nan;0;0
49421;6527;10;0;0;0;0;.00nan;0;0
49377;567;24;0;0;0;0;.00nan;0;0
49377;1652;0;80;34;3;31;.912;3600000;0
49377;1828;24;31;31;7;24;.774;3600000;0
49377;6446;0;0;0;0;0;.00nan;0;0
49577;530;28;60;35;5;30;.857;3600000;0
49577;690;152;0;0;0;0;.00nan;0;0
49577;982;28;0;0;0;0;.00nan;0;0
49577;5950;152;55;45;7;38;.844;3553750;0
49399;0;18;99;33;1;32;.970;3600000;0
49399;150;26;0;0;0;0;.00nan;0;0
49399;830;26;91;36;2;34;.944;3600000;0
49399;1247;18;0;0;0;0;.00nan;0;0
49401;613;20;98;45;2;43;.956;3586600;0
49401;929;8;100;31;0;31;1.000;3600000;0
49401;952;20;0;0;0;0;.00nan;0;0
49401;5430;8;0;0;0;0;.00nan;0;0
49455;442;12;0;0;0;0;.00nan;0;0
49455;1294;9;0;0;0;0;.00nan;0;0
49455;3756;12;35;29;6;23;.793;3540350;0
49455;5934;9;76;42;5;37;.881;3600000;0
49487;945;30;77;21;1;20;.952;3600000;0
49487;1021;30;0;0;0;0;.00nan;0;0
49487;1222;10;0;0;0;0;.00nan;0;0
49487;6527;10;48;23;4;19;.826;3600000;0
49473;703;1;0;0;0;0;.00nan;0;0
49473;864;3;0;0;0;0;.00nan;0;0
49473;1064;3;100;31;1;30;.968;3600000;0
49473;3513;1;64;27;3;24;.889;3585600;0
50038;457;23;0;0;0;0;.00nan;0;0
50038;933;19;88;32;2;30;.938;3600000;0
50038;1615;19;0;0;0;0;.00nan;0;0
50038;6515;23;76;33;3;30;.909;3546650;0
49428;384;21;0;0;0;0;.00nan;0;0
49428;540;21;74;25;2;23;.920;3600000;0
49428;879;124;0;0;0;0;.00nan;0;0
49428;1658;124;68;47;6;41;.872;3600000;0
49480;1664;31;0;0;0;0;.00nan;0;0
49480;2664;17;0;0;0;0;.00nan;0;0
49480;2965;31;73;23;2;21;.913;3600000;0
49480;5872;17;88;46;4;42;.913;3528850;0
49464;384;21;64;26;3;23;.885;3600000;0
49464;540;21;0;0;0;0;.00nan;0;0
49464;690;152;78;50;6;44;.880;3600000;0
49464;5950;152;0;0;0;0;.00nan;0;0
49349;530;28;48;0;0;0;.00nan;297450;0
49349;864;3;55;21;3;18;.857;3600000;0
49349;982;28;71;48;6;42;.875;3302550;0
49349;1064;3;0;0;0;0;.00nan;0;0
49381;443;7;41;13;3;10;.769;1532950;0
49381;862;2;0;0;0;0;.00nan;0;0
49381;1651;7;32;15;4;11;.733;2067050;0
49381;5935;2;51;18;3;15;.833;3600000;0
49482;150;26;0;0;0;0;.00nan;0;0
49482;830;26;66;40;5;35;.875;3600000;0
49482;2664;17;87;32;2;30;.938;3600000;0
49482;5872;17;0;0;0;0;.00nan;0;0
49389;536;27;26;12;4;8;.667;943500;0
49389;1294;9;73;25;2;23;.920;3600000;0
49389;2062;27;39;17;4;13;.765;2656500;0
49389;5934;9;0;0;0;0;.00nan;0;0
49406;0;18;0;0;0;0;.00nan;0;0
49406;762;25;66;40;5;35;.875;3577000;0
49406;1247;18;63;25;3;22;.880;3600000;0
49406;3273;25;0;0;0;0;.00nan;0;0
49387;668;14;0;0;0;0;.00nan;0;0
49387;1218;14;62;28;4;24;.857;3600000;0
49387;1652;0;0;0;0;0;.00nan;0;0
49387;6446;0;74;43;5;38;.884;3599800;0
49507;703;1;29;31;7;24;.774;3037350;0
49507;1664;31;73;30;3;27;.900;3600000;0
49507;2965;31;0;0;0;0;.00nan;0;0
49507;3513;1;43;9;2;7;.778;562650;0
50198;457;23;63;24;3;21;.875;3600000;0
50198;933;19;68;35;4;31;.886;3583200;0
50198;1615;19;0;0;0;0;.00nan;0;0
50198;6515;23;0;0;0;0;.00nan;0;0
49449;442;12;0;0;0;0;.00nan;0;0
49449;1222;10;70;42;5;37;.881;3536200;0
49449;3756;12;60;23;3;20;.870;3600000;0
49449;6527;10;0;0;0;0;.00nan;0;0
50224;862;2;100;38;1;37;.974;3900000;0
50224;945;30;98;34;1;33;.971;3900000;0
50224;1021;30;0;0;0;0;.00nan;0;0
50224;5935;2;0;0;0;0;.00nan;0;0
50148;668;14;90;41;3;38;.927;3900000;0
50148;929;8;81;38;3;35;.921;3900000;0
50148;1218;14;0;0;0;0;.00nan;0;0
50148;5430;8;0;0;0;0;.00nan;0;0
50219;536;27;100;24;0;24;1.000;3600000;0
50219;613;20;78;46;5;41;.891;3600000;0
50219;952;20;0;0;0;0;.00nan;0;0
50219;2062;27;0;0;0;0;.00nan;0;0
50222;443;7;0;0;0;0;.00nan;0;0
50222;762;25;0;0;0;0;.00nan;0;0
50222;1651;7;83;22;1;21;.955;3600000;0
50222;3273;25;49;35;6;29;.829;3600000;0
49521;904;29;0;0;0;0;.00nan;0;0
49521;1294;9;69;35;4;31;.886;3600000;0
49521;3462;29;82;35;3;32;.914;3600000;0
49521;5934;9;0;0;0;0;.00nan;0;0
50209;150;26;0;0;0;0;.00nan;0;0
50209;457;23;0;0;0;0;.00nan;0;0
50209;830;26;75;33;3;30;.909;3541650;0
50209;6515;23;85;31;2;29;.935;3600000;0
50225;879;124;0;0;0;0;.00nan;0;0
50225;1222;10;0;0;0;0;.00nan;0;0
50225;1658;124;77;34;3;31;.912;3459150;0
50225;6527;10;100;40;1;39;.975;3600000;0
49496;945;30;0;0;0;0;.00nan;0;0
49496;1021;30;77;31;3;28;.903;3900000;0
49496;2664;17;0;0;0;0;.00nan;0;0
49496;5872;17;82;34;3;31;.912;3900000;0
49424;862;2;0;0;0;0;.00nan;0;0
49424;1664;31;0;0;0;0;.00nan;0;0
49424;2965;31;43;26;5;21;.808;3600000;0
49424;5935;2;100;31;0;31;1.000;3600000;0
49415;443;7;0;0;0;0;.00nan;0;0
49415;1651;7;96;42;2;40;.952;3600000;0
49415;1652;0;80;41;4;37;.902;3510250;0
49415;6446;0;0;0;0;0;.00nan;0;0
49501;567;24;0;0;0;0;.00nan;0;0
49501;879;124;66;21;2;19;.905;3600000;0
49501;1658;124;0;0;0;0;.00nan;0;0
49501;1828;24;46;27;5;22;.815;3600000;0
49448;384;21;0;0;0;0;.00nan;0;0
49448;540;21;59;30;4;26;.867;3600000;0
49448;929;8;100;45;2;43;.956;3600000;0
49448;5430;8;0;0;0;0;.00nan;0;0
49476;0;18;24;34;8;26;.765;3262500;0
49476;567;24;59;17;2;15;.882;3600000;0
49476;1247;18;44;4;1;3;.750;337500;0
49476;1828;24;0;0;0;0;.00nan;0;0
49486;613;20;0;0;0;0;.00nan;0;0
49486;952;20;84;37;3;34;.919;3600000;0
49486;2664;17;67;34;4;30;.882;3550750;0
49486;5872;17;0;0;0;0;.00nan;0;0
49579;457;23;0;0;0;0;.00nan;0;0
49579;904;29;48;6;1;5;.833;673050;0
49579;3462;29;40;31;6;25;.806;2926950;0
49579;6515;23;67;33;4;29;.879;3600000;0
49445;762;25;82;42;4;38;.905;3537150;0
49445;945;30;55;21;3;18;.857;3600000;0
49445;1021;30;0;0;0;0;.00nan;0;0
49445;3273;25;0;0;0;0;.00nan;0;0
49438;442;12;73;22;2;20;.909;3600000;0
49438;1652;0;57;23;3;20;.870;1460850;0
49438;3756;12;0;0;0;0;.00nan;0;0
49438;6446;0;28;25;6;19;.760;2139150;0
49426;530;28;75;25;2;23;.920;3600000;0
49426;862;2;0;0;0;0;.00nan;0;0
49426;982;28;0;0;0;0;.00nan;0;0
49426;5935;2;43;33;6;27;.818;3600000;0
49564;443;7;67;21;2;19;.905;3600000;0
49564;690;152;0;0;0;0;.00nan;0;0
49564;1651;7;0;0;0;0;.00nan;0;0
49564;5950;152;90;52;5;47;.904;3600000;0
49504;384;21;56;27;4;23;.852;3740200;0
49504;540;21;0;0;0;0;.00nan;0;0
49504;1222;10;70;29;3;26;.897;3740200;0
49504;6527;10;0;0;0;0;.00nan;0;0
49437;668;14;0;0;0;0;.00nan;0;0
49437;933;19;77;27;2;25;.926;3600000;0
49437;1218;14;79;39;4;35;.897;3600000;0
49437;1615;19;0;0;0;0;.00nan;0;0
49390;536;27;73;38;4;34;.895;3582650;0
49390;864;3;0;0;0;0;.00nan;0;0
49390;1064;3;87;38;3;35;.921;3600000;0
49390;2062;27;0;0;0;0;.00nan;0;0
49403;536;27;82;40;4;36;.900;3830200;0
49403;1664;31;73;34;3;31;.912;3830200;0
49403;2062;27;0;0;0;0;.00nan;0;0
49403;2965;31;0;0;0;0;.00nan;0;0
49568;703;1;0;0;0;0;.00nan;0;0
49568;1222;10;0;0;0;0;.00nan;0;0
49568;3513;1;100;41;0;41;1.000;3600000;0
49568;6527;10;86;45;3;42;.933;3600000;0
49465;150;26;0;0;0;0;.00nan;0;0
49465;830;26;89;28;1;27;.964;3572700;0
49465;945;30;0;0;0;0;.00nan;0;0
49465;1021;30;94;19;0;19;1.000;3600000;0
49425;0;18;0;0;0;0;.00nan;0;0
49425;1247;18;88;32;2;30;.938;3600000;0
49425;2664;17;0;0;0;0;.00nan;0;0
49425;5872;17;66;33;4;29;.879;3568400;0
49431;879;124;0;0;0;0;.00nan;0;0
49431;929;8;89;27;1;26;.963;3600000;0
49431;1658;124;82;36;3;33;.917;3491000;0
49431;5430;8;0;0;0;0;.00nan;0;0
49593;443;7;0;0;0;0;.00nan;0;0
49593;1294;9;54;25;4;21;.840;3600000;0
49593;1651;7;65;39;5;34;.872;3569800;0
49593;5934;9;0;0;0;0;.00nan;0;0
49418;762;25;72;18;1;17;.944;3600000;0
49418;904;3;40;23;5;18;.783;3600000;0
49418;1064;3;0;0;0;0;.00nan;0;0
49418;3273;25;0;0;0;0;.00nan;0;0
49512;442;12;0;0;0;0;.00nan;0;0
49512;690;152;52;14;2;12;.857;1367900;0
49512;1831;12;66;21;2;19;.905;3600000;0
49512;5950;152;43;33;6;27;.818;2232100;0
49446;150;26;0;0;0;0;.00nan;0;0
49446;830;26;91;43;2;41;.953;3600000;0
49446;862;2;55;28;4;24;.857;3558800;0
49446;5935;2;0;0;0;0;.00nan;0;0
49541;457;28;85;37;3;34;.919;3529900;0
49541;703;1;0;0;0;0;.00nan;0;0
49541;982;28;0;0;0;0;.00nan;0;0
49541;3513;1;73;25;2;23;.920;3600000;0
49682;530;23;28;37;8;29;.784;2802600;0
49682;3462;29;56;20;3;17;.850;3600000;0
49682;6515;23;77;16;0;16;1.000;797400;0
49397;613;20;23;27;7;20;.741;2399700;0
49397;668;14;0;0;0;0;.00nan;0;0
49397;952;20;53;9;1;8;.889;1200300;0
49397;1218;14;76;20;1;19;.950;3600000;0
49618;1222;10;70;33;4;29;.879;3709750;0
49618;1294;9;0;0;0;0;.00nan;0;0
49618;5934;9;68;26;3;23;.885;3709750;0
49618;6527;10;0;0;0;0;.00nan;0;0
49528;442;12;0;0;0;0;.00nan;0;0
49528;933;19;93;46;3;43;.935;3900000;0
49528;1615;19;0;0;0;0;.00nan;0;0
49528;1831;12;69;27;3;24;.889;3883450;0
49417;536;27;100;28;0;28;1.000;3600000;0
49417;1664;31;0;0;0;0;.00nan;0;0
49417;2062;27;0;0;0;0;.00nan;0;0
49417;2965;31;32;27;6;21;.778;3600000;0
49491;384;21;0;0;0;0;.00nan;0;0
49491;540;21;65;26;3;23;.885;3600000;0
49491;613;20;0;0;0;0;.00nan;0;0
49491;952;20;70;36;4;32;.889;3565700;0
49606;690;152;0;0;0;0;.00nan;0;0
49606;3462;29;57;28;4;24;.857;3600000;0
49606;5950;152;56;46;7;39;.848;3600000;0
49523;879;124;0;0;0;0;.00nan;0;0
49523;933;19;0;0;0;0;.00nan;0;0
49523;1615;19;51;19;3;16;.842;3551150;0
49523;1658;124;83;23;1;22;.957;3600000;0
49422;668;14;52;25;4;21;.840;1175750;0
49422;929;8;49;24;4;20;.833;2251950;0
49422;1218;14;80;16;0;16;1.000;2424250;0
49422;5430;8;69;17;1;16;.941;1324600;0
49505;150;26;0;0;0;0;.00nan;0;0
49505;830;26;99;40;2;38;.950;3900000;0
49505;2664;17;0;0;0;0;.00nan;0;0
49505;5872;17;77;29;2;27;.931;3900000;0
49430;762;25;75;41;4;37;.902;3893250;0
49430;1652;0;94;57;5;52;.912;3893250;0
49430;3273;25;0;0;0;0;.00nan;0;0
49430;6446;0;0;0;0;0;.00nan;0;0
49447;0;18;28;7;3;4;.571;374650;0
49447;904;3;0;0;0;0;.00nan;0;0
49447;1064;3;73;36;4;32;.889;3600000;0
49447;1247;18;76;32;3;29;.906;3201500;0
49925;530;23;0;0;0;0;.00nan;0;0
49925;945;30;58;17;2;15;.882;1877850;0
49925;1021;30;28;13;4;9;.692;1722150;0
49925;6515;23;67;32;4;28;.875;3600000;0
50201;567;24;0;0;0;0;.00nan;0;0
50201;1664;31;73;31;3;28;.903;3600000;0
50201;1828;24;67;33;4;29;.879;3596800;0
50201;2965;31;0;0;0;0;.00nan;0;0
49543;457;28;80;29;2;27;.931;3510800;0
49543;703;1;0;0;0;0;.00nan;0;0
49543;982;28;0;0;0;0;.00nan;0;0
49543;3513;1;100;36;1;35;.972;3600000;0
50216;384;21;0;0;0;0;.00nan;0;0
50216;540;21;84;50;5;45;.900;3600000;0
50216;668;14;84;24;1;23;.958;3600000;0
50216;1218;14;0;0;0;0;.00nan;0;0
49419;0;18;0;0;0;0;.00nan;0;0
49419;536;27;52;38;6;32;.842;3062950;0
49419;1247;18;80;44;5;39;.886;3600000;0
49419;2062;27;50;1;0;1;1.000;452900;0
49490;904;3;83;42;4;38;.905;3577150;0
49490;945;30;0;0;0;0;.00nan;0;0
49490;1021;30;69;22;2;20;.909;3600000;0
49490;1064;3;0;0;0;0;.00nan;0;0
49514;442;12;0;0;0;0;.00nan;0;0
49514;1664;31;74;29;3;26;.897;3600000;0
49514;1831;12;71;42;5;37;.881;3558350;0
49514;2965;31;0;0;0;0;.00nan;0;0
49493;613;20;83;35;3;32;.914;3600000;0
49493;952;20;0;0;0;0;.00nan;0;0
49493;1652;0;59;30;4;26;.867;3581200;0
49493;6446;0;0;0;0;0;.00nan;0;0
49469;150;26;52;2;0;2;1.000;397450;0
49469;830;26;28;25;6;19;.760;3202550;0
49469;929;8;93;35;2;33;.943;3600000;0
49469;5430;8;0;0;0;0;.00nan;0;0
49511;690;152;0;0;0;0;.00nan;0;0
49511;2664;17;86;26;1;25;.962;3600000;0
49511;5872;17;0;0;0;0;.00nan;0;0
49511;5950;152;68;35;4;31;.886;3600000;0
49443;530;23;90;51;4;47;.922;3600000;0
49443;536;27;78;20;1;19;.950;3600000;0
49443;2062;27;0;0;0;0;.00nan;0;0
49443;6515;23;0;0;0;0;.00nan;0;0
49462;0;18;0;0;0;0;.00nan;0;0
49462;668;14;0;0;0;0;.00nan;0;0
49462;1218;14;100;32;1;31;.969;3600000;0
49462;1247;18;66;34;4;30;.882;3600000;0
49524;150;26;53;3;0;3;1.000;492150;0
49524;830;26;64;43;6;37;.860;3107850;0
49524;904;3;0;0;0;0;.00nan;0;0
49524;1064;3;86;25;1;24;.960;3600000;0
49450;762;25;39;29;6;23;.793;3664850;0
49450;3273;25;0;0;0;0;.00nan;0;0
49450;3462;29;38;34;7;27;.794;3664850;0
49562;442;12;0;0;0;0;.00nan;0;0
49562;443;7;0;0;0;0;.00nan;0;0
49562;1651;7;100;43;1;42;.977;3600000;0
49562;1831;12;87;33;2;31;.939;3566900;0
49454;879;124;0;0;0;0;.00nan;0;0
49454;1658;124;100;41;2;39;.951;3600000;0
49454;1664;31;0;0;0;0;.00nan;0;0
49454;2965;31;64;33;4;29;.879;3525150;0
49555;933;19;61;31;4;27;.871;3600000;0
49555;1222;10;91;29;1;28;.966;3600000;0
49555;1615;19;0;0;0;0;.00nan;0;0
49555;6527;10;0;0;0;0;.00nan;0;0
49483;457;28;59;6;0;6;1.000;618500;0
49483;862;2;0;0;0;0;.00nan;0;0
49483;982;28;44;33;6;27;.818;2981500;0
49483;5935;2;79;28;2;26;.929;3600000;0
49556;945;30;53;21;3;18;.857;3552850;0
49556;1021;30;0;0;0;0;.00nan;0;0
49556;1294;9;74;25;2;23;.920;3600000;0
49556;5934;9;0;0;0;0;.00nan;0;0
49466;929;8;37;36;7;29;.806;2147650;0
49466;1652;0;91;29;1;28;.966;3600000;0
49466;5430;8;43;9;2;7;.778;1452350;0
49466;6446;0;0;0;0;0;.00nan;0;0
49458;668;14;0;0;0;0;.00nan;0;0
49458;703;1;0;0;0;0;.00nan;0;0
49458;1218;14;66;27;3;24;.889;3600000;0
49458;3513;1;69;47;6;41;.872;3600000;0
49470;929;8;58;28;4;24;.857;3564450;0
49470;933;19;91;34;2;32;.941;3600000;0
49470;1615;19;0;0;0;0;.00nan;0;0
49470;2123;8;0;0;0;0;.00nan;0;0
49495;613;20;0;0;0;0;.00nan;0;0
49495;952;20;100;41;1;40;.976;3600000;0
49495;1664;31;86;37;3;34;.919;3581650;0
49495;2965;31;0;0;0;0;.00nan;0;0
49500;1222;10;21;9;4;5;.556;822350;0
49500;1652;0;0;0;0;0;.00nan;0;0
49500;6446;0;65;19;2;17;.895;3600000;0
49500;6527;10;43;21;4;17;.810;2777650;0
49973;530;23;0;0;0;0;.00nan;0;0
49973;945;30;0;0;0;0;.00nan;0;0
49973;1021;30;69;28;3;25;.893;3600000;0
49973;6515;23;48;24;4;20;.833;3590100;0
49588;443;7;91;46;4;42;.913;3600000;0
49588;457;28;49;30;5;25;.833;3552250;0
49588;982;28;0;0;0;0;.00nan;0;0
49588;1651;7;0;0;0;0;.00nan;0;0
49522;150;26;0;0;0;0;.00nan;0;0
49522;830;26;82;41;4;37;.902;3564050;0
49522;3462;29;62;24;3;21;.875;3600000;0
49519;384;21;0;0;0;0;.00nan;0;0
49519;540;21;95;30;1;29;.967;3600000;0
49519;2664;17;0;0;0;0;.00nan;0;0
49519;5872;17;70;35;4;31;.886;3600000;0
49532;690;152;77;39;4;35;.897;3580050;0
49532;879;124;0;0;0;0;.00nan;0;0
49532;1658;124;68;28;3;25;.893;3600000;0
49532;5950;152;0;0;0;0;.00nan;0;0
49453;536;27;72;30;3;27;.900;3755150;0
49453;1294;9;75;38;4;34;.895;3755150;0
49453;2062;27;0;0;0;0;.00nan;0;0
49453;5934;9;0;0;0;0;.00nan;0;0
49976;530;23;100;36;1;35;.972;3600000;0
49976;1294;9;0;0;0;0;.00nan;0;0
49976;5934;9;44;22;4;18;.818;3600000;0
49976;6515;23;0;0;0;0;.00nan;0;0
49539;384;21;61;30;4;26;.867;3799800;0
49539;540;21;0;0;0;0;.00nan;0;0
49539;904;3;76;42;5;37;.881;3799800;0
49539;1064;3;0;0;0;0;.00nan;0;0
49441;668;14;95;43;3;40;.930;3600000;0
49441;1218;14;0;0;0;0;.00nan;0;0
49441;1222;10;38;30;6;24;.800;3228550;0
49441;6527;10;39;1;1;0;.000;371450;0
49525;567;24;0;0;0;0;.00nan;0;0
49525;862;2;60;36;5;31;.861;3547300;0
49525;1828;24;76;37;4;33;.892;3600000;0
49525;5935;2;0;0;0;0;.00nan;0;0
49489;703;1;72;37;4;33;.892;3513200;0
49489;762;25;0;0;0;0;.00nan;0;0
49489;3273;25;89;33;2;31;.939;3600000;0
49489;3513;1;0;0;0;0;.00nan;0;0
49589;442;12;0;0;0;0;.00nan;0;0
49589;690;152;0;0;0;0;.00nan;0;0
49589;1831;12;57;33;5;28;.848;3600000;0
49589;5950;152;100;35;0;35;1.000;3600000;0
49516;0;18;0;0;0;0;.00nan;0;0
49516;443;7;0;0;0;0;.00nan;0;0
49516;1247;18;84;25;1;24;.960;3600000;0
49516;1651;7;74;38;4;34;.895;3600000;0
49499;613;20;91;33;2;31;.939;3600000;0
49499;879;124;0;0;0;0;.00nan;0;0
49499;952;20;0;0;0;0;.00nan;0;0
49499;1658;124;52;30;5;25;.833;3600000;0
49578;457;28;89;40;3;37;.925;3562150;0
49578;933;19;57;16;2;14;.875;3600000;0
49578;982;28;0;0;0;0;.00nan;0;0
49578;1615;19;0;0;0;0;.00nan;0;0
50221;567;24;82;30;2;28;.933;3533350;0
50221;929;8;100;25;0;25;1.000;3600000;0
50221;1828;24;0;0;0;0;.00nan;0;0
50221;2123;8;0;0;0;0;.00nan;0;0
49536;862;2;0;0;0;0;.00nan;0;0
49536;2664;17;0;0;0;0;.00nan;0;0
49536;5872;17;53;33;5;28;.848;3600000;0
49536;5935;2;81;23;1;22;.957;3600000;0
49561;703;1;0;0;0;0;.00nan;0;0
49561;762;25;0;0;0;0;.00nan;0;0
49561;3273;25;100;30;0;30;1.000;3600000;0
49561;3513;1;85;31;2;29;.935;3559150;0
49542;384;21;0;0;0;0;.00nan;0;0
49542;540;21;55;34;5;29;.853;3533650;0
49542;3462;29;88;39;3;36;.923;3600000;0
49484;668;14;0;0;0;0;.00nan;0;0
49484;690;152;0;0;0;0;.00nan;0;0
49484;1218;14;68;34;4;30;.882;3600000;0
49484;5950;152;94;53;5;48;.906;3567150;0
49478;762;25;0;0;0;0;.00nan;0;0
49478;929;8;11;15;6;9;.600;3245200;0
49478;2123;8;44;4;1;3;.750;354800;0
49478;3273;25;100;25;0;25;1.000;3600000;0
49548;945;30;0;0;0;0;.00nan;0;0
49548;1021;30;67;21;2;19;.905;3600000;0
49548;2664;17;0;0;0;0;.00nan;0;0
49548;5872;17;83;36;3;33;.917;3600000;0
49650;933;19;91;46;4;42;.913;3600000;0
49650;1615;19;0;0;0;0;.00nan;0;0
49650;3462;29;53;31;5;26;.839;3600000;0
49601;442;12;0;0;0;0;.00nan;0;0
49601;613;20;0;0;0;0;.00nan;0;0
49601;952;20;37;30;6;24;.800;3600000;0
49601;1831;12;67;27;3;24;.889;3600000;0
49474;536;27;75;39;4;35;.897;3549400;0
49474;1294;9;79;33;3;30;.909;3600000;0
49474;2062;27;0;0;0;0;.00nan;0;0
49474;5934;9;0;0;0;0;.00nan;0;0
49551;530;23;30;26;6;20;.769;3600000;0
49551;904;3;90;39;3;36;.923;3600000;0
49551;1064;3;0;0;0;0;.00nan;0;0
49551;6515;23;0;0;0;0;.00nan;0;0
49535;1222;10;0;0;0;0;.00nan;0;0
49535;1664;31;100;30;0;30;1.000;3600000;0
49535;2965;31;0;0;0;0;.00nan;0;0
49535;6527;10;90;28;1;27;.964;3541350;0
49472;443;7;100;45;3;42;.933;3600000;0
49472;668;14;53;27;4;23;.852;2370350;0
49472;1218;14;58;5;0;5;1.000;1173150;0
49472;1651;7;0;0;0;0;.00nan;0;0
49534;384;21;0;0;0;0;.00nan;0;0
49534;540;21;100;27;0;27;1.000;3600000;0
49534;879;124;0;0;0;0;.00nan;0;0
49534;1658;124;68;40;5;35;.875;3600000;0
49570;0;18;0;0;0;0;.00nan;0;0
49570;567;24;0;0;0;0;.00nan;0;0
49570;1247;18;72;18;1;17;.944;3600000;0
49570;1828;24;59;30;4;26;.867;3600000;0
49515;703;1;0;0;0;0;.00nan;0;0
49515;1652;0;54;38;6;32;.842;2653750;0
49515;3513;1;55;38;6;32;.842;3600000;0
49515;6446;0;46;11;2;9;.818;908450;0
49475;613;20;91;47;4;43;.915;3600000;0
49475;929;8;0;0;0;0;.00nan;0;0
49475;952;20;0;0;0;0;.00nan;0;0
49475;2123;8;80;22;1;21;.955;3600000;0
49459;150;26;0;0;0;0;.00nan;0;0
49459;536;27;81;23;1;22;.957;3600000;0
49459;830;26;44;40;7;33;.825;3600000;0
49459;2062;27;0;0;0;0;.00nan;0;0
49557;762;25;0;0;0;0;.00nan;0;0
49557;2664;17;0;0;0;0;.00nan;0;0
49557;3273;25;60;36;5;31;.861;3565750;0
49557;5872;17;86;38;3;35;.921;3600000;0
49592;457;28;44;4;1;3;.750;1314750;0
49592;945;30;0;0;0;0;.00nan;0;0
49592;982;28;23;16;5;11;.688;2285250;0
49592;1021;30;63;25;3;22;.880;3600000;0
49552;862;2;0;0;0;0;.00nan;0;0
49552;1294;9;82;29;2;27;.931;3600000;0
49552;5934;9;0;0;0;0;.00nan;0;0
49552;5935;2;37;24;5;19;.792;3600000;0
49533;1652;0;0;0;0;0;.00nan;0;0
49533;1664;31;0;0;0;0;.00nan;0;0
49533;2965;31;77;27;2;25;.926;3600000;0
49533;6446;0;84;37;3;34;.919;3562550;0
49463;536;27;99;21;0;21;1.000;3600000;0
49463;933;19;56;28;4;24;.857;1992000;0
49463;1615;19;46;11;2;9;.818;1608000;0
49463;2062;27;0;0;0;0;.00nan;0;0
49681;457;28;0;0;0;0;.00nan;0;0
49681;945;30;0;0;0;0;.00nan;0;0
49681;982;28;96;30;1;29;.967;3600000;0
49681;1021;30;79;28;2;26;.929;3548200;0
49526;150;26;0;0;0;0;.00nan;0;0
49526;690;152;88;42;4;38;.905;3648850;0
49526;830;26;77;31;3;28;.903;3648850;0
49526;5950;152;0;0;0;0;.00nan;0;0
49596;384;21;53;9;1;8;.889;1274000;0
49596;530;23;0;0;0;0;.00nan;0;0
49596;540;21;30;26;6;20;.769;2326000;0
49596;6515;23;66;26;3;23;.885;3600000;0
49600;862;2;65;32;4;28;.875;3600000;0
49600;1294;9;48;6;1;5;.833;791450;0
49600;5934;9;37;28;6;22;.786;2808550;0
49600;5935;2;0;0;0;0;.00nan;0;0
49494;929;8;66;33;4;29;.879;3703550;0
49494;1222;10;0;0;0;0;.00nan;0;0
49494;2123;8;0;0;0;0;.00nan;0;0
49494;6527;10;63;37;5;32;.865;3703550;0
49611;0;18;0;0;0;0;.00nan;0;0
49611;703;1;0;0;0;0;.00nan;0;0
49611;738;18;71;42;5;37;.881;3600000;0
49611;3513;1;84;36;3;33;.917;3600000;0
49538;879;124;0;0;0;0;.00nan;0;0
49538;1658;124;66;25;3;22;.880;3600000;0
49538;2664;17;54;26;4;22;.846;3540300;0
49538;5872;17;0;0;0;0;.00nan;0;0
49550;668;14;65;20;2;18;.900;2507900;0
49550;1218;14;14;11;5;6;.545;1092100;0
49550;3462;29;87;32;2;30;.938;3600000;0
49720;442;12;67;26;3;23;.885;3600000;0
49720;933;19;64;33;4;29;.879;3590200;0
49720;1615;19;0;0;0;0;.00nan;0;0
49720;1831;12;0;0;0;0;.00nan;0;0
49520;0;18;0;0;0;0;.00nan;0;0
49520;738;18;82;24;1;23;.958;3600000;0
49520;1222;10;62;35;5;30;.857;3600000;0
49520;6527;10;0;0;0;0;.00nan;0;0
49545;150;26;0;0;0;0;.00nan;0;0
49545;690;152;0;0;0;0;.00nan;0;0
49545;830;26;100;41;1;40;.976;3900000;0
49545;5950;152;98;40;1;39;.975;3900000;0
49517;1664;31;83;39;4;35;.897;3900000;0
49517;2965;31;0;0;0;0;.00nan;0;0
49517;3462;29;71;37;4;33;.892;3900000;0
49590;384;21;0;0;0;0;.00nan;0;0
49590;530;23;100;41;1;40;.976;3600000;0
49590;540;21;68;23;2;21;.913;3549100;0
49590;6515;23;0;0;0;0;.00nan;0;0
49540;879;124;83;28;2;26;.929;3600000;0
49540;1652;0;0;0;0;0;.00nan;0;0
49540;1658;124;0;0;0;0;.00nan;0;0
49540;6446;0;63;26;3;23;.885;3600000;0
49583;762;25;0;0;0;0;.00nan;0;0
49583;904;3;0;0;0;0;.00nan;0;0
49583;1064;3;85;36;3;33;.917;3600000;0
49583;3273;25;40;31;6;25;.806;3600000;0
49529;613;20;59;28;4;24;.857;3600000;0
49529;904;3;79;47;5;42;.894;3598950;0
49529;952;20;0;0;0;0;.00nan;0;0
49529;1064;3;0;0;0;0;.00nan;0;0
49620;442;12;78;31;3;28;.903;3600000;0
49620;862;2;0;0;0;0;.00nan;0;0
49620;1831;12;0;0;0;0;.00nan;0;0
49620;5935;2;52;37;6;31;.838;3600000;0
49833;443;7;67;40;5;35;.875;3563950;0
49833;703;1;0;0;0;0;.00nan;0;0
49833;1651;7;0;0;0;0;.00nan;0;0
49833;3513;1;75;37;4;33;.892;3600000;0
49631;457;28;61;31;4;27;.871;3579300;0
49631;567;24;0;0;0;0;.00nan;0;0
49631;982;28;0;0;0;0;.00nan;0;0
49631;1828;24;93;35;2;33;.943;3600000;0
49625;567;24;100;34;0;34;1.000;3600000;0
49625;929;8;17;19;6;13;.684;3600000;0
49625;1828;24;0;0;0;0;.00nan;0;0
49625;2123;8;0;0;0;0;.00nan;0;0
49558;933;19;90;32;2;30;.938;3856100;0
49558;1615;19;0;0;0;0;.00nan;0;0
49558;1652;0;100;41;1;40;.976;3856100;0
49558;6446;0;0;0;0;0;.00nan;0;0
49940;442;12;100;37;1;36;.973;3900000;0
49940;530;23;98;39;1;38;.974;3900000;0
49940;1831;12;0;0;0;0;.00nan;0;0
49940;6515;23;0;0;0;0;.00nan;0;0
49660;384;21;0;0;0;0;.00nan;0;0
49660;443;7;0;0;0;0;.00nan;0;0
49660;540;21;76;33;3;30;.909;3600000;0
49660;1651;7;91;32;1;31;.969;3600000;0
49566;150;26;0;0;0;0;.00nan;0;0
49566;668;14;0;0;0;0;.00nan;0;0
49566;830;26;76;39;4;35;.897;3574000;0
49566;1218;14;76;32;3;29;.906;3600000;0
49736;945;30;48;23;4;19;.826;3600000;0
49736;1021;30;0;0;0;0;.00nan;0;0
49736;1664;31;72;41;5;36;.878;3551450;0
49736;2965;31;0;0;0;0;.00nan;0;0
49481;536;27;0;0;0;0;.00nan;0;0
49481;1222;10;0;0;0;0;.00nan;0;0
49481;2062;27;65;27;3;24;.889;3535300;0
49481;6527;10;93;38;2;36;.947;3600000;0
49571;690;152;69;16;1;15;.938;3600000;0
49571;862;2;96;39;2;37;.949;3598700;0
49571;5935;2;0;0;0;0;.00nan;0;0
49571;5950;152;0;0;0;0;.00nan;0;0
49584;613;20;0;0;0;0;.00nan;0;0
49584;952;20;70;30;3;27;.900;3547100;0
49584;2664;17;0;0;0;0;.00nan;0;0
49584;5872;17;78;27;2;25;.926;3600000;0
49656;457;28;54;39;6;33;.846;3600000;0
49656;762;25;0;0;0;0;.00nan;0;0
49656;982;28;0;0;0;0;.00nan;0;0
49656;3273;25;88;31;2;29;.935;3600000;0
49537;703;1;0;0;0;0;.00nan;0;0
49537;1664;31;0;0;0;0;.00nan;0;0
49537;2965;31;72;30;3;27;.900;3600000;0
49537;3513;1;73;44;5;39;.886;3600000;0
49723;567;24;17;19;6;13;.684;1839150;0
49723;862;2;0;0;0;0;.00nan;0;0
49723;1828;24;62;13;1;12;.923;1760850;0
49723;5935;2;64;14;1;13;.929;3600000;0
49567;613;20;94;37;2;35;.946;3825700;0
49567;952;20;0;0;0;0;.00nan;0;0
49567;1222;10;79;34;3;31;.912;3825700;0
49567;6527;10;0;0;0;0;.00nan;0;0
49559;1294;9;80;42;4;38;.905;3856650;0
49559;1652;0;0;0;0;0;.00nan;0;0
49559;5934;9;0;0;0;0;.00nan;0;0
49559;6446;0;79;34;3;31;.912;3856650;0
49546;150;26;0;0;0;0;.00nan;0;0
49546;830;26;91;41;3;38;.927;3600000;0
49546;3462;29;82;43;4;39;.907;3554800;0
49479;536;27;59;34;5;29;.853;3874500;0
49479;879;124;92;35;2;33;.943;2995300;0
49479;1658;124;31;14;4;10;.714;879200;0
49479;2062;27;0;0;0;0;.00nan;0;0
49586;668;14;69;22;2;20;.909;3771650;0
49586;945;30;0;0;0;0;.00nan;0;0
49586;1021;30;70;28;3;25;.893;3771650;0
49586;1218;14;0;0;0;0;.00nan;0;0
49627;384;21;76;38;4;34;.895;3600000;0
49627;540;21;0;0;0;0;.00nan;0;0
49627;690;152;0;0;0;0;.00nan;0;0
49627;5950;152;40;37;7;30;.811;3565000;0
49498;0;18;68;35;4;31;.886;3600000;0
49498;738;18;0;0;0;0;.00nan;0;0
49498;929;8;91;30;1;29;.967;3600000;0
49498;2123;8;0;0;0;0;.00nan;0;0
49648;457;28;0;0;0;0;.00nan;0;0
49648;762;25;100;26;0;26;1.000;3600000;0
49648;982;28;47;22;4;18;.818;3600000;0
49648;3273;25;0;0;0;0;.00nan;0;0
49708;443;7;73;43;5;38;.884;3600000;0
49708;530;23;0;0;0;0;.00nan;0;0
49708;1651;7;0;0;0;0;.00nan;0;0
49708;6515;23;75;26;2;24;.923;3600000;0
49623;904;3;0;0;0;0;.00nan;0;0
49623;1064;3;53;27;4;23;.852;3510200;0
49623;1294;9;0;0;0;0;.00nan;0;0
49623;5934;9;80;28;2;26;.929;3600000;0
49553;879;124;0;0;0;0;.00nan;0;0
49553;1658;124;51;30;5;25;.833;3600000;0
49553;3462;29;43;33;6;27;.818;3568800;0
49565;703;1;100;21;0;21;1.000;3600000;0
49565;2664;17;77;22;1;21;.955;2064550;0
49565;3513;1;0;0;0;0;.00nan;0;0
49565;5872;17;24;22;6;16;.727;1535450;0
49633;0;18;97;39;2;37;.949;3545700;0
49633;442;12;87;25;1;24;.960;3600000;0
49633;738;18;0;0;0;0;.00nan;0;0
49633;1831;12;0;0;0;0;.00nan;0;0
49563;862;2;0;0;0;0;.00nan;0;0
49563;1664;31;96;30;1;29;.967;3600000;0
49563;2965;31;0;0;0;0;.00nan;0;0
49563;5935;2;83;31;2;29;.935;3576950;0
49569;457;28;39;37;7;30;.811;3600000;0
49569;982;28;0;0;0;0;.00nan;0;0
49569;1652;0;83;36;3;33;.917;3600000;0
49569;6446;0;0;0;0;0;.00nan;0;0
49624;762;25;87;15;0;15;1.000;3600000;0
49624;933;19;66;28;3;25;.893;3600000;0
49624;1615;19;0;0;0;0;.00nan;0;0
49624;3273;25;0;0;0;0;.00nan;0;0
49506;150;26;0;0;0;0;.00nan;0;0
49506;830;26;63;37;5;32;.865;3600000;0
49506;929;8;43;32;6;26;.813;3555900;0
49506;2123;8;0;0;0;0;.00nan;0;0
49587;442;12;73;19;1;18;.947;3600000;0
49587;1831;12;0;0;0;0;.00nan;0;0
49587;2664;17;23;22;6;16;.727;1899750;0
49587;5872;17;57;17;2;15;.882;1700250;0
49674;443;7;0;0;0;0;.00nan;0;0
49674;613;20;26;6;3;3;.500;366550;0
49674;952;20;90;28;1;27;.964;3233450;0
49674;1651;7;98;21;0;21;1.000;3600000;0
49639;567;24;0;0;0;0;.00nan;0;0
49639;690;152;85;37;3;34;.919;3541900;0
49639;1828;24;100;37;1;36;.973;3600000;0
49639;5950;152;0;0;0;0;.00nan;0;0
49508;536;27;71;29;3;26;.897;3783250;0
49508;668;14;0;0;0;0;.00nan;0;0
49508;1218;14;91;47;4;43;.915;3783250;0
49508;2062;27;0;0;0;0;.00nan;0;0
49831;384;21;48;6;1;5;.833;929800;0
49831;540;21;5;23;8;15;.652;2670200;0
49831;1222;10;0;0;0;0;.00nan;0;0
49831;6527;10;73;31;3;28;.903;3600000;0
49665;530;23;73;38;4;34;.895;3566800;0
49665;904;3;98;49;3;46;.939;3600000;0
49665;1064;3;0;0;0;0;.00nan;0;0
49665;6515;23;0;0;0;0;.00nan;0;0
49513;536;27;99;32;1;31;.969;3600000;0
49513;929;8;89;35;2;33;.943;3600000;0
49513;2062;27;0;0;0;0;.00nan;0;0
49513;2123;8;0;0;0;0;.00nan;0;0
49602;384;21;27;23;6;17;.739;3003500;0
49602;540;21;54;3;0;3;1.000;596500;0
49602;1652;0;97;44;3;41;.932;3600000;0
49602;6446;0;0;0;0;0;.00nan;0;0
49603;150;26;0;0;0;0;.00nan;0;0
49603;830;26;80;22;1;21;.955;3600000;0
49603;933;19;82;34;3;31;.912;3561450;0
49603;1615;19;0;0;0;0;.00nan;0;0
49635;1222;10;0;0;0;0;.00nan;0;0
49635;1294;9;0;0;0;0;.00nan;0;0
49635;5934;9;100;36;1;35;.972;3600000;0
49635;6527;10;72;30;3;27;.900;3546850;0
49575;879;124;0;0;0;0;.00nan;0;0
49575;1658;124;46;28;5;23;.821;3552400;0
49575;2664;17;0;0;0;0;.00nan;0;0
49575;5872;17;62;29;4;25;.862;3600000;0
49617;0;18;71;43;5;38;.884;3600000;0
49617;703;1;85;31;2;29;.935;3600000;0
49617;738;18;0;0;0;0;.00nan;0;0
49617;3513;1;0;0;0;0;.00nan;0;0
49647;443;7;0;0;0;0;.00nan;0;0
49647;1651;7;89;43;4;39;.907;3637200;0
49647;1664;31;59;23;3;20;.870;3637200;0
49647;2965;31;0;0;0;0;.00nan;0;0
49640;530;23;0;0;0;0;.00nan;0;0
49640;668;14;0;0;0;0;.00nan;0;0
49640;1218;14;88;47;4;43;.915;3600000;0
49640;6515;23;96;30;1;29;.967;3600000;0
50212;567;24;0;0;0;0;.00nan;0;0
50212;945;30;67;20;2;18;.900;3600000;0
50212;1021;30;0;0;0;0;.00nan;0;0
50212;1828;24;67;33;4;29;.879;3572500;0
49582;150;26;53;3;0;3;1.000;552000;0
49582;384;21;0;0;0;0;.00nan;0;0
49582;540;21;82;29;2;27;.931;3600000;0
49582;830;26;35;29;6;23;.793;3048000;0
49718;442;12;82;24;1;23;.958;3600000;0
49718;457;28;0;0;0;0;.00nan;0;0
49718;982;28;66;32;4;28;.875;3600000;0
49718;1831;12;0;0;0;0;.00nan;0;0
49580;613;20;0;0;0;0;.00nan;0;0
49580;690;152;14;17;6;11;.647;1197150;0
49580;952;20;69;22;2;20;.909;3600000;0
49580;5950;152;67;10;0;10;1.000;2402850;0
49700;530;23;62;37;5;32;.865;3556000;0
49700;1664;31;0;0;0;0;.00nan;0;0
49700;2965;31;66;31;4;27;.871;3600000;0
49700;6515;23;0;0;0;0;.00nan;0;0
49527;536;27;91;41;3;38;.927;3600000;0
49527;862;2;62;32;4;28;.875;3562750;0
49527;2062;27;0;0;0;0;.00nan;0;0
49527;5935;2;0;0;0;0;.00nan;0;0
49605;879;124;100;39;0;39;1.000;3600000;0
49605;904;3;51;29;5;24;.828;3600000;0
49605;1064;3;0;0;0;0;.00nan;0;0
49605;1658;124;0;0;0;0;.00nan;0;0
49607;933;19;0;0;0;0;.00nan;0;0
49607;1615;19;68;33;4;29;.879;3637600;0
49607;1652;0;0;0;0;0;.00nan;0;0
49607;6446;0;91;41;3;38;.927;3673550;0
49956;762;25;52;26;4;22;.846;3512350;0
49956;888;30;0;0;0;0;.00nan;0;0
49956;945;30;46;16;3;13;.813;3600000;0
49956;3273;25;0;0;0;0;.00nan;0;0
49654;738;18;0;0;0;0;.00nan;0;0
49654;1247;18;66;32;4;28;.875;3600000;0
49654;1294;9;5;12;6;6;.500;1509250;0
49654;5934;9;55;22;3;19;.864;2090750;0
49626;443;7;99;46;2;44;.957;3682350;0
49626;668;14;79;32;3;29;.906;3682350;0
49626;1218;14;0;0;0;0;.00nan;0;0
49626;1651;7;0;0;0;0;.00nan;0;0
49510;929;8;31;8;3;5;.625;1703650;0
49510;2123;8;42;20;4;16;.800;1896350;0
49510;3462;29;100;34;1;33;.971;3600000;0
49712;457;28;75;26;2;24;.923;3600000;0
49712;982;28;0;0;0;0;.00nan;0;0
49712;1222;10;0;0;0;0;.00nan;0;0
49712;6527;10;63;25;3;22;.880;3557450;0
49598;442;12;100;29;0;29;1.000;3600000;0
49598;1831;12;0;0;0;0;.00nan;0;0
49598;2664;17;49;36;6;30;.833;3600000;0
49598;5872;17;0;0;0;0;.00nan;0;0
49706;567;24;0;0;0;0;.00nan;0;0
49706;613;20;0;0;0;0;.00nan;0;0
49706;952;20;58;34;5;29;.853;3600000;0
49706;1828;24;90;32;2;30;.938;3600000;0
49509;536;27;42;32;6;26;.813;3574750;0
49509;703;1;0;0;0;0;.00nan;0;0
49509;2062;27;0;0;0;0;.00nan;0;0
49509;3513;1;76;37;4;33;.892;3600000;0
49530;929;8;65;22;2;20;.909;3900000;0
49530;933;19;99;38;2;36;.947;3900000;0
49530;1615;19;0;0;0;0;.00nan;0;0
49530;2123;8;0;0;0;0;.00nan;0;0
49628;862;2;58;23;3;20;.870;3600000;0
49628;1294;9;0;0;0;0;.00nan;0;0
49628;5934;9;100;24;0;24;1.000;3600000;0
49628;5935;2;0;0;0;0;.00nan;0;0
49636;443;7;0;0;0;0;.00nan;0;0
49636;690;152;0;0;0;0;.00nan;0;0
49636;1651;7;81;23;1;22;.957;3600000;0
49636;5950;152;62;35;5;30;.857;3600000;0
49599;530;23;34;22;5;17;.773;3600000;0
49599;1652;0;90;28;1;27;.964;3600000;0
49599;6446;0;0;0;0;0;.00nan;0;0
49599;6515;23;0;0;0;0;.00nan;0;0
49843;762;25;0;0;0;0;.00nan;0;0
49843;3273;25;61;31;4;27;.871;3600000;0
49843;3462;29;72;30;3;27;.900;3600000;0
49975;762;25;100;44;1;43;.977;3600000;0
49975;888;30;59;22;3;19;.864;3550500;0
49975;945;30;0;0;0;0;.00nan;0;0
49975;3273;25;0;0;0;0;.00nan;0;0
49645;457;28;57;33;5;28;.848;3183600;0
49645;668;14;0;0;0;0;.00nan;0;0
49645;982;28;48;6;1;5;.833;416400;0
49645;1218;14;73;24;2;22;.917;3600000;0
49659;862;2;0;0;0;0;.00nan;0;0
49659;904;3;84;44;3;41;.932;3638100;0
49659;1064;3;0;0;0;0;.00nan;0;0
49659;5935;2;76;27;2;25;.926;3638100;0
49634;690;152;64;21;2;19;.905;3584350;0
49634;2664;17;0;0;0;0;.00nan;0;0
49634;5872;17;87;26;1;25;.962;3600000;0
49634;5950;152;0;0;0;0;.00nan;0;0
49691;613;20;58;29;4;25;.862;3600000;0
49691;738;18;0;0;0;0;.00nan;0;0
49691;952;20;0;0;0;0;.00nan;0;0
49691;1247;18;100;31;0;31;1.000;3600000;0
49787;1652;0;0;0;0;0;.00nan;0;0
49787;3462;29;46;40;7;33;.825;3600000;0
49787;6446;0;64;31;4;27;.871;3600000;0
49629;384;21;0;0;0;0;.00nan;0;0
49629;540;21;61;36;5;31;.861;3668950;0
49629;1664;31;84;42;4;38;.905;3668950;0
49629;2965;31;0;0;0;0;.00nan;0;0
49591;703;1;0;0;0;0;.00nan;0;0
49591;904;3;0;0;0;0;.00nan;0;0
49591;1064;3;89;33;2;31;.939;3600000;0
49591;3513;1;77;33;3;30;.909;3540600;0
49595;150;26;0;0;0;0;.00nan;0;0
49595;830;26;79;40;4;36;.900;3695200;0
49595;879;124;82;43;5;38;.884;3695200;0
49595;1658;124;0;0;0;0;.00nan;0;0
49695;442;12;94;36;2;34;.944;3559600;0
49695;1222;10;0;0;0;0;.00nan;0;0
49695;1831;12;0;0;0;0;.00nan;0;0
49695;6527;10;83;24;1;23;.958;3600000;0
49735;862;2;0;0;0;0;.00nan;0;0
49735;1222;10;65;39;5;34;.872;3600000;0
49735;5935;2;66;21;2;19;.905;3600000;0
49735;6527;10;0;0;0;0;.00nan;0;0
49655;933;19;89;27;1;26;.963;3600000;0
49655;1615;19;0;0;0;0;.00nan;0;0
49655;2664;17;0;0;0;0;.00nan;0;0
49655;5872;17;90;34;2;32;.941;3597000;0
49851;442;12;0;0;0;0;.00nan;0;0
49851;567;24;0;0;0;0;.00nan;0;0
49851;1828;24;100;32;0;32;1.000;3600000;0
49851;1831;12;51;19;3;16;.842;3600000;0
49696;690;152;66;10;0;10;1.000;1329000;0
49696;904;3;67;27;3;24;.889;3600000;0
49696;1064;3;0;0;0;0;.00nan;0;0
49696;5950;152;32;26;6;20;.769;2271000;0
49637;945;30;0;0;0;0;.00nan;0;0
49637;1021;30;63;13;1;12;.923;3600000;0
49637;1652;0;52;26;4;22;.846;3600000;0
49637;6446;0;0;0;0;0;.00nan;0;0
49709;443;7;0;0;0;0;.00nan;0;0
49709;1294;9;74;26;2;24;.923;3270500;0
49709;1651;7;73;36;4;32;.889;3600000;0
49709;5934;9;23;4;3;1;.250;271200;0
49573;0;18;0;0;0;0;.00nan;0;0
49573;536;27;31;32;7;25;.781;3600000;0
49573;738;18;64;20;2;18;.900;3600000;0
49573;2062;27;0;0;0;0;.00nan;0;0
49652;904;3;0;0;0;0;.00nan;0;0
49652;1064;3;83;30;2;28;.933;3600000;0
49652;2664;17;67;39;5;34;.872;3600000;0
49652;5872;17;0;0;0;0;.00nan;0;0
49662;613;20;57;11;1;10;.909;321050;0
49662;668;14;0;0;0;0;.00nan;0;0
49662;952;20;47;34;6;28;.824;3278950;0
49662;1218;14;84;41;4;37;.902;3600000;0
49619;384;21;0;0;0;0;.00nan;0;0
49619;540;21;77;33;3;30;.909;3600000;0
49619;703;1;59;12;1;11;.917;1356900;0
49619;3513;1;43;21;4;17;.810;2205000;0
49604;150;26;0;0;0;0;.00nan;0;0
49604;762;25;0;0;0;0;.00nan;0;0
49604;830;26;94;38;2;36;.947;3818550;0
49604;3273;25;67;28;3;25;.893;3818550;0
49758;457;28;53;27;4;23;.852;3506650;0
49758;982;28;0;0;0;0;.00nan;0;0
49758;1294;9;0;0;0;0;.00nan;0;0
49758;5934;9;92;35;2;33;.943;3600000;0
50060;442;12;100;35;1;34;.971;3600000;0
50060;862;2;49;41;7;34;.829;3600000;0
50060;1831;12;0;0;0;0;.00nan;0;0
50060;5935;2;0;0;0;0;.00nan;0;0
49680;690;152;84;25;1;24;.960;3600000;0
49680;1222;10;0;0;0;0;.00nan;0;0
49680;5950;152;0;0;0;0;.00nan;0;0
49680;6527;10;84;30;2;28;.933;3554600;0
49613;933;19;0;0;0;0;.00nan;0;0
49613;1615;19;81;23;1;22;.957;3600000;0
49613;1641;29;0;0;0;0;.00nan;0;0
49613;3462;29;56;34;5;29;.853;3600000;0
49560;879;124;57;39;6;33;.846;2937350;0
49560;929;8;64;20;2;18;.900;3600000;0
49560;1658;124;55;10;1;9;.900;662650;0
49560;2123;8;0;0;0;0;.00nan;0;0
49609;879;124;0;0;0;0;.00nan;0;0
49609;1658;124;73;31;3;28;.903;3600000;0
49609;1664;31;0;0;0;0;.00nan;0;0
49609;2965;31;92;48;4;44;.917;3566200;0
49776;457;28;0;0;0;0;.00nan;0;0
49776;530;23;100;49;2;47;.959;3600000;0
49776;982;28;65;33;4;29;.879;3566200;0
49776;6515;23;0;0;0;0;.00nan;0;0
49574;536;27;0;0;0;0;.00nan;0;0
49574;929;8;0;0;0;0;.00nan;0;0
49574;2062;27;78;27;2;25;.926;3600000;0
49574;2123;8;80;41;4;37;.902;3575600;0
49653;150;26;58;35;5;30;.857;3547100;0
49653;443;7;0;0;0;0;.00nan;0;0
49653;830;26;0;0;0;0;.00nan;0;0
49653;1651;7;73;30;3;27;.900;3600000;0
49773;443;7;100;32;0;32;1.000;3600000;0
49773;668;14;0;0;0;0;.00nan;0;0
49773;1218;14;43;31;6;25;.806;3600000;0
49773;1651;7;0;0;0;0;.00nan;0;0
49651;1641;29;0;0;0;0;.00nan;0;0
49651;2664;17;0;0;0;0;.00nan;0;0
49651;3462;29;83;36;3;33;.917;3600000;0
49651;5872;17;88;45;4;41;.911;3570300;0
49649;384;21;0;0;0;0;.00nan;0;0
49649;540;21;64;44;6;38;.864;3600000;0
49649;1664;31;100;23;0;23;1.000;3600000;0
49649;2965;31;0;0;0;0;.00nan;0;0
49690;613;20;0;0;0;0;.00nan;0;0
49690;904;3;41;26;5;21;.808;3550400;0
49690;952;20;99;43;3;40;.930;3600000;0
49690;1064;3;0;0;0;0;.00nan;0;0
49612;0;18;44;15;3;12;.800;1297850;0
49612;738;18;21;27;7;20;.741;2302150;0
49612;1652;0;100;22;0;22;1.000;3600000;0
49612;6446;0;0;0;0;0;.00nan;0;0
49721;530;23;0;0;0;0;.00nan;0;0
49721;1222;10;100;42;2;40;.952;3900000;0
49721;6515;23;80;34;2;32;.941;3900000;0
49721;6527;10;0;0;0;0;.00nan;0;0
49924;457;28;45;28;5;23;.821;2739000;0
49924;567;24;0;0;0;0;.00nan;0;0
49924;982;28;52;8;1;7;.875;849500;0
49924;1828;24;86;44;4;40;.909;3600000;0
49783;929;8;66;20;2;18;.900;3600000;0
49783;1222;10;0;0;0;0;.00nan;0;0
49783;2123;8;0;0;0;0;.00nan;0;0
49783;6527;10;61;48;7;41;.854;3600000;0
49614;0;18;86;26;1;25;.962;3600000;0
49614;703;1;67;28;3;25;.893;3313900;0
49614;738;18;0;0;0;0;.00nan;0;0
49614;3513;1;28;7;3;4;.571;286100;0
49663;668;14;61;30;4;26;.867;2284500;0
49663;690;152;0;0;0;0;.00nan;0;0
49663;1218;14;49;12;2;10;.833;1315500;0
49663;5950;152;100;46;3;43;.935;3600000;0
49622;762;25;35;23;5;18;.783;3600000;0
49622;1652;0;0;0;0;0;.00nan;0;0
49622;3273;25;0;0;0;0;.00nan;0;0
49622;6446;0;100;42;2;40;.952;3600000;0
49581;536;27;72;30;3;27;.900;3600000;0
49581;945;30;72;24;2;22;.917;3600000;0
49581;1021;30;0;0;0;0;.00nan;0;0
49581;2062;27;0;0;0;0;.00nan;0;0
49677;1294;9;0;0;0;0;.00nan;0;0
49677;1641;29;0;0;0;0;.00nan;0;0
49677;3462;29;80;28;2;26;.929;3600000;0
49677;5934;9;41;31;6;25;.806;3600000;0
49703;933;19;0;0;0;0;.00nan;0;0
49703;1615;19;81;29;2;27;.931;3542300;0
49703;1664;31;79;22;1;21;.955;3600000;0
49703;2965;31;0;0;0;0;.00nan;0;0
49632;150;26;0;0;0;0;.00nan;0;0
49632;703;1;0;0;0;0;.00nan;0;0
49632;830;26;98;49;3;46;.939;3600000;0
49632;3513;1;100;22;0;22;1.000;3600000;0
49729;567;24;64;19;2;17;.895;3600000;0
49729;613;20;53;2;0;2;1.000;1108150;0
49729;952;20;38;30;6;24;.800;2491850;0
49729;1828;24;0;0;0;0;.00nan;0;0
49585;442;12;78;27;2;25;.926;3600000;0
49585;929;8;89;41;3;38;.927;3555950;0
49585;2123;8;0;0;0;0;.00nan;0;0
49585;3756;12;0;0;0;0;.00nan;0;0
49657;384;21;39;13;3;10;.769;1005550;0
49657;540;21;28;24;6;18;.750;2594450;0
49657;762;25;0;0;0;0;.00nan;0;0
49657;3273;25;40;30;6;24;.800;3600000;0
49646;879;124;0;0;0;0;.00nan;0;0
49646;945;30;98;32;1;31;.969;3600000;0
49646;1021;30;0;0;0;0;.00nan;0;0
49646;1658;124;79;34;3;31;.912;3476550;0
49979;933;19;64;19;2;17;.895;3600000;0
49979;1294;9;89;40;3;37;.925;3551850;0
49979;1615;19;0;0;0;0;.00nan;0;0
49979;5934;9;0;0;0;0;.00nan;0;0
49644;530;23;59;12;1;11;.917;1375250;0
49644;703;1;0;0;0;0;.00nan;0;0
49644;3513;1;89;36;2;34;.944;3600000;0
49644;6515;23;37;18;4;14;.778;2224750;0
49638;1222;10;0;0;0;0;.00nan;0;0
49638;1652;0;65;26;3;23;.885;3600000;0
49638;6446;0;0;0;0;0;.00nan;0;0
49638;6527;10;90;52;5;47;.904;3596300;0
49798;442;12;0;0;0;0;.00nan;0;0
49798;1641;29;0;0;0;0;.00nan;0;0
49798;3462;29;48;42;7;35;.833;3600000;0
49798;3756;12;87;38;3;35;.921;3600000;0
49608;904;3;93;49;4;45;.918;3573000;0
49608;929;8;0;0;0;0;.00nan;0;0
49608;1064;3;0;0;0;0;.00nan;0;0
49608;2123;8;72;29;3;26;.897;3600000;0
49781;443;7;82;30;2;28;.933;3600000;0
49781;457;28;45;27;5;22;.815;3166850;0
49781;982;28;55;9;1;8;.889;433150;0
49781;1651;7;0;0;0;0;.00nan;0;0
49688;150;26;0;0;0;0;.00nan;0;0
49688;567;24;0;0;0;0;.00nan;0;0
49688;830;26;69;35;4;31;.886;3600000;0
49688;1828;24;70;17;1;16;.941;3600000;0
49817;384;21;0;0;0;0;.00nan;0;0
49817;540;21;65;26;3;23;.885;3600000;0
49817;613;20;67;33;4;29;.879;3598100;0
49817;952;20;0;0;0;0;.00nan;0;0
49765;457;28;0;0;0;0;.00nan;0;0
49765;982;28;91;40;3;37;.925;3564300;0
49765;1641;29;0;0;0;0;.00nan;0;0
49765;3462;29;100;40;2;38;.950;3600000;0
49594;536;27;81;34;3;31;.912;3600000;0
49594;862;2;0;0;0;0;.00nan;0;0
49594;2062;27;0;0;0;0;.00nan;0;0
49594;5935;2;49;36;6;30;.833;3600000;0
49673;150;26;81;29;2;27;.931;3587850;0
49673;830;26;0;0;0;0;.00nan;0;0
49673;888;30;77;21;1;20;.952;3600000;0
49673;945;30;0;0;0;0;.00nan;0;0
49658;0;18;0;0;0;0;.00nan;0;0
49658;690;152;97;58;4;54;.931;3900000;0
49658;738;18;67;33;4;29;.879;3900000;0
49658;5950;152;0;0;0;0;.00nan;0;0
49667;530;23;91;41;3;38;.927;3600000;0
49667;1652;0;0;0;0;0;.00nan;0;0
49667;6446;0;45;28;5;23;.821;3510350;0
49667;6515;23;0;0;0;0;.00nan;0;0
49750;904;3;0;0;0;0;.00nan;0;0
49750;1064;3;63;38;5;33;.868;3583100;0
49750;1664;31;56;25;4;21;.840;3600000;0
49750;2965;31;0;0;0;0;.00nan;0;0
49687;762;25;0;0;0;0;.00nan;0;0
49687;933;19;86;40;3;37;.925;3900000;0
49687;1615;19;0;0;0;0;.00nan;0;0
49687;3273;25;90;38;3;35;.921;3829350;0
49685;567;24;38;24;5;19;.792;3551750;0
49685;879;124;0;0;0;0;.00nan;0;0
49685;1658;124;81;39;4;35;.897;3600000;0
49685;1828;24;0;0;0;0;.00nan;0;0
49671;703;1;0;0;0;0;.00nan;0;0
49671;1294;9;0;0;0;0;.00nan;0;0
49671;3513;1;76;33;3;30;.909;3802550;0
49671;5934;9;62;29;4;25;.862;3802550;0
49615;929;8;82;30;2;28;.933;3600000;0
49615;933;19;0;0;0;0;.00nan;0;0
49615;1615;19;66;28;3;25;.893;3556900;0
49615;2123;8;0;0;0;0;.00nan;0;0
49804;613;20;0;0;0;0;.00nan;0;0
49804;690;152;0;0;0;0;.00nan;0;0
49804;952;20;86;32;2;30;.938;3600000;0
49804;5950;152;44;39;7;32;.821;3600000;0
49679;443;7;0;0;0;0;.00nan;0;0
49679;1651;7;84;35;3;32;.914;3600000;0
49679;2664;17;0;0;0;0;.00nan;0;0
49679;5872;17;80;42;4;38;.905;3571050;0
49597;536;27;57;27;4;23;.852;3600000;0
49597;888;30;0;0;0;0;.00nan;0;0
49597;945;30;61;42;6;36;.857;3567050;0
49597;2062;27;0;0;0;0;.00nan;0;0
49778;457;28;0;0;0;0;.00nan;0;0
49778;982;28;72;40;5;35;.875;3661700;0
49778;1664;31;0;0;0;0;.00nan;0;0
49778;2965;31;66;30;4;26;.867;3661700;0
50200;530;23;78;28;2;26;.929;3739000;0
50200;668;14;0;0;0;0;.00nan;0;0
50200;1218;14;90;52;3;49;.942;3739000;0
50200;6515;23;0;0;0;0;.00nan;0;0
49630;442;12;87;42;3;39;.929;3900000;0
49630;929;8;0;0;0;0;.00nan;0;0
49630;2123;8;84;38;3;35;.921;3900000;0
49630;3756;12;0;0;0;0;.00nan;0;0
49697;0;18;66;27;3;24;.889;3600000;0
49697;738;18;0;0;0;0;.00nan;0;0
49697;762;25;64;37;5;32;.865;3481750;0
49697;3273;25;0;0;0;0;.00nan;0;0
49714;150;26;0;0;0;0;.00nan;0;0
49714;830;26;74;30;3;27;.900;3600000;0
49714;1222;10;49;36;6;30;.833;3600000;0
49714;6527;10;0;0;0;0;.00nan;0;0
49661;703;1;82;49;5;44;.898;3600000;0
49661;862;2;0;0;0;0;.00nan;0;0
49661;3513;1;0;0;0;0;.00nan;0;0
49661;5935;2;85;37;3;34;.919;3600000;0
49670;904;3;0;0;0;0;.00nan;0;0
49670;1064;3;67;29;3;26;.897;3900000;0
49670;1652;0;96;42;3;39;.929;3900000;0
49670;6446;0;0;0;0;0;.00nan;0;0
49676;879;124;58;5;0;5;1.000;909250;0
49676;1294;9;66;27;3;24;.889;3600000;0
49676;1658;124;73;47;6;41;.872;2690750;0
49676;5934;9;0;0;0;0;.00nan;0;0
49664;862;2;80;29;2;27;.931;3571700;0
49664;1664;31;90;28;1;27;.964;3600000;0
49664;2965;31;0;0;0;0;.00nan;0;0
49664;5935;2;0;0;0;0;.00nan;0;0
49666;536;27;73;25;2;23;.920;3623300;0
49666;567;24;0;0;0;0;.00nan;0;0
49666;1828;24;79;33;3;30;.909;3623300;0
49666;2062;27;0;0;0;0;.00nan;0;0
49761;1222;10;0;0;0;0;.00nan;0;0
49761;1641;29;0;0;0;0;.00nan;0;0
49761;3462;29;51;24;4;20;.833;3600000;0
49761;6527;10;68;46;6;40;.870;3545350;0
49692;384;21;0;0;0;0;.00nan;0;0
49692;540;21;64;26;3;23;.885;3600000;0
49692;879;124;76;50;6;44;.880;3600000;0
49692;1658;124;0;0;0;0;.00nan;0;0
49725;443;7;0;0;0;0;.00nan;0;0
49725;888;30;0;0;0;0;.00nan;0;0
49725;945;30;66;15;1;14;.933;3774150;0
49725;1651;7;93;35;2;33;.943;3774150;0
49793;442;12;72;24;2;22;.917;3693850;0
49793;613;20;89;37;3;34;.919;3693850;0
49793;952;20;0;0;0;0;.00nan;0;0
49793;3756;12;0;0;0;0;.00nan;0;0
49786;762;25;0;0;0;0;.00nan;0;0
49786;1294;9;0;0;0;0;.00nan;0;0
49786;3273;25;22;27;7;20;.741;3600000;0
49786;5934;9;92;28;1;27;.964;3600000;0
49686;668;14;0;0;0;0;.00nan;0;0
49686;1218;14;73;44;5;39;.886;3581550;0
49686;2664;17;0;0;0;0;.00nan;0;0
49686;5872;17;74;24;2;22;.917;3600000;0
49809;384;21;72;35;4;31;.886;3600000;0
49809;540;21;0;0;0;0;.00nan;0;0
49809;690;152;100;24;0;24;1.000;3600000;0
49809;5950;152;0;0;0;0;.00nan;0;0
49668;0;18;37;33;7;26;.788;3630000;0
49668;668;14;46;34;6;28;.824;2606700;0
49668;738;18;0;0;0;0;.00nan;0;0
49668;1218;14;72;12;0;12;1.000;1023300;0
49719;933;19;83;29;2;27;.931;3600000;0
49719;1615;19;0;0;0;0;.00nan;0;0
49719;2664;17;35;28;6;22;.786;3600000;0
49719;5872;17;0;0;0;0;.00nan;0;0
49678;384;21;0;0;0;0;.00nan;0;0
49678;536;27;47;35;6;29;.829;3600000;0
49678;540;21;75;32;3;29;.906;3600000;0
49678;2062;27;0;0;0;0;.00nan;0;0
49717;690;152;53;27;4;23;.852;2240000;0
49717;1652;0;66;21;2;19;.905;3600000;0
49717;5950;152;70;12;0;12;1.000;1335450;0
49717;6446;0;0;0;0;0;.00nan;0;0
49722;150;26;78;40;4;36;.900;3575700;0
49722;457;28;84;37;3;34;.919;3600000;0
49722;830;26;0;0;0;0;.00nan;0;0
49722;982;28;0;0;0;0;.00nan;0;0
49641;929;8;73;39;4;35;.897;3857900;0
49641;1222;10;0;0;0;0;.00nan;0;0
49641;2123;8;0;0;0;0;.00nan;0;0
49641;6527;10;90;41;3;38;.927;3857900;0
49694;536;27;54;26;4;22;.846;3600000;0
49694;2062;27;0;0;0;0;.00nan;0;0
49694;2664;17;0;0;0;0;.00nan;0;0
49694;5872;17;83;36;3;33;.917;3600000;0
49698;567;24;0;0;0;0;.00nan;0;0
49698;1652;0;0;0;0;0;.00nan;0;0
49698;1828;24;79;27;2;25;.926;3600000;0
49698;6446;0;87;43;3;40;.930;3585600;0
49643;929;8;0;0;0;0;.00nan;0;0
49643;1294;9;0;0;0;0;.00nan;0;0
49643;2123;8;100;38;2;36;.947;3669150;0
49643;5934;9;86;36;3;33;.917;3669150;0
49745;150;26;0;0;0;0;.00nan;0;0
49745;830;26;65;44;6;38;.864;3600000;0
49745;1641;29;0;0;0;0;.00nan;0;0
49745;3462;29;79;27;2;25;.926;3600000;0
49770;904;3;74;29;3;26;.897;3634250;0
49770;945;30;64;19;2;17;.895;3634250;0
49770;1021;30;0;0;0;0;.00nan;0;0
49770;1064;3;0;0;0;0;.00nan;0;0
49731;457;28;0;0;0;0;.00nan;0;0
49731;933;19;86;38;3;35;.921;3900000;0
49731;982;28;87;38;3;35;.921;3900000;0
49731;1615;19;0;0;0;0;.00nan;0;0
49808;442;12;73;24;2;22;.917;3600000;0
49808;668;14;0;0;0;0;.00nan;0;0
49808;1218;14;74;43;5;38;.884;3600000;0
49808;3756;12;0;0;0;0;.00nan;0;0
49699;0;18;0;0;0;0;.00nan;0;0
49699;738;18;100;35;0;35;1.000;3600000;0
49699;862;2;0;0;0;0;.00nan;0;0
49699;5935;2;94;30;1;29;.967;3598850;0
49794;384;21;0;0;0;0;.00nan;0;0
49794;443;7;0;0;0;0;.00nan;0;0
49794;540;21;23;33;8;25;.758;3600000;0
49794;1651;7;98;32;1;31;.969;3600000;0
49705;613;20;0;0;0;0;.00nan;0;0
49705;879;124;0;0;0;0;.00nan;0;0
49705;952;20;100;44;2;42;.955;3900000;0
49705;1658;124;75;31;2;29;.935;3900000;0
49683;690;152;54;38;6;32;.842;3600000;0
49683;703;1;0;0;0;0;.00nan;0;0
49683;3513;1;97;36;2;34;.944;3600000;0
49683;5950;152;0;0;0;0;.00nan;0;0
49958;530;23;81;41;4;37;.902;3900000;0
49958;1664;31;97;55;4;51;.927;3900000;0
49958;2965;31;0;0;0;0;.00nan;0;0
49958;6515;23;0;0;0;0;.00nan;0;0
49844;762;25;62;18;2;16;.889;3600000;0
49844;1664;31;0;0;0;0;.00nan;0;0
49844;2965;31;62;38;5;33;.868;3574300;0
49844;3273;25;0;0;0;0;.00nan;0;0
49702;862;2;58;22;3;19;.864;3546400;0
49702;879;124;94;36;2;34;.944;3600000;0
49702;1658;124;0;0;0;0;.00nan;0;0
49702;5935;2;0;0;0;0;.00nan;0;0
49867;384;21;58;5;0;5;1.000;732500;0
49867;530;23;100;26;0;26;1.000;3600000;0
49867;540;21;40;30;6;24;.800;2867500;0
49867;6515;23;0;0;0;0;.00nan;0;0
49733;613;20;70;22;2;20;.909;3600000;0
49733;933;19;57;27;4;23;.852;3553400;0
49733;952;20;0;0;0;0;.00nan;0;0
49733;1615;19;0;0;0;0;.00nan;0;0
49788;457;28;87;26;1;25;.962;3600000;0
49788;567;24;0;0;0;0;.00nan;0;0
49788;982;28;0;0;0;0;.00nan;0;0
49788;1828;24;80;36;3;33;.917;3561950;0
49771;442;12;87;31;2;29;.935;3600000;0
49771;2664;17;0;0;0;0;.00nan;0;0
49771;3756;12;0;0;0;0;.00nan;0;0
49771;5872;17;84;44;4;40;.909;3533150;0
49760;690;152;63;13;1;12;.923;2401800;0
49760;904;3;0;0;0;0;.00nan;0;0
49760;1064;3;48;35;6;29;.829;3564400;0
49760;5950;152;36;16;4;12;.750;1198200;0
49675;443;7;0;0;0;0;.00nan;0;0
49675;1651;7;56;33;5;28;.848;3600000;0
49675;1652;0;75;20;1;19;.950;3600000;0
49675;6446;0;0;0;0;0;.00nan;0;0
49753;150;26;0;0;0;0;.00nan;0;0
49753;830;26;49;18;3;15;.833;3540650;0
49753;1222;10;0;0;0;0;.00nan;0;0
49753;6527;10;91;35;2;33;.943;3600000;0
49701;613;20;0;0;0;0;.00nan;0;0
49701;703;1;0;0;0;0;.00nan;0;0
49701;952;20;97;31;1;30;.968;3899650;0
49701;3513;1;98;42;1;41;.976;3900000;0
49684;929;8;38;30;6;24;.800;3335700;0
49684;1641;29;0;0;0;0;.00nan;0;0
49684;2123;8;53;3;0;3;1.000;208600;0
49684;3462;29;68;40;5;35;.875;3600000;0
49707;879;124;0;0;0;0;.00nan;0;0
49707;1222;10;94;30;1;29;.967;3600000;0
49707;1658;124;70;30;3;27;.900;3580000;0
49707;6527;10;0;0;0;0;.00nan;0;0
49726;1652;0;0;0;0;0;.00nan;0;0
49726;2664;17;80;42;5;37;.881;3788850;0
49726;5872;17;0;0;0;0;.00nan;0;0
49726;6446;0;57;28;4;24;.857;3788850;0
49815;442;12;0;0;0;0;.00nan;0;0
49815;762;25;0;0;0;0;.00nan;0;0
49815;3273;25;64;42;6;36;.857;3600000;0
49815;3756;12;75;26;2;24;.923;3600000;0
49961;1294;9;0;0;0;0;.00nan;0;0
49961;1664;31;75;29;3;26;.897;3618900;0
49961;2965;31;0;0;0;0;.00nan;0;0
49961;5934;9;70;35;4;31;.886;3618900;0
49837;443;7;73;32;3;29;.906;3600000;0
49837;530;23;0;0;0;0;.00nan;0;0
49837;1651;7;0;0;0;0;.00nan;0;0
49837;6515;23;100;24;0;24;1.000;3600000;0
49908;862;2;0;0;0;0;.00nan;0;0
49908;1294;9;56;22;3;19;.864;3600000;0
49908;5934;9;0;0;0;0;.00nan;0;0
49908;5935;2;82;30;2;28;.933;3600000;0
49737;0;18;0;0;0;0;.00nan;0;0
49737;738;18;86;32;2;30;.938;3600000;0
49737;1641;29;0;0;0;0;.00nan;0;0
49737;3462;29;78;34;3;31;.912;3582300;0
49728;668;14;0;0;0;0;.00nan;0;0
49728;762;25;67;38;5;33;.868;3842750;0
49728;1218;14;82;41;4;37;.902;3842750;0
49728;3273;25;0;0;0;0;.00nan;0;0
49669;536;27;58;28;4;24;.857;3600000;0
49669;567;24;0;0;0;0;.00nan;0;0
49669;1828;24;62;37;5;32;.865;3587700;0
49669;2062;27;0;0;0;0;.00nan;0;0
49716;703;1;0;0;0;0;.00nan;0;0
49716;945;30;0;0;0;0;.00nan;0;0
49716;1021;30;71;24;2;22;.917;3572800;0
49716;3513;1;100;41;1;40;.976;3600000;0
49727;904;3;100;22;0;22;1.000;3600000;0
49727;933;19;0;0;0;0;.00nan;0;0
49727;1064;3;0;0;0;0;.00nan;0;0
49727;1615;19;44;33;6;27;.818;3600000;0
49730;0;18;48;36;6;30;.833;3281650;0
49730;668;14;57;41;6;35;.854;3835300;0
49730;738;18;48;3;1;2;.667;553650;0
49730;1218;14;0;0;0;0;.00nan;0;0
49779;703;1;89;46;2;44;.957;3600000;0
49779;904;3;55;39;6;33;.846;3600000;0
49779;1064;3;0;0;0;0;.00nan;0;0
49779;3513;1;0;0;0;0;.00nan;0;0
49852;567;24;0;0;0;0;.00nan;0;0
49852;1222;10;53;38;6;32;.842;3600000;0
49852;1828;24;61;17;2;15;.882;3600000;0
49852;6527;10;0;0;0;0;.00nan;0;0
49689;929;8;62;7;0;7;1.000;1039900;0
49689;945;30;84;25;1;24;.960;3600000;0
49689;1021;30;0;0;0;0;.00nan;0;0
49689;2123;8;18;19;6;13;.684;2560100;0
49746;1294;9;0;0;0;0;.00nan;0;0
49746;1652;0;62;19;2;17;.895;3577600;0
49746;5934;9;83;23;1;22;.957;3600000;0
49746;6446;0;0;0;0;0;.00nan;0;0
49812;1641;29;0;0;0;0;.00nan;0;0
49812;1664;31;60;30;4;26;.867;3089700;0
49812;2965;31;58;4;0;4;1.000;468550;0
49812;3462;29;80;34;3;31;.912;3600000;0
49711;536;27;0;0;0;0;.00nan;0;0
49711;933;19;51;43;7;36;.837;3031900;0
49711;1615;19;57;5;0;5;1.000;568100;0
49711;2062;27;62;24;3;21;.875;3600000;0
49754;738;18;78;28;2;26;.929;3599600;0
49754;862;2;0;0;0;0;.00nan;0;0
49754;1247;18;0;0;0;0;.00nan;0;0
49754;5935;2;88;27;1;26;.963;3600000;0
49775;442;12;57;20;3;17;.850;3600000;0
49775;1222;10;0;0;0;0;.00nan;0;0
49775;3756;12;0;0;0;0;.00nan;0;0
49775;6527;10;65;39;5;34;.872;3597300;0
49693;536;27;53;27;4;23;.852;3600000;0
49693;929;8;93;29;1;28;.966;3600000;0
49693;2062;27;0;0;0;0;.00nan;0;0
49693;2123;8;0;0;0;0;.00nan;0;0
49807;457;28;73;30;3;27;.900;3600000;0
49807;567;24;55;39;6;33;.846;3600000;0
49807;982;28;0;0;0;0;.00nan;0;0
49807;1828;24;0;0;0;0;.00nan;0;0
49769;150;26;0;0;0;0;.00nan;0;0
49769;690;152;67;33;4;29;.879;3600000;0
49769;830;26;91;29;1;28;.966;3600000;0
49769;5950;152;0;0;0;0;.00nan;0;0
49713;668;14;0;0;0;0;.00nan;0;0
49713;1218;14;68;34;4;30;.882;3600000;0
49713;1652;0;0;0;0;0;.00nan;0;0
49713;6446;0;100;24;0;24;1.000;3600000;0
49715;879;124;71;29;3;26;.897;3600000;0
49715;1294;9;68;34;4;30;.882;3553350;0
49715;1658;124;0;0;0;0;.00nan;0;0
49715;5934;9;0;0;0;0;.00nan;0;0
49759;384;21;0;0;0;0;.00nan;0;0
49759;540;21;63;25;3;22;.880;3600000;0
49759;703;1;0;0;0;0;.00nan;0;0
49759;3513;1;66;38;5;33;.868;3512350;0
49791;690;152;0;0;0;0;.00nan;0;0
49791;945;30;0;0;0;0;.00nan;0;0
49791;1021;30;82;29;2;27;.931;3600000;0
49791;5950;152;82;36;3;33;.917;3600000;0
49814;443;7;0;0;0;0;.00nan;0;0
49814;904;3;0;0;0;0;.00nan;0;0
49814;1064;3;100;43;3;40;.930;3900000;0
49814;1651;7;95;42;3;39;.929;3900000;0
49772;442;12;0;0;0;0;.00nan;0;0
49772;703;1;94;36;2;34;.944;3829400;0
49772;3513;1;0;0;0;0;.00nan;0;0
49772;3756;12;82;34;3;31;.912;3829400;0
49739;530;23;23;9;4;5;.556;1199550;0
49739;929;8;91;28;1;27;.964;3600000;0
49739;2123;8;0;0;0;0;.00nan;0;0
49739;6515;23;55;21;3;18;.857;2400450;0
49743;613;20;0;0;0;0;.00nan;0;0
49743;945;30;0;0;0;0;.00nan;0;0
49743;952;20;96;18;0;18;1.000;3600000;0
49743;1021;30;71;31;3;28;.903;3600000;0
49734;933;19;0;0;0;0;.00nan;0;0
49734;1615;19;94;39;2;37;.949;3717650;0
49734;1664;31;0;0;0;0;.00nan;0;0
49734;2965;31;100;36;1;35;.972;3717650;0
49767;762;25;0;0;0;0;.00nan;0;0
49767;879;124;0;0;0;0;.00nan;0;0
49767;1658;124;45;27;5;22;.815;3600000;0
49767;3273;25;35;35;7;28;.800;3600000;0
49704;536;27;79;35;3;32;.914;3544500;0
49704;1641;29;0;0;0;0;.00nan;0;0
49704;2062;27;0;0;0;0;.00nan;0;0
49704;3462;29;91;35;2;33;.943;3600000;0
49803;150;26;46;5;1;4;.800;297250;0
49803;762;25;70;27;3;24;.889;3600000;0
49803;830;26;48;34;6;28;.824;3302750;0
49803;3273;25;0;0;0;0;.00nan;0;0
49780;613;20;82;35;3;32;.914;3600000;0
49780;862;2;0;0;0;0;.00nan;0;0
49780;952;20;0;0;0;0;.00nan;0;0
49780;5935;2;56;27;4;23;.852;3600000;0
49749;457;28;0;0;0;0;.00nan;0;0
49749;982;28;82;29;2;27;.931;3600000;0
49749;1652;0;0;0;0;0;.00nan;0;0
49749;6446;0;73;44;5;39;.886;3600000;0
49796;442;12;94;42;3;39;.929;3622850;0
49796;2664;17;0;0;0;0;.00nan;0;0
49796;3756;12;0;0;0;0;.00nan;0;0
49796;5872;17;100;43;2;41;.953;3622850;0
49849;668;14;0;0;0;0;.00nan;0;0
49849;1218;14;84;35;3;32;.914;3600000;0
49849;1664;31;82;42;4;38;.905;3600000;0
49849;2965;31;0;0;0;0;.00nan;0;0
49762;384;21;53;3;0;3;1.000;511750;0
49762;540;21;33;33;7;26;.788;3088250;0
49762;738;18;91;34;2;32;.941;3600000;0
49762;1247;18;0;0;0;0;.00nan;0;0
49732;443;7;63;38;5;33;.868;3600000;0
49732;879;124;97;20;0;20;1.000;3600000;0
49732;1651;7;0;0;0;0;.00nan;0;0
49732;1658;124;0;0;0;0;.00nan;0;0
49741;933;19;66;34;4;30;.882;3552300;0
49741;1294;9;0;0;0;0;.00nan;0;0
49741;1615;19;0;0;0;0;.00nan;0;0
49741;5934;9;66;20;2;18;.900;3600000;0
49832;457;28;46;23;4;19;.826;2157150;0
49832;982;28;61;13;1;12;.923;1381350;0
49832;1641;29;68;28;3;25;.893;3600000;0
49832;3462;29;0;0;0;0;.00nan;0;0
49805;530;23;0;0;0;0;.00nan;0;0
49805;1222;10;0;0;0;0;.00nan;0;0
49805;6515;23;60;22;3;19;.864;3600000;0
49805;6527;10;49;30;5;25;.833;3510850;0
49896;150;26;71;23;2;21;.913;3600000;0
49896;567;24;0;0;0;0;.00nan;0;0
49896;830;26;0;0;0;0;.00nan;0;0
49896;1828;24;71;30;3;27;.900;3547400;0
49790;384;21;72;37;4;33;.892;3573450;0
49790;540;21;0;0;0;0;.00nan;0;0
49790;904;3;89;33;2;31;.939;3600000;0
49790;1064;3;0;0;0;0;.00nan;0;0
49823;530;23;100;26;0;26;1.000;3600000;0
49823;738;18;0;0;0;0;.00nan;0;0
49823;1247;18;86;37;3;34;.919;3600000;0
49823;6515;23;0;0;0;0;.00nan;0;0
49818;690;152;0;0;0;0;.00nan;0;0
49818;762;25;100;39;0;39;1.000;3600000;0
49818;3273;25;0;0;0;0;.00nan;0;0
49818;5950;152;55;21;3;18;.857;3600000;0
49824;613;20;72;37;4;33;.892;3600000;0
49824;862;2;0;0;0;0;.00nan;0;0
49824;952;20;0;0;0;0;.00nan;0;0
49824;5935;2;100;38;1;37;.974;3600000;0
49878;443;7;0;0;0;0;.00nan;0;0
49878;762;25;26;29;7;22;.759;2993500;0
49878;1651;7;75;32;3;29;.906;3600000;0
49878;3273;25;44;4;1;3;.750;606500;0
49751;536;27;77;34;3;31;.912;3900000;0
49751;879;124;86;37;3;34;.919;3900000;0
49751;1658;124;0;0;0;0;.00nan;0;0
49751;2062;27;0;0;0;0;.00nan;0;0
49777;457;28;0;0;0;0;.00nan;0;0
49777;982;28;95;40;2;38;.950;3900000;0
49777;1652;0;0;0;0;0;.00nan;0;0
49777;6446;0;93;35;2;33;.943;3900000;0
49829;668;14;0;0;0;0;.00nan;0;0
49829;703;1;0;0;0;0;.00nan;0;0
49829;1218;14;66;34;4;30;.882;3586700;0
49829;3513;1;95;39;3;36;.923;3600000;0
49799;150;26;0;0;0;0;.00nan;0;0
49799;442;12;0;0;0;0;.00nan;0;0
49799;830;26;79;40;4;36;.900;3528500;0
49799;3756;12;81;28;2;26;.929;3600000;0
49840;862;2;77;32;3;29;.906;3600000;0
49840;1641;29;0;0;0;0;.00nan;0;0
49840;3462;29;60;36;5;31;.861;3585600;0
49840;5935;2;0;0;0;0;.00nan;0;0
49747;443;7;98;39;1;38;.974;3900000;0
49747;933;19;0;0;0;0;.00nan;0;0
49747;1615;19;100;33;1;32;.970;3900000;0
49747;1651;7;0;0;0;0;.00nan;0;0
49820;690;152;0;0;0;0;.00nan;0;0
49820;1664;31;89;41;3;38;.927;3873400;0
49820;2965;31;0;0;0;0;.00nan;0;0
49820;5950;152;85;44;4;40;.909;3870700;0
49821;442;12;61;35;5;30;.857;3600000;0
49821;945;30;87;26;1;25;.962;3600000;0
49821;1021;30;0;0;0;0;.00nan;0;0
49821;3756;12;0;0;0;0;.00nan;0;0
49764;1222;10;0;0;0;0;.00nan;0;0
49764;1652;0;89;38;3;35;.921;3900000;0
49764;6446;0;0;0;0;0;.00nan;0;0
49764;6527;10;95;39;3;36;.923;3900000;0
49816;457;29;0;0;0;0;.00nan;0;0
49816;904;3;69;33;4;29;.879;3565150;0
49816;1064;3;0;0;0;0;.00nan;0;0
49816;3462;29;72;29;3;26;.897;3600000;0
49740;929;8;52;25;4;21;.840;2472350;0
49740;2123;8;55;13;1;12;.923;1427650;0
49740;2664;17;0;0;0;0;.00nan;0;0
49740;5872;17;56;35;5;30;.857;3900000;0
49782;738;18;0;0;0;0;.00nan;0;0
49782;879;124;0;0;0;0;.00nan;0;0
49782;1247;18;77;40;4;36;.900;3521400;0
49782;1658;124;84;31;2;29;.935;3600000;0
49744;536;27;81;22;1;21;.955;3600000;0
49744;668;14;24;34;8;26;.765;3600000;0
49744;1218;14;0;0;0;0;.00nan;0;0
49744;2062;27;0;0;0;0;.00nan;0;0
49962;567;24;0;0;0;0;.00nan;0;0
49962;982;28;100;46;1;45;.978;3600000;0
49962;1275;28;0;0;0;0;.00nan;0;0
49962;1828;24;56;22;3;19;.864;3535200;0
49797;150;26;61;36;5;31;.861;3600000;0
49797;830;26;0;0;0;0;.00nan;0;0
49797;1294;9;0;0;0;0;.00nan;0;0
49797;5934;9;63;24;3;21;.875;3600000;0
50046;384;21;91;40;3;37;.925;3894700;0
50046;540;21;0;0;0;0;.00nan;0;0
50046;762;25;0;0;0;0;.00nan;0;0
50046;3273;25;92;36;2;34;.944;3894700;0
49742;102;8;79;41;4;37;.902;3590400;0
49742;738;18;84;30;2;28;.933;3600000;0
49742;1247;18;0;0;0;0;.00nan;0;0
49742;2123;8;0;0;0;0;.00nan;0;0
49748;613;20;0;0;0;0;.00nan;0;0
49748;933;19;71;29;3;26;.897;3600000;0
49748;952;20;60;30;4;26;.867;3571250;0
49748;1615;19;0;0;0;0;.00nan;0;0
49838;703;1;0;0;0;0;.00nan;0;0
49838;862;2;0;0;0;0;.00nan;0;0
49838;3513;1;84;36;3;33;.917;3592350;0
49838;5935;2;94;35;2;33;.943;3600000;0
49835;690;152;0;0;0;0;.00nan;0;0
49835;1664;31;0;0;0;0;.00nan;0;0
49835;2965;31;84;30;2;28;.933;3669450;0
49835;5950;152;86;36;3;33;.917;3669450;0
50017;904;3;46;5;1;4;.800;606300;0
50017;982;28;56;26;4;22;.846;3600000;0
50017;1064;3;38;28;6;22;.786;2993700;0
50017;1275;28;0;0;0;0;.00nan;0;0
49755;613;20;76;20;1;19;.950;3600000;0
49755;952;20;0;0;0;0;.00nan;0;0
49755;1294;9;0;0;0;0;.00nan;0;0
49755;5934;9;63;38;5;33;.868;3600000;0
49766;536;27;0;0;0;0;.00nan;0;0
49766;2062;27;73;19;1;18;.947;3600000;0
49766;2664;17;55;4;0;4;1.000;723150;0
49766;5872;17;74;50;6;44;.880;2876850;0
49858;567;24;0;0;0;0;.00nan;0;0
49858;879;124;80;34;3;31;.912;3600000;0
49858;1658;124;0;0;0;0;.00nan;0;0
49858;1828;24;58;35;5;30;.857;3562300;0
49789;150;26;0;0;0;0;.00nan;0;0
49789;830;26;75;33;3;30;.909;3600000;0
49789;1652;0;0;0;0;0;.00nan;0;0
49789;6446;0;83;24;1;23;.958;3600000;0
49853;945;30;0;0;0;0;.00nan;0;0
49853;1021;30;44;22;4;18;.818;3556200;0
49853;1222;10;0;0;0;0;.00nan;0;0
49853;6527;10;54;20;3;17;.850;3600000;0
49822;530;23;45;39;7;32;.821;3600000;0
49822;668;14;0;0;0;0;.00nan;0;0
49822;1218;14;82;24;1;23;.958;3600000;0
49822;6515;23;0;0;0;0;.00nan;0;0
50053;567;24;34;27;6;21;.778;3600000;0
50053;904;3;100;30;0;30;1.000;3600000;0
50053;1064;3;0;0;0;0;.00nan;0;0
50053;1828;24;0;0;0;0;.00nan;0;0
49861;457;29;0;0;0;0;.00nan;0;0
49861;888;30;67;39;5;34;.872;3558350;0
49861;1021;30;0;0;0;0;.00nan;0;0
49861;3462;29;53;25;4;21;.840;3600000;0
49842;690;152;75;34;4;30;.882;3763350;0
49842;762;25;85;38;3;35;.921;3763350;0
49842;3273;25;0;0;0;0;.00nan;0;0
49842;5950;152;0;0;0;0;.00nan;0;0
49757;102;8;0;0;0;0;.00nan;0;0
49757;703;1;84;38;3;35;.921;3600000;0
49757;2123;8;78;39;4;35;.897;3600000;0
49757;3513;1;0;0;0;0;.00nan;0;0
49871;738;18;0;0;0;0;.00nan;0;0
49871;862;2;42;32;6;26;.813;3571650;0
49871;1247;18;55;33;5;28;.848;3600000;0
49871;5935;2;0;0;0;0;.00nan;0;0
49800;613;20;0;0;0;0;.00nan;0;0
49800;952;20;60;23;3;20;.870;3600000;0
49800;1294;9;0;0;0;0;.00nan;0;0
49800;5934;9;60;30;4;26;.867;3563300;0
49752;933;19;0;0;0;0;.00nan;0;0
49752;1222;10;0;0;0;0;.00nan;0;0
49752;1615;19;94;30;1;29;.967;3600000;0
49752;6527;10;75;39;4;35;.897;3600000;0
49841;443;7;0;0;0;0;.00nan;0;0
49841;530;23;70;36;4;32;.889;3600000;0
49841;1651;7;100;23;0;23;1.000;3600000;0
49841;6515;23;0;0;0;0;.00nan;0;0
49834;384;21;0;0;0;0;.00nan;0;0
49834;442;12;94;48;4;44;.917;3649200;0
49834;540;21;100;51;3;48;.941;3649200;0
49834;3756;12;0;0;0;0;.00nan;0;0
49859;530;23;0;0;0;0;.00nan;0;0
49859;2664;17;0;0;0;0;.00nan;0;0
49859;5872;17;82;22;1;21;.955;3600000;0
49859;6515;23;75;33;3;30;.909;3567250;0
49785;443;7;54;2;0;2;1.000;161700;0
49785;536;27;65;31;4;27;.871;3600000;0
49785;1651;7;58;41;6;35;.854;3354900;0
49785;2062;27;0;0;0;0;.00nan;0;0
49862;150;26;0;0;0;0;.00nan;0;0
49862;830;26;100;36;1;35;.972;3600000;0
49862;879;124;91;36;2;34;.944;3535100;0
49862;1658;124;0;0;0;0;.00nan;0;0
49756;703;1;0;0;0;0;.00nan;0;0
49756;933;19;100;39;1;38;.974;3600000;0
49756;1615;19;0;0;0;0;.00nan;0;0
49756;3513;1;77;34;3;31;.912;3514700;0
49806;102;8;100;34;1;33;.971;3600000;0
49806;690;152;0;0;0;0;.00nan;0;0
49806;2123;8;0;0;0;0;.00nan;0;0
49806;5950;152;82;42;4;38;.905;3600000;0
49836;442;12;61;42;6;36;.857;3692200;0
49836;1664;31;67;45;6;39;.867;3215750;0
49836;2965;31;55;8;1;7;.875;476450;0
49836;3756;12;0;0;0;0;.00nan;0;0
49827;982;28;71;37;4;33;.892;3507500;0
49827;1275;28;0;0;0;0;.00nan;0;0
49827;1294;9;0;0;0;0;.00nan;0;0
49827;5934;9;94;36;2;34;.944;3600000;0
49900;457;29;0;0;0;0;.00nan;0;0
49900;945;30;77;25;2;23;.920;3600000;0
49900;1021;30;0;0;0;0;.00nan;0;0
49900;3462;29;51;31;5;26;.839;3600000;0
49810;567;24;0;0;0;0;.00nan;0;0
49810;1652;0;0;0;0;0;.00nan;0;0
49810;1828;24;26;28;7;21;.750;3600000;0
49810;6446;0;71;29;3;26;.897;3600000;0
49932;530;23;0;0;0;0;.00nan;0;0
49932;904;3;79;34;3;31;.912;3600000;0
49932;1064;3;0;0;0;0;.00nan;0;0
49932;6515;23;82;32;2;30;.938;3600000;0
49839;384;21;52;32;5;27;.844;3543050;0
49839;540;21;0;0;0;0;.00nan;0;0
49839;703;1;91;41;3;38;.927;3600000;0
49839;3513;1;0;0;0;0;.00nan;0;0
49850;443;7;34;34;7;27;.794;3541750;0
49850;738;18;0;0;0;0;.00nan;0;0
49850;1247;18;60;35;5;30;.857;3600000;0
49850;1651;7;0;0;0;0;.00nan;0;0
49995;150;26;58;22;3;19;.864;3727800;0
49995;567;24;73;38;4;34;.895;3727800;0
49995;830;26;0;0;0;0;.00nan;0;0
49995;1828;24;0;0;0;0;.00nan;0;0
49763;536;27;0;0;0;0;.00nan;0;0
49763;933;19;0;0;0;0;.00nan;0;0
49763;1615;19;62;32;4;28;.875;3568000;0
49763;2062;27;91;35;2;33;.943;3600000;0
49872;613;20;62;38;5;33;.868;3600000;0
49872;952;20;0;0;0;0;.00nan;0;0
49872;1222;10;0;0;0;0;.00nan;0;0
49872;6527;10;70;23;2;21;.913;3600000;0
49865;982;28;0;0;0;0;.00nan;0;0
49865;1275;28;80;28;2;26;.929;3600000;0
49865;2664;17;0;0;0;0;.00nan;0;0
49865;5872;17;76;38;4;34;.895;3600000;0
49869;879;124;0;0;0;0;.00nan;0;0
49869;1294;9;69;22;2;20;.909;3600000;0
49869;1658;124;46;34;6;28;.824;3600000;0
49869;5934;9;0;0;0;0;.00nan;0;0
49883;442;12;50;19;3;16;.842;3600000;0
49883;945;30;0;0;0;0;.00nan;0;0
49883;1021;30;100;28;0;28;1.000;3600000;0
49883;3756;12;0;0;0;0;.00nan;0;0
49864;690;152;62;31;4;27;.871;3600000;0
49864;862;2;0;0;0;0;.00nan;0;0
49864;5935;2;94;18;0;18;1.000;3600000;0
49864;5950;152;0;0;0;0;.00nan;0;0
49768;102;8;30;20;5;15;.750;2237450;0
49768;1664;31;100;34;1;33;.971;3600000;0
49768;2123;8;52;8;1;7;.875;1362550;0
49768;2965;31;0;0;0;0;.00nan;0;0
49882;738;18;70;29;3;26;.897;3600000;0
49882;904;3;80;47;5;42;.894;3600000;0
49882;1064;3;0;0;0;0;.00nan;0;0
49882;1247;18;0;0;0;0;.00nan;0;0
49921;567;24;0;0;0;0;.00nan;0;0
49921;668;14;0;0;0;0;.00nan;0;0
49921;1218;14;64;39;5;34;.872;3600000;0
49921;1828;24;98;36;2;34;.944;3600000;0
49868;862;2;0;0;0;0;.00nan;0;0
49868;945;30;98;43;1;42;.977;3900000;0
49868;1021;30;0;0;0;0;.00nan;0;0
49868;5935;2;72;20;1;19;.950;3898750;0
49938;762;25;42;19;4;15;.789;3600000;0
49938;2689;10;0;0;0;0;.00nan;0;0
49938;3273;25;0;0;0;0;.00nan;0;0
49938;6527;10;51;37;6;31;.838;3600000;0
49784;536;27;89;39;3;36;.923;3569200;0
49784;1652;0;0;0;0;0;.00nan;0;0
49784;2062;27;0;0;0;0;.00nan;0;0
49784;6446;0;100;41;2;39;.951;3600000;0
49774;703;1;0;0;0;0;.00nan;0;0
49774;933;19;82;36;3;33;.917;3600000;0
49774;1615;19;0;0;0;0;.00nan;0;0
49774;3513;1;85;25;1;24;.960;3600000;0
49929;442;12;0;0;0;0;.00nan;0;0
49929;982;28;77;39;4;35;.897;3600000;0
49929;1275;28;0;0;0;0;.00nan;0;0
49929;3756;12;98;32;1;31;.969;3600000;0
49802;102;8;0;0;0;0;.00nan;0;0
49802;613;20;0;0;0;0;.00nan;0;0
49802;952;20;52;26;4;22;.846;3564700;0
49802;2123;8;82;35;3;32;.914;3600000;0
49913;762;25;0;0;0;0;.00nan;0;0
49913;879;124;92;17;0;17;1.000;3600000;0
49913;1658;124;0;0;0;0;.00nan;0;0
49913;3273;25;41;31;6;25;.806;3600000;0
49972;150;26;0;0;0;0;.00nan;0;0
49972;830;26;100;23;0;23;1.000;3600000;0
49972;2664;17;0;0;0;0;.00nan;0;0
49972;5872;17;92;45;3;42;.933;3560700;0
49889;457;29;83;24;1;23;.958;3600000;0
49889;2689;10;62;32;4;28;.875;3600000;0
49889;3462;29;0;0;0;0;.00nan;0;0
49889;6527;10;0;0;0;0;.00nan;0;0
49795;668;14;47;23;4;19;.826;2240350;0
49795;1218;14;50;7;1;6;.857;1359650;0
49795;1652;0;79;21;1;20;.952;3600000;0
49795;6446;0;0;0;0;0;.00nan;0;0
49873;384;21;0;0;0;0;.00nan;0;0
49873;540;21;56;34;5;29;.853;3600000;0
49873;738;18;0;0;0;0;.00nan;0;0
49873;1247;18;100;32;0;32;1.000;3600000;0
49811;904;3;0;0;0;0;.00nan;0;0
49811;1064;3;87;26;1;25;.962;3600000;0
49811;1294;9;0;0;0;0;.00nan;0;0
49811;5934;9;79;35;3;32;.914;3567000;0
49848;690;152;0;0;0;0;.00nan;0;0
49848;862;2;93;42;3;39;.929;3571500;0
49848;5935;2;0;0;0;0;.00nan;0;0
49848;5950;152;93;37;2;35;.946;3600000;0
49856;443;7;0;0;0;0;.00nan;0;0
49856;1651;7;97;32;1;31;.969;3600000;0
49856;1664;31;0;0;0;0;.00nan;0;0
49856;2965;31;53;27;4;23;.852;3600000;0
50010;384;21;57;22;3;19;.864;3620050;0
50010;457;29;0;0;0;0;.00nan;0;0
50010;540;21;0;0;0;0;.00nan;0;0
50010;3462;29;72;35;4;31;.886;3620050;0
49920;530;23;60;30;4;26;.867;3531350;0
49920;613;20;91;47;3;44;.936;3600000;0
49920;952;20;0;0;0;0;.00nan;0;0
49920;6515;23;0;0;0;0;.00nan;0;0
49948;442;12;0;0;0;0;.00nan;0;0
49948;982;28;100;35;1;34;.971;3600000;0
49948;1275;28;0;0;0;0;.00nan;0;0
49948;3756;12;52;25;4;21;.840;3600000;0
50056;668;14;0;0;0;0;.00nan;0;0
50056;1218;14;55;32;5;27;.844;3600000;0
50056;2664;17;0;0;0;0;.00nan;0;0
50056;5872;17;34;28;6;22;.786;3580250;0
49943;530;23;0;0;0;0;.00nan;0;0
49943;762;25;64;31;4;27;.871;3600000;0
49943;3273;25;0;0;0;0;.00nan;0;0
49943;6515;23;65;38;5;33;.868;3600000;0
49845;150;26;0;0;0;0;.00nan;0;0
49845;830;26;100;27;0;27;1.000;3600000;0
49845;933;19;74;38;4;34;.895;3600000;0
49845;1615;19;0;0;0;0;.00nan;0;0
49830;102;8;47;29;5;24;.828;3600000;0
49830;945;30;0;0;0;0;.00nan;0;0
49830;1021;30;100;24;0;24;1.000;3600000;0
49830;2123;8;0;0;0;0;.00nan;0;0
49899;384;21;0;0;0;0;.00nan;0;0
49899;540;21;54;32;5;27;.844;3600000;0
49899;1294;9;0;0;0;0;.00nan;0;0
49899;5934;9;81;29;2;27;.931;3600000;0
49903;457;29;0;0;0;0;.00nan;0;0
49903;690;152;0;0;0;0;.00nan;0;0
49903;3462;29;95;30;1;29;.967;3600000;0
49903;5950;152;97;38;2;36;.947;3545950;0
49874;443;7;80;41;4;37;.902;3585550;0
49874;862;2;0;0;0;0;.00nan;0;0
49874;1651;7;0;0;0;0;.00nan;0;0
49874;5935;2;64;20;2;18;.900;3600000;0
49942;442;12;62;30;4;26;.867;3600000;0
49942;567;24;53;3;0;3;1.000;310150;0
49942;1828;24;42;38;7;31;.816;3289850;0
49942;3756;12;0;0;0;0;.00nan;0;0
49890;613;20;59;29;4;25;.862;3685350;0
49890;738;18;84;36;3;33;.917;3685350;0
49890;952;20;0;0;0;0;.00nan;0;0
49890;1247;18;0;0;0;0;.00nan;0;0
49819;102;8;0;0;0;0;.00nan;0;0
49819;1652;0;0;0;0;0;.00nan;0;0
49819;2123;8;74;25;2;23;.920;3600000;0
49819;6446;0;72;37;4;33;.892;3530750;0
49866;443;7;0;0;0;0;.00nan;0;0
49866;1651;7;100;35;1;34;.971;3600000;0
49866;2689;10;0;0;0;0;.00nan;0;0
49866;6527;10;66;27;3;24;.889;3556850;0
49981;668;14;0;0;0;0;.00nan;0;0
49981;982;28;72;30;3;27;.900;3523750;0
49981;1218;14;100;40;2;38;.950;3600000;0
49981;1275;28;0;0;0;0;.00nan;0;0
50024;384;21;64;24;3;21;.875;3600000;0
50024;540;21;0;0;0;0;.00nan;0;0
50024;2664;17;0;0;0;0;.00nan;0;0
50024;5872;17;75;38;4;34;.895;3555850;0
49813;536;27;73;30;3;27;.900;3600000;0
49813;762;25;43;31;6;25;.806;3600000;0
49813;2062;27;0;0;0;0;.00nan;0;0
49813;3273;25;0;0;0;0;.00nan;0;0
49855;703;1;0;0;0;0;.00nan;0;0
49855;1294;9;51;25;4;21;.840;3558950;0
49855;3513;1;75;31;3;28;.903;3600000;0
49855;5934;9;0;0;0;0;.00nan;0;0
49886;0;18;57;29;4;25;.862;3600000;0
49886;738;18;0;0;0;0;.00nan;0;0
49886;879;124;91;26;1;25;.962;3600000;0
49886;1658;124;0;0;0;0;.00nan;0;0
49792;613;20;0;0;0;0;.00nan;0;0
49792;933;19;0;0;0;0;.00nan;0;0
49792;952;20;73;38;4;34;.895;3600000;0
49792;1615;19;81;22;1;21;.955;3600000;0
49879;150;26;59;30;4;26;.867;3581750;0
49879;830;26;0;0;0;0;.00nan;0;0
49879;1664;31;84;35;3;32;.914;3600000;0
49879;2965;31;0;0;0;0;.00nan;0;0
49965;442;12;0;0;0;0;.00nan;0;0
49965;2664;17;37;30;6;24;.800;2767600;0
49965;3756;12;73;24;2;22;.917;3600000;0
49965;5872;17;66;10;0;10;1.000;832400;0
49888;690;152;0;0;0;0;.00nan;0;0
49888;2689;10;81;40;4;36;.900;3600000;0
49888;5950;152;65;37;5;32;.865;3578550;0
49888;6527;10;0;0;0;0;.00nan;0;0
49828;904;3;78;38;4;34;.895;3600000;0
49828;1064;3;0;0;0;0;.00nan;0;0
49828;1652;0;41;31;6;25;.806;2183150;0
49828;6446;0;62;8;0;8;1.000;1346650;0
49826;442;12;23;28;7;21;.750;2284000;0
49826;536;27;61;24;3;21;.875;3600000;0
49826;2062;27;0;0;0;0;.00nan;0;0
49826;3756;12;38;18;4;14;.778;1316000;0
49909;945;30;53;3;0;3;1.000;919450;0
49909;1021;30;39;31;6;25;.806;2632850;0
49909;1664;31;56;32;5;27;.844;3600000;0
49909;2965;31;0;0;0;0;.00nan;0;0
49936;150;26;0;0;0;0;.00nan;0;0
49936;830;26;93;38;2;36;.947;3786350;0
49936;982;28;0;0;0;0;.00nan;0;0
49936;1275;28;74;31;3;28;.903;3778600;0
49923;690;152;70;30;3;27;.900;3900000;0
49923;762;25;0;0;0;0;.00nan;0;0
49923;3273;25;79;36;3;33;.917;3900000;0
49923;5950;152;0;0;0;0;.00nan;0;0
49825;102;8;0;0;0;0;.00nan;0;0
49825;904;3;0;0;0;0;.00nan;0;0
49825;1064;3;98;41;2;39;.951;3900000;0
49825;2123;8;92;32;2;30;.938;3900000;0
49880;443;7;0;0;0;0;.00nan;0;0
49880;703;1;0;0;0;0;.00nan;0;0
49880;1651;7;81;21;1;20;.952;3600000;0
49880;3513;1;87;33;2;31;.939;3565450;0
49928;668;14;0;0;0;0;.00nan;0;0
49928;879;124;84;39;3;36;.923;3600000;0
49928;1218;14;61;29;4;25;.862;3544700;0
49928;1658;124;0;0;0;0;.00nan;0;0
49947;457;29;0;0;0;0;.00nan;0;0
49947;879;124;0;0;0;0;.00nan;0;0
49947;1658;124;73;44;5;39;.886;3600000;0
49947;3462;29;81;23;1;22;.957;3600000;0
49801;567;24;0;0;0;0;.00nan;0;0
49801;933;19;85;30;2;28;.933;3600000;0
49801;1615;19;0;0;0;0;.00nan;0;0
49801;1828;24;57;29;4;25;.862;3563050;0
49967;530;23;0;0;0;0;.00nan;0;0
49967;1664;31;0;0;0;0;.00nan;0;0
49967;2965;31;57;35;5;30;.857;3542800;0
49967;6515;23;90;34;2;32;.941;3600000;0
49860;384;21;35;17;4;13;.765;1233000;0
49860;540;21;10;21;7;14;.667;2367000;0
49860;1652;0;0;0;0;0;.00nan;0;0
49860;6446;0;92;29;1;28;.966;3600000;0
49951;668;14;55;27;4;23;.852;3600000;0
49951;945;30;90;27;1;26;.963;3600000;0
49951;1021;30;0;0;0;0;.00nan;0;0
49951;1218;14;0;0;0;0;.00nan;0;0
49876;613;20;64;20;2;18;.900;3600000;0
49876;862;2;57;11;1;10;.909;1109400;0
49876;952;20;0;0;0;0;.00nan;0;0
49876;5935;2;35;29;6;23;.793;2490600;0
49870;904;3;60;29;4;25;.862;3600000;0
49870;1064;3;0;0;0;0;.00nan;0;0
49870;1294;9;55;15;2;13;.867;2214950;0
49870;5934;9;22;21;6;15;.714;1385050;0
49884;703;1;0;0;0;0;.00nan;0;0
49884;982;28;56;40;6;34;.850;3600000;0
49884;1275;28;0;0;0;0;.00nan;0;0
49884;3513;1;84;37;3;34;.919;3600000;0
50050;457;29;0;0;0;0;.00nan;0;0
50050;2664;17;52;26;4;22;.846;2499750;0
50050;3462;29;66;26;3;23;.885;3600000;0
50050;5872;17;31;14;4;10;.714;1100250;0
49904;0;18;0;0;0;0;.00nan;0;0
49904;738;18;81;29;2;27;.931;3600000;0
49904;2689;10;0;0;0;0;.00nan;0;0
49904;6527;10;56;34;5;29;.853;3600000;0
49893;762;25;71;36;4;32;.889;3486750;0
49893;862;2;0;0;0;0;.00nan;0;0
49893;3273;25;0;0;0;0;.00nan;0;0
49893;5935;2;85;30;2;28;.933;3600000;0
49877;536;27;49;30;5;25;.833;2375500;0
49877;567;24;0;0;0;0;.00nan;0;0
49877;1828;24;54;32;5;27;.844;3600000;0
49877;2062;27;25;11;4;7;.636;1224500;0
49894;442;12;19;19;6;13;.684;2024200;0
49894;1294;9;94;19;0;19;1.000;3600000;0
49894;3756;12;50;13;2;11;.846;1575800;0
49894;5934;9;0;0;0;0;.00nan;0;0
49885;668;14;0;0;0;0;.00nan;0;0
49885;1218;14;100;42;1;41;.976;3600000;0
49885;1652;0;0;0;0;0;.00nan;0;0
49885;6446;0;93;35;2;33;.943;3557350;0
49887;536;27;0;0;0;0;.00nan;0;0
49887;982;28;35;17;4;13;.765;1672500;0
49887;1275;28;41;26;5;21;.808;1927500;0
49887;2062;27;85;31;2;29;.935;3600000;0
49927;457;29;0;0;0;0;.00nan;0;0
49927;690;152;0;0;0;0;.00nan;0;0
49927;3462;29;85;42;4;38;.905;3723300;0
49927;5950;152;100;50;3;47;.940;3723300;0
49933;879;124;78;34;3;31;.912;3600000;0
49933;1658;124;0;0;0;0;.00nan;0;0
49933;2689;10;85;13;0;13;1.000;3600000;0
49933;6527;10;0;0;0;0;.00nan;0;0
49854;102;8;98;39;2;37;.949;3600000;0
49854;530;23;0;0;0;0;.00nan;0;0
49854;2123;8;0;0;0;0;.00nan;0;0
49854;6515;23;69;29;3;26;.897;3548750;0
49901;102;8;0;0;0;0;.00nan;0;0
49901;1664;31;50;35;6;29;.829;3202300;0
49901;2123;8;62;29;4;25;.862;3600000;0
49901;2965;31;52;2;0;2;1.000;372050;0
49846;933;19;89;28;1;27;.964;3555000;0
49846;945;30;0;0;0;0;.00nan;0;0
49846;1021;30;92;18;0;18;1.000;3600000;0
49846;1615;19;0;0;0;0;.00nan;0;0
49990;668;14;76;49;6;43;.878;3562750;0
49990;690;152;55;32;5;27;.844;3600000;0
49990;1218;14;0;0;0;0;.00nan;0;0
49990;5950;152;0;0;0;0;.00nan;0;0
49892;442;12;0;0;0;0;.00nan;0;0
49892;1652;0;100;38;2;36;.947;3600000;0
49892;3756;12;28;30;7;23;.767;3600000;0
49892;6446;0;0;0;0;0;.00nan;0;0
49881;443;7;0;0;0;0;.00nan;0;0
49881;762;25;39;35;7;28;.800;3600000;0
49881;1651;7;98;32;1;31;.969;3600000;0
49881;3273;25;0;0;0;0;.00nan;0;0
50055;567;24;0;0;0;0;.00nan;0;0
50055;613;20;71;33;4;29;.879;3900000;0
50055;952;20;0;0;0;0;.00nan;0;0
50055;1828;24;62;37;4;33;.892;3900000;0
49930;703;1;0;0;0;0;.00nan;0;0
49930;2664;17;0;0;0;0;.00nan;0;0
49930;3513;1;88;46;4;42;.913;3600000;0
49930;5872;17;96;30;1;29;.967;3600000;0
49955;384;21;69;33;4;29;.879;3900000;0
49955;540;21;0;0;0;0;.00nan;0;0
49955;1294;9;0;0;0;0;.00nan;0;0
49955;5934;9;83;44;4;40;.909;3900000;0
50227;830;26;0;0;0;0;.00nan;0;0
50227;889;19;0;0;0;0;.00nan;0;0
50227;933;19;91;29;1;28;.966;3600000;0
50227;2896;26;52;31;5;26;.839;3600000;0
50229;690;152;50;1;0;1;1.000;500750;0
50229;2664;17;0;0;0;0;.00nan;0;0
50229;5872;17;100;33;0;33;1.000;3600000;0
50229;5950;152;37;29;6;23;.793;3099250;0
50231;862;2;82;23;1;22;.957;3600000;0
50231;5935;2;0;0;0;0;.00nan;0;0
50231;6070;23;91;46;4;42;.913;3600000;0
50231;6515;23;0;0;0;0;.00nan;0;0
50233;0;18;0;0;0;0;.00nan;0;0
50233;124;31;100;35;0;35;1.000;3600000;0
50233;738;18;85;38;3;35;.921;3600000;0
50233;1835;31;0;0;0;0;.00nan;0;0
50235;613;20;62;26;3;23;.885;3539650;0
50235;930;9;0;0;0;0;.00nan;0;0
50235;952;20;0;0;0;0;.00nan;0;0
50235;1294;9;100;26;0;26;1.000;3600000;0
50237;384;21;59;17;2;15;.882;3600000;0
50237;540;21;0;0;0;0;.00nan;0;0
50237;879;124;89;72;3;69;.958;3563350;0
50237;6495;124;0;0;0;0;.00nan;0;0
50239;762;25;0;0;0;0;.00nan;0;0
50239;1652;0;0;0;0;0;.00nan;0;0
50239;3273;25;52;25;4;21;.840;3698100;0
50239;6446;0;79;44;5;39;.886;3698100;0
50241;904;29;93;39;3;36;.923;3850100;0
50241;1021;30;73;24;2;22;.917;3850100;0
50241;3318;30;0;0;0;0;.00nan;0;0
50241;3462;29;0;0;0;0;.00nan;0;0
50243;704;3;0;0;0;0;.00nan;0;0
50243;929;8;67;21;2;19;.905;3600000;0
50243;1893;3;71;49;6;43;.878;3600000;0
50243;2123;8;0;0;0;0;.00nan;0;0
50245;703;1;0;0;0;0;.00nan;0;0
50245;1222;10;0;0;0;0;.00nan;0;0
50245;2689;10;49;29;5;24;.828;3600000;0
50245;3513;1;81;29;2;27;.931;3600000;0
50247;567;24;46;33;6;27;.818;2334300;0
50247;1064;7;64;19;2;17;.895;3600000;0
50247;1651;7;0;0;0;0;.00nan;0;0
50247;1828;24;30;12;4;8;.667;1265700;0
50249;530;28;74;32;3;29;.906;3558200;0
50249;1275;28;0;0;0;0;.00nan;0;0
50249;3756;12;0;0;0;0;.00nan;0;0
50249;6985;12;94;35;2;33;.943;3600000;0
50251;668;14;78;20;1;19;.950;3600000;0
50251;2062;27;48;6;1;5;.833;404700;0
50251;3101;27;56;39;6;33;.846;3195300;0
50251;3220;14;0;0;0;0;.00nan;0;0
50253;0;18;0;0;0;0;.00nan;0;0
50253;703;1;86;32;2;30;.938;3600000;0
50253;738;18;71;30;3;27;.900;3571250;0
50253;3513;1;0;0;0;0;.00nan;0;0
50255;384;21;0;0;0;0;.00nan;0;0
50255;540;21;46;22;4;18;.818;3600000;0
50255;862;2;83;48;5;43;.896;3587500;0
50255;5935;2;0;0;0;0;.00nan;0;0
50257;567;24;100;39;1;38;.974;3600000;0
50257;830;26;0;0;0;0;.00nan;0;0
50257;1828;24;0;0;0;0;.00nan;0;0
50257;2896;26;75;31;3;28;.903;3515500;0
50259;124;31;0;0;0;0;.00nan;0;0
50259;1835;31;89;44;4;40;.909;3636100;0
50259;2062;27;0;0;0;0;.00nan;0;0
50259;3109;27;75;32;3;29;.906;3636100;0
50261;864;152;78;27;2;25;.926;3600000;0
50261;1652;0;57;35;5;30;.857;3600000;0
50261;5950;152;0;0;0;0;.00nan;0;0
50261;6446;0;0;0;0;0;.00nan;0;0
50263;294;124;0;0;0;0;.00nan;0;0
50263;613;20;0;0;0;0;.00nan;0;0
50263;665;124;73;44;5;39;.886;3600000;0
50263;952;20;85;31;2;29;.935;3600000;0
50265;668;14;41;37;7;30;.811;3571950;0
50265;3220;14;0;0;0;0;.00nan;0;0
50265;3756;12;91;52;5;47;.904;3600000;0
50265;6985;12;0;0;0;0;.00nan;0;0
50267;762;25;67;34;4;30;.882;3600000;0
50267;2664;17;0;0;0;0;.00nan;0;0
50267;3273;25;0;0;0;0;.00nan;0;0
50267;5872;17;89;27;1;26;.963;3600000;0
50269;8;30;100;39;2;37;.949;3600000;0
50269;904;29;0;0;0;0;.00nan;0;0
50269;3318;30;0;0;0;0;.00nan;0;0
50269;3462;29;47;23;4;19;.826;3535750;0
50271;889;19;0;0;0;0;.00nan;0;0
50271;929;8;0;0;0;0;.00nan;0;0
50271;933;19;74;36;4;32;.889;3600000;0
50271;2123;8;46;29;5;24;.828;3592550;0
50273;530;28;66;40;5;35;.875;3577100;0
50273;704;3;82;41;4;37;.902;3600000;0
50273;1275;28;0;0;0;0;.00nan;0;0
50273;1893;3;0;0;0;0;.00nan;0;0
50275;2075;10;79;22;1;21;.955;3600000;0
50275;2689;10;0;0;0;0;.00nan;0;0
50275;2746;23;37;36;7;29;.806;3600000;0
50275;6070;23;0;0;0;0;.00nan;0;0
50277;930;9;0;0;0;0;.00nan;0;0
50277;1064;7;49;36;6;30;.833;3583050;0
50277;1294;9;82;48;5;43;.896;3600000;0
50277;1651;7;0;0;0;0;.00nan;0;0
50279;567;24;94;36;2;34;.944;3900000;0
50279;929;8;81;29;2;27;.931;3900000;0
50279;1828;24;0;0;0;0;.00nan;0;0
50279;2123;8;0;0;0;0;.00nan;0;0
50281;690;152;83;31;2;29;.935;3900000;0
50281;864;152;0;0;0;0;.00nan;0;0
50281;2746;23;0;0;0;0;.00nan;0;0
50281;6070;23;88;30;2;28;.933;3900000;0
50283;442;12;86;39;3;36;.923;3892200;0
50283;2965;31;93;36;2;34;.944;3892200;0
50283;3756;12;0;0;0;0;.00nan;0;0
50283;6493;31;0;0;0;0;.00nan;0;0
50285;294;124;0;0;0;0;.00nan;0;0
50285;704;3;80;41;4;37;.902;3600000;0
50285;1658;124;75;31;3;28;.903;3600000;0
50285;1893;3;0;0;0;0;.00nan;0;0
50287;668;14;0;0;0;0;.00nan;0;0
50287;703;1;0;0;0;0;.00nan;0;0
50287;3220;14;41;26;5;21;.808;3519650;0
50287;3513;1;78;44;3;41;.932;3600000;0
50289;8;30;0;0;0;0;.00nan;0;0
50289;762;25;0;0;0;0;.00nan;0;0
50289;3273;25;89;27;1;26;.963;3600000;0
50289;3318;30;40;25;5;20;.800;3600000;0
50291;530;28;0;0;0;0;.00nan;0;0
50291;1275;28;77;39;4;35;.897;3900000;0
50291;2075;10;0;0;0;0;.00nan;0;0
50291;6527;10;100;53;4;49;.925;3900000;0
50293;930;9;74;24;2;22;.917;3600000;0
50293;1064;7;0;0;0;0;.00nan;0;0
50293;1294;9;0;0;0;0;.00nan;0;0
50293;1651;7;65;32;4;28;.875;3550450;0
50295;1652;0;0;0;0;0;.00nan;0;0
50295;2664;17;93;47;3;44;.936;3641150;0
50295;5872;17;0;0;0;0;.00nan;0;0
50295;6446;0;74;35;4;31;.886;3641150;0
50297;0;18;93;37;2;35;.946;3600000;0
50297;738;18;0;0;0;0;.00nan;0;0
50297;904;29;68;41;5;36;.878;3600000;0
50297;3462;29;0;0;0;0;.00nan;0;0
50299;830;26;70;29;3;26;.897;3600000;0
50299;2062;27;0;0;0;0;.00nan;0;0
50299;2896;26;0;0;0;0;.00nan;0;0
50299;3109;27;64;32;4;28;.875;3517400;0
50301;862;2;0;0;0;0;.00nan;0;0
50301;889;19;0;0;0;0;.00nan;0;0
50301;1615;19;55;21;3;18;.857;3559500;0
50301;5935;2;83;30;2;28;.933;3600000;0
50303;384;21;0;0;0;0;.00nan;0;0
50303;540;21;77;34;3;31;.912;3900000;0
50303;613;20;65;29;3;26;.897;3900000;0
50303;952;20;0;0;0;0;.00nan;0;0
50305;1652;0;0;0;0;0;.00nan;0;0
50305;2062;27;58;41;6;35;.854;3128300;0
50305;3109;27;52;2;0;2;1.000;471700;0
50305;6446;0;64;20;2;18;.900;3600000;0
50307;738;18;82;35;3;32;.914;3543900;0
50307;904;29;0;0;0;0;.00nan;0;0
50307;1247;18;0;0;0;0;.00nan;0;0
50307;3462;29;100;52;2;50;.962;3600000;0
50309;8;30;0;0;0;0;.00nan;0;0
50309;1222;10;75;30;3;27;.900;3600000;0
50309;2075;10;0;0;0;0;.00nan;0;0
50309;2653;30;85;14;0;14;1.000;3600000;0
50311;613;20;71;36;4;32;.889;3555100;0
50311;889;19;0;0;0;0;.00nan;0;0
50311;933;19;69;28;3;25;.893;3600000;0
50311;952;20;0;0;0;0;.00nan;0;0
50313;567;24;67;34;4;30;.882;3532100;0
50313;668;14;76;26;2;24;.923;3600000;0
50313;1828;24;0;0;0;0;.00nan;0;0
50313;3220;14;0;0;0;0;.00nan;0;0
50315;762;25;47;29;5;24;.828;3531550;0
50315;930;9;0;0;0;0;.00nan;0;0
50315;1294;9;94;48;4;44;.917;3600000;0
50315;3273;25;0;0;0;0;.00nan;0;0
50317;530;28;97;38;2;36;.947;3600000;0
50317;1275;28;0;0;0;0;.00nan;0;0
50317;2664;17;0;0;0;0;.00nan;0;0
50317;5872;17;39;31;6;25;.806;3600000;0
50319;1064;7;0;0;0;0;.00nan;0;0
50319;1651;7;78;21;1;20;.952;3600000;0
50319;1664;31;43;9;2;7;.778;700500;0
50319;6493;31;45;33;6;27;.818;2899500;0
50321;294;124;41;14;3;11;.786;1360450;0
50321;929;8;0;0;0;0;.00nan;0;0
50321;1658;124;32;27;6;21;.778;2239550;0
50321;2123;8;100;26;0;26;1.000;3600000;0
50323;703;1;0;0;0;0;.00nan;0;0
50323;862;2;16;18;6;12;.667;1909950;0
50323;3513;1;91;34;2;32;.941;3600000;0
50323;5935;2;61;7;0;7;1.000;1690050;0
50325;442;12;100;34;1;33;.971;3900000;0
50325;864;152;0;0;0;0;.00nan;0;0
50325;3756;12;0;0;0;0;.00nan;0;0
50325;5483;152;96;36;1;35;.972;3875150;0
50327;704;3;86;41;4;37;.902;3900000;0
50327;830;26;0;0;0;0;.00nan;0;0
50327;1893;3;0;0;0;0;.00nan;0;0
50327;2896;26;83;43;4;39;.907;3900000;0
50329;384;21;0;0;0;0;.00nan;0;0
50329;540;21;96;43;3;40;.930;3600000;0
50329;2746;23;0;0;0;0;.00nan;0;0
50329;6515;23;54;25;4;21;.840;3551850;0
50331;929;8;0;0;0;0;.00nan;0;0
50331;2123;8;85;31;2;29;.935;3600000;0
50331;2664;17;75;33;3;30;.909;3575150;0
50331;5872;17;0;0;0;0;.00nan;0;0
50333;8;30;63;19;2;17;.895;3600000;0
50333;613;20;0;0;0;0;.00nan;0;0
50333;952;20;66;28;3;25;.893;3600000;0
50333;2653;30;0;0;0;0;.00nan;0;0
50335;530;28;0;0;0;0;.00nan;0;0
50335;704;3;0;0;0;0;.00nan;0;0
50335;1275;28;75;19;1;18;.947;3600000;0
50335;1893;3;98;43;2;41;.953;3600000;0
50337;904;29;71;17;1;16;.941;1036150;0
50337;1652;0;48;44;8;36;.818;3614950;0
50337;3462;29;51;36;6;30;.833;2578800;0
50337;6446;0;0;0;0;0;.00nan;0;0
50339;703;1;100;25;0;25;1.000;3600000;0
50339;3513;1;0;0;0;0;.00nan;0;0
50339;3756;12;0;0;0;0;.00nan;0;0
50339;5889;12;80;41;4;37;.902;3600000;0
50341;384;21;82;41;4;37;.902;3600000;0
50341;540;21;0;0;0;0;.00nan;0;0
50341;930;9;0;0;0;0;.00nan;0;0
50341;1294;9;56;33;5;28;.848;3542650;0
50343;1064;7;61;35;5;30;.857;3586250;0
50343;1651;7;0;0;0;0;.00nan;0;0
50343;1664;31;67;32;4;28;.875;3600000;0
50343;2965;31;0;0;0;0;.00nan;0;0
50345;738;18;0;0;0;0;.00nan;0;0
50345;864;152;0;0;0;0;.00nan;0;0
50345;1247;18;60;23;3;20;.870;3600000;0
50345;5668;152;78;46;5;41;.891;3572850;0
50347;567;24;0;0;0;0;.00nan;0;0
50347;830;26;84;23;1;22;.957;3600000;0
50347;1828;24;83;31;2;29;.935;3545750;0
50347;2896;26;0;0;0;0;.00nan;0;0
50349;862;2;0;0;0;0;.00nan;0;0
50349;5935;2;68;34;4;30;.882;3571950;0
50349;5944;23;82;35;3;32;.914;3600000;0
50351;536;27;71;36;4;32;.889;3600000;0
50351;762;25;0;0;0;0;.00nan;0;0
50351;2062;27;0;0;0;0;.00nan;0;0
50351;3273;25;100;38;1;37;.974;3600000;0
50353;294;124;34;21;5;16;.762;3600000;0
50353;889;19;0;0;0;0;.00nan;0;0
50353;933;19;69;28;3;25;.893;3600000;0
50353;1658;124;0;0;0;0;.00nan;0;0
50355;668;14;0;0;0;0;.00nan;0;0
50355;2075;10;53;3;0;3;1.000;485350;0
50355;2689;10;73;48;6;42;.875;3092350;0
50355;3220;14;59;29;4;25;.862;3600000;0
50357;762;25;0;0;0;0;.00nan;0;0
50357;929;8;0;0;0;0;.00nan;0;0
50357;2123;8;86;38;3;35;.921;3600000;0
50357;3273;25;41;31;6;25;.806;3600000;0
50359;703;1;95;30;1;29;.967;3600000;0
50359;3513;1;0;0;0;0;.00nan;0;0
50359;5944;23;0;0;0;0;.00nan;0;0
50359;6515;23;75;45;5;40;.889;3600000;0
50361;384;21;0;0;0;0;.00nan;0;0
50361;540;21;85;37;3;34;.919;3600000;0
50361;830;26;46;5;1;4;.800;340350;0
50361;2896;26;43;32;6;26;.813;3259650;0
50363;613;20;97;37;2;35;.946;3900000;0
50363;704;3;0;0;0;0;.00nan;0;0
50363;952;20;0;0;0;0;.00nan;0;0
50363;1893;3;100;52;2;50;.962;3900000;0
50365;294;124;0;0;0;0;.00nan;0;0
50365;1658;124;67;46;6;40;.870;3600000;0
50365;2965;31;0;0;0;0;.00nan;0;0
50365;6493;31;75;37;4;33;.892;3600000;0
50367;530;28;89;41;3;38;.927;3549450;0
50367;904;29;100;43;2;41;.953;3600000;0
50367;1275;28;0;0;0;0;.00nan;0;0
50367;3462;29;0;0;0;0;.00nan;0;0
50369;442;12;85;62;5;57;.919;3504050;0
50369;668;14;81;34;3;31;.912;3600000;0
50369;3220;14;0;0;0;0;.00nan;0;0
50369;3756;12;0;0;0;0;.00nan;0;0
50371;862;2;87;31;2;29;.935;3600000;0
50371;1294;9;25;23;6;17;.739;2395350;0
50371;5934;9;67;9;0;9;1.000;1204650;0
50371;5935;2;0;0;0;0;.00nan;0;0
50373;864;152;0;0;0;0;.00nan;0;0
50373;1064;7;100;34;0;34;1.000;3600000;0
50373;1651;7;0;0;0;0;.00nan;0;0
50373;5451;152;62;43;6;37;.860;3600000;0
50375;738;18;90;37;2;35;.946;3553800;0
50375;1247;18;0;0;0;0;.00nan;0;0
50375;2075;10;94;30;1;29;.967;3600000;0
50375;6527;10;0;0;0;0;.00nan;0;0
50377;945;30;0;0;0;0;.00nan;0;0
50377;1021;30;70;35;4;31;.886;3525500;0
50377;2664;17;96;36;2;34;.944;3600000;0
50377;5872;17;0;0;0;0;.00nan;0;0
50379;536;27;0;0;0;0;.00nan;0;0
50379;889;19;0;0;0;0;.00nan;0;0
50379;933;19;86;44;4;40;.909;3567700;0
50379;2062;27;74;25;2;23;.920;3600000;0
50381;567;24;84;44;4;40;.909;3597800;0
50381;1652;0;0;0;0;0;.00nan;0;0
50381;1828;24;0;0;0;0;.00nan;0;0
50381;6446;0;81;28;2;26;.929;3600000;0
50383;738;18;0;0;0;0;.00nan;0;0
50383;1064;7;80;22;1;21;.955;3600000;0
50383;1247;18;92;46;4;42;.913;3600000;0
50383;1651;7;0;0;0;0;.00nan;0;0
50385;945;30;55;22;3;19;.864;3563350;0
50385;1021;30;0;0;0;0;.00nan;0;0
50385;1664;31;91;35;1;34;.971;3600000;0
50385;2965;31;0;0;0;0;.00nan;0;0
50387;704;3;40;24;5;19;.792;3590750;0
50387;762;25;59;27;4;23;.852;3586500;0
50387;1893;3;0;0;0;0;.00nan;0;0
50387;3273;25;0;0;0;0;.00nan;0;0
50389;1294;9;48;24;4;20;.833;3554250;0
50389;5934;9;0;0;0;0;.00nan;0;0
50389;5944;23;83;29;2;27;.931;3600000;0
50389;6515;23;0;0;0;0;.00nan;0;0
50391;442;12;83;24;1;23;.958;3849350;0
50391;2075;10;0;0;0;0;.00nan;0;0
50391;5889;12;0;0;0;0;.00nan;0;0
50391;6527;10;79;27;2;25;.926;3849350;0
50393;536;27;85;30;2;28;.933;3600000;0
50393;862;2;53;32;5;27;.844;3600000;0
50393;2062;27;0;0;0;0;.00nan;0;0
50393;5935;2;0;0;0;0;.00nan;0;0
50395;530;28;0;0;0;0;.00nan;0;0
50395;904;29;0;0;0;0;.00nan;0;0
50395;1275;28;80;34;3;31;.912;3600000;0
50395;3462;29;74;44;5;39;.886;3600000;0
50397;384;21;0;0;0;0;.00nan;0;0
50397;540;21;94;38;2;36;.947;3723250;0
50397;929;8;81;23;1;22;.957;3723250;0
50397;2123;8;0;0;0;0;.00nan;0;0
50399;294;124;0;0;0;0;.00nan;0;0
50399;567;24;79;34;3;31;.912;3600000;0
50399;1658;124;100;28;0;28;1.000;3600000;0
50399;1828;24;0;0;0;0;.00nan;0;0
50401;830;26;0;0;0;0;.00nan;0;0
50401;2664;17;0;0;0;0;.00nan;0;0
50401;2896;26;76;26;2;24;.923;3600000;0
50401;5872;17;77;34;3;31;.912;3586000;0
50403;889;19;76;32;3;29;.906;3577550;0
50403;933;19;0;0;0;0;.00nan;0;0
50403;1852;152;66;21;2;19;.905;3600000;0
50403;5950;152;0;0;0;0;.00nan;0;0
50405;613;20;91;41;3;38;.927;3600000;0
50405;668;14;64;38;5;33;.868;3566450;0
50405;952;20;0;0;0;0;.00nan;0;0
50405;3220;14;0;0;0;0;.00nan;0;0
50407;703;1;53;32;5;27;.844;3543700;0
50407;1652;0;0;0;0;0;.00nan;0;0
50407;3513;1;0;0;0;0;.00nan;0;0
50407;6446;0;75;32;3;29;.906;3600000;0
50469;457;32;98;42;1;41;.976;3900000;0
50469;2075;54;86;26;1;25;.962;3900000;0
50469;2689;54;0;0;0;0;.00nan;0;0
50469;2746;32;0;0;0;0;.00nan;0;0
50486;930;55;0;0;0;0;.00nan;0;0
50486;1547;48;0;0;0;0;.00nan;0;0
50486;1959;48;83;45;4;41;.911;3600000;0
50486;3319;55;82;27;1;26;.963;3600000;0
50415;977;40;0;0;0;0;.00nan;0;0
50415;1507;41;88;47;3;44;.936;3600000;0
50415;2116;41;0;0;0;0;.00nan;0;0
50415;5923;40;52;32;5;27;.844;3592000;0
51392;294;125;86;38;3;35;.921;3600000;0
51392;551;50;54;28;4;24;.857;3600000;0
51392;665;125;0;0;0;0;.00nan;0;0
51392;737;50;0;0;0;0;.00nan;0;0
51307;704;36;55;33;4;29;.879;3549000;0
51307;1919;34;0;0;0;0;.00nan;0;0
51307;2021;34;58;29;3;26;.897;3600000;0
51307;2845;36;0;0;0;0;.00nan;0;0
51366;8;44;44;20;3;17;.850;3528000;0
51366;124;123;0;0;0;0;.00nan;0;0
51366;2653;44;0;0;0;0;.00nan;0;0
51366;6493;123;94;37;1;36;.973;3600000;0
50423;1633;38;0;0;0;0;.00nan;0;0
50423;1771;45;74;31;2;29;.935;3600000;0
50423;2115;45;0;0;0;0;.00nan;0;0
50423;6571;38;69;30;3;27;.900;3600000;0
50418;526;59;70;50;6;44;.880;3600000;0
50418;892;59;0;0;0;0;.00nan;0;0
50418;1531;153;0;0;0;0;.00nan;0;0
50418;1852;153;76;31;2;29;.935;3600000;0
50428;1835;33;67;7;0;7;1.000;881000;0
50428;1926;47;35;32;6;26;.813;2866000;0
50428;5668;33;28;34;7;27;.794;3019000;0
50428;5740;47;47;8;1;7;.875;1034000;0
50411;102;53;0;0;0;0;.00nan;0;0
50411;958;53;45;47;7;40;.851;3600000;0
50411;1831;57;92;18;0;18;1.000;3600000;0
50411;3756;57;0;0;0;0;.00nan;0;0
50413;1269;56;0;0;0;0;.00nan;0;0
50413;3101;37;0;0;0;0;.00nan;0;0
50413;3395;37;69;37;4;33;.892;3600000;0
50413;5820;56;7;35;9;26;.743;3600000;0
50409;889;62;0;0;0;0;.00nan;0;0
50409;1269;56;67;28;3;25;.893;3600000;0
50409;3066;62;84;34;2;32;.941;3600000;0
50409;5820;56;0;0;0;0;.00nan;0;0
50414;1547;48;64;25;3;22;.880;3553000;0
50414;1959;48;0;0;0;0;.00nan;0;0
50414;3101;37;99;46;2;44;.957;3600000;0
50414;3395;37;0;0;0;0;.00nan;0;0
50410;1044;43;51;30;4;26;.867;3600000;0
50410;1264;58;63;10;0;10;1.000;1735000;0
50410;5948;58;28;26;6;20;.769;1810000;0
50410;5949;43;0;0;0;0;.00nan;0;0
50412;102;53;42;33;6;27;.818;2369000;0
50412;958;53;69;14;0;14;1.000;1231000;0
50412;2921;60;0;0;0;0;.00nan;0;0
50412;3391;60;83;23;1;22;.957;3600000;0
50419;294;125;0;0;0;0;.00nan;0;0
50419;665;125;51;29;4;25;.862;3900000;0
50419;977;40;79;38;4;34;.895;3900000;0
50419;5923;40;0;0;0;0;.00nan;0;0
50669;1926;47;63;40;5;35;.875;3584000;0
50669;2075;54;0;0;0;0;.00nan;0;0
50669;2689;54;91;40;3;37;.925;3600000;0
50669;5740;47;0;0;0;0;.00nan;0;0
50480;124;123;71;31;3;28;.903;3600000;0
50480;526;59;0;0;0;0;.00nan;0;0
50480;892;59;60;36;5;31;.861;3600000;0
50480;6493;123;0;0;0;0;.00nan;0;0
50429;1507;41;97;33;1;32;.970;3900000;0
50429;1531;153;0;0;0;0;.00nan;0;0
50429;1852;153;94;30;1;29;.967;3900000;0
50429;2116;41;0;0;0;0;.00nan;0;0
50478;8;44;0;0;0;0;.00nan;0;0
50478;457;32;74;42;4;38;.905;3560000;0
50478;2653;44;74;31;2;29;.935;3600000;0
50478;2746;32;0;0;0;0;.00nan;0;0
50408;551;50;0;0;0;0;.00nan;0;0
50408;737;50;69;39;4;35;.897;3576000;0
50408;1831;57;80;32;2;30;.938;3600000;0
50408;3756;57;0;0;0;0;.00nan;0;0
50420;1771;45;0;0;0;0;.00nan;0;0
50420;2115;45;78;24;1;23;.958;3600000;0
50420;2921;60;40;40;6;34;.850;3600000;0
50420;3391;60;0;0;0;0;.00nan;0;0
50427;889;62;64;36;4;32;.889;3900000;0
50427;1919;34;74;36;4;32;.889;3900000;0
50427;2021;34;0;0;0;0;.00nan;0;0
50427;3066;62;0;0;0;0;.00nan;0;0
50437;1531;153;15;19;6;13;.684;2698000;0
50437;1835;33;58;33;4;29;.879;3600000;0
50437;1852;153;57;16;2;14;.875;902000;0
50437;5668;33;0;0;0;0;.00nan;0;0
50466;930;55;25;6;3;3;.500;390000;0
50466;1507;41;0;0;0;0;.00nan;0;0
50466;2116;41;74;31;2;29;.935;3600000;0
50466;3319;55;37;28;5;23;.821;3210000;0
51362;457;32;0;0;0;0;.00nan;0;0
51362;2746;32;51;38;5;33;.868;3593000;0
51362;3101;37;0;0;0;0;.00nan;0;0
51362;3395;37;84;36;3;33;.917;3600000;0
50574;124;123;0;0;0;0;.00nan;0;0
50574;704;36;0;0;0;0;.00nan;0;0
50574;2845;36;69;39;4;35;.897;3600000;0
50574;6493;123;100;22;0;22;1.000;3600000;0
50425;8;44;55;24;3;21;.875;3598000;0
50425;1044;43;0;0;0;0;.00nan;0;0
50425;2653;44;0;0;0;0;.00nan;0;0
50425;5949;43;69;26;2;24;.923;3600000;0
50973;1926;47;0;0;0;0;.00nan;0;0
50973;2075;54;62;38;5;33;.868;3585000;0
50973;2689;54;0;0;0;0;.00nan;0;0
50973;5740;47;56;28;4;24;.857;3600000;0
50416;1771;45;68;25;2;23;.920;3600000;0
50416;1831;57;0;0;0;0;.00nan;0;0
50416;2115;45;0;0;0;0;.00nan;0;0
50416;3756;57;81;38;3;35;.921;3585000;0
50417;977;40;68;30;3;27;.900;3690000;0
50417;1264;58;0;0;0;0;.00nan;0;0
50417;5923;40;0;0;0;0;.00nan;0;0
50417;5948;58;86;34;2;32;.941;3690000;0
50432;1269;56;54;4;0;4;1.000;474000;0
50432;1919;34;0;0;0;0;.00nan;0;0
50432;2021;34;53;28;4;24;.857;3600000;0
50432;5820;56;38;31;6;25;.806;3057000;0
50433;102;53;100;29;0;29;1.000;3600000;0
50433;294;125;0;0;0;0;.00nan;0;0
50433;665;125;83;44;3;41;.932;3600000;0
50433;958;53;0;0;0;0;.00nan;0;0
50471;526;59;0;0;0;0;.00nan;0;0
50471;551;50;83;26;1;25;.962;3600000;0
50471;737;50;0;0;0;0;.00nan;0;0
50471;892;59;88;37;2;35;.946;3555000;0
50445;1044;43;81;35;2;33;.943;3900000;0
50445;1633;38;78;27;2;25;.926;3900000;0
50445;5949;43;0;0;0;0;.00nan;0;0
50445;6571;38;0;0;0;0;.00nan;0;0
51373;1269;56;58;25;3;22;.880;3600000;0
51373;1926;47;54;51;7;44;.863;3600000;0
51373;5740;47;0;0;0;0;.00nan;0;0
51373;5820;56;0;0;0;0;.00nan;0;0
51354;102;53;95;44;3;41;.932;3570000;0
51354;958;53;0;0;0;0;.00nan;0;0
51354;1547;48;72;27;2;25;.926;3600000;0
51354;1959;48;0;0;0;0;.00nan;0;0
50659;704;36;85;63;4;59;.937;3580000;0
50659;889;62;0;0;0;0;.00nan;0;0
50659;2845;36;0;0;0;0;.00nan;0;0
50659;3066;62;68;23;2;21;.913;3600000;0
50435;124;123;0;0;0;0;.00nan;0;0
50435;2921;60;0;0;0;0;.00nan;0;0
50435;3391;60;51;22;3;19;.864;3567000;0
50435;6493;123;91;35;2;33;.943;3600000;0
50455;294;125;46;33;6;27;.818;3600000;0
50455;665;125;0;0;0;0;.00nan;0;0
50455;1633;38;0;0;0;0;.00nan;0;0
50455;6571;38;100;24;0;24;1.000;3600000;0
51324;1531;153;0;0;0;0;.00nan;0;0
51324;1771;45;0;0;0;0;.00nan;0;0
51324;1852;153;98;37;1;36;.973;3600000;0
51324;2115;45;91;22;0;22;1.000;3600000;0
51311;1507;41;65;22;2;20;.909;3600000;0
51311;1831;57;0;0;0;0;.00nan;0;0
51311;2116;41;0;0;0;0;.00nan;0;0
51311;3756;57;54;38;5;33;.868;3600000;0
50421;1547;48;0;0;0;0;.00nan;0;0
50421;1959;48;62;41;4;37;.902;3600000;0
50421;3101;37;0;0;0;0;.00nan;0;0
50421;3395;37;75;30;3;27;.900;3600000;0
50507;457;32;0;0;0;0;.00nan;0;0
50507;551;50;0;0;0;0;.00nan;0;0
50507;737;50;83;36;2;34;.944;3900000;0
50507;2746;32;74;33;2;31;.939;3900000;0
50443;930;55;86;36;2;34;.944;3600000;0
50443;1919;34;41;24;4;20;.833;3600000;0
50443;2021;34;0;0;0;0;.00nan;0;0
50443;3319;55;0;0;0;0;.00nan;0;0
51348;526;59;0;0;0;0;.00nan;0;0
51348;892;59;46;21;3;18;.857;3552000;0
51348;1044;43;96;39;1;38;.974;3600000;0
51348;5949;43;0;0;0;0;.00nan;0;0
50705;8;44;62;26;3;23;.885;3600000;0
50705;704;36;52;37;5;32;.865;3553000;0
50705;2653;44;0;0;0;0;.00nan;0;0
50705;2845;36;0;0;0;0;.00nan;0;0
50430;1264;58;56;3;0;3;1.000;1289000;0
50430;1835;33;44;36;6;30;.833;3600000;0
50430;5668;33;0;0;0;0;.00nan;0;0
50430;5948;58;53;25;4;21;.840;2311000;0
50446;977;40;0;0;0;0;.00nan;0;0
50446;1269;56;0;0;0;0;.00nan;0;0
50446;5820;56;58;22;3;19;.864;3600000;0
50446;5923;40;100;30;0;30;1.000;3600000;0
50460;1507;41;66;28;3;25;.893;3579000;0
50460;2116;41;0;0;0;0;.00nan;0;0
50460;2921;60;66;17;2;15;.882;3600000;0
50460;3391;60;0;0;0;0;.00nan;0;0
51383;930;55;100;56;2;54;.964;3900000;0
51383;3101;37;0;0;0;0;.00nan;0;0
51383;3319;55;0;0;0;0;.00nan;0;0
51383;3395;37;93;43;2;41;.953;3900000;0
50492;1919;34;61;39;4;35;.897;3600000;0
50492;1926;47;90;25;1;24;.960;3600000;0
50492;2021;34;0;0;0;0;.00nan;0;0
50492;5740;47;0;0;0;0;.00nan;0;0
50439;1547;48;44;34;5;29;.853;3600000;0
50439;1835;33;0;0;0;0;.00nan;0;0
50439;1959;48;0;0;0;0;.00nan;0;0
50439;5668;33;84;36;2;34;.944;3600000;0
51302;704;36;0;0;0;0;.00nan;0;0
51302;889;62;0;0;0;0;.00nan;0;0
51302;2845;36;60;21;2;19;.905;3600000;0
51302;3066;62;65;29;3;26;.897;3550000;0
50451;1269;56;29;30;6;24;.800;3254000;0
50451;1547;48;0;0;0;0;.00nan;0;0
50451;1959;48;66;39;4;35;.897;3600000;0
50451;5820;56;55;3;0;3;1.000;292000;0
50426;930;55;0;0;0;0;.00nan;0;0
50426;1771;45;0;0;0;0;.00nan;0;0
50426;2115;45;66;33;3;30;.909;3600000;0
50426;3319;55;64;46;5;41;.891;3600000;0
50516;457;32;0;0;0;0;.00nan;0;0
50516;1926;47;54;6;0;6;1.000;599000;0
50516;2746;32;89;30;1;29;.967;3600000;0
50516;5740;47;20;26;6;20;.769;3001000;0
51391;1531;153;0;0;0;0;.00nan;0;0
51391;1852;153;90;42;3;39;.929;3600000;0
51391;1919;34;0;0;0;0;.00nan;0;0
51391;2021;34;69;36;4;32;.889;3586000;0
50438;294;125;0;0;0;0;.00nan;0;0
50438;665;125;100;37;0;37;1.000;3600000;0
50438;3101;37;60;23;2;21;.913;3562000;0
50438;3395;37;0;0;0;0;.00nan;0;0
50458;1633;38;0;0;0;0;.00nan;0;0
50458;2075;54;0;0;0;0;.00nan;0;0
50458;2689;54;45;24;4;20;.833;3574000;0
50458;6571;38;73;27;2;25;.926;3600000;0
50436;551;50;68;32;3;29;.906;3600000;0
50436;737;50;0;0;0;0;.00nan;0;0
50436;1264;58;0;0;0;0;.00nan;0;0
50436;5948;58;82;25;1;24;.960;3600000;0
50461;8;44;71;29;3;26;.897;3600000;0
50461;2653;44;0;0;0;0;.00nan;0;0
50461;2921;60;63;11;0;11;1.000;451000;0
50461;3391;60;38;32;6;26;.813;3149000;0
50467;102;53;98;49;3;46;.939;3553000;0
50467;526;59;0;0;0;0;.00nan;0;0
50467;892;59;98;40;1;39;.975;3600000;0
50467;958;53;0;0;0;0;.00nan;0;0
50434;1044;43;87;45;3;42;.933;3558000;0
50434;1831;57;0;0;0;0;.00nan;0;0
50434;3756;57;81;33;2;31;.939;3600000;0
50434;5949;43;0;0;0;0;.00nan;0;0
50452;124;123;0;0;0;0;.00nan;0;0
50452;977;40;0;0;0;0;.00nan;0;0
50452;5923;40;93;34;1;33;.971;3600000;0
50452;6493;123;64;26;3;23;.885;3517000;0
51390;8;44;0;0;0;0;.00nan;0;0
51390;294;125;0;0;0;0;.00nan;0;0
51390;665;125;94;33;2;31;.939;3623000;0
51390;2653;44;82;26;1;25;.962;3623000;0
50475;124;123;86;26;1;25;.962;3600000;0
50475;1507;41;0;0;0;0;.00nan;0;0
50475;2116;41;61;24;2;22;.917;3600000;0
50475;6493;123;0;0;0;0;.00nan;0;0
50422;1831;57;58;38;5;33;.868;3578000;0
50422;1835;33;88;47;3;44;.936;3600000;0
50422;3756;57;0;0;0;0;.00nan;0;0
50422;5668;33;0;0;0;0;.00nan;0;0
50660;704;36;0;0;0;0;.00nan;0;0
50660;1633;38;60;30;3;27;.900;3581000;0
50660;2845;36;86;25;1;24;.960;3600000;0
50660;6571;38;0;0;0;0;.00nan;0;0
50424;1044;43;39;31;5;26;.839;3598000;0
50424;1771;45;0;0;0;0;.00nan;0;0
50424;2115;45;54;22;3;19;.864;3600000;0
50424;5949;43;0;0;0;0;.00nan;0;0
50447;1264;58;100;35;0;35;1.000;3600000;0
50447;1531;153;0;0;0;0;.00nan;0;0
50447;1852;153;95;36;1;35;.972;3600000;0
50447;5948;58;0;0;0;0;.00nan;0;0
50483;1507;41;97;47;2;45;.957;3600000;0
50483;2116;41;0;0;0;0;.00nan;0;0
50483;2921;60;68;18;1;17;.944;3600000;0
50483;3391;60;0;0;0;0;.00nan;0;0
50440;102;53;0;0;0;0;.00nan;0;0
50440;551;50;100;36;0;36;1.000;3600000;0
50440;737;50;0;0;0;0;.00nan;0;0
50440;958;53;88;34;1;33;.971;3551000;0
50497;526;59;0;0;0;0;.00nan;0;0
50497;889;62;0;0;0;0;.00nan;0;0
50497;892;59;66;38;5;33;.868;3537000;0
50497;3066;62;65;33;3;30;.909;3600000;0
50505;457;32;0;0;0;0;.00nan;0;0
50505;1835;33;0;0;0;0;.00nan;0;0
50505;2746;32;57;18;2;16;.889;3600000;0
50505;5668;33;81;46;4;42;.913;3600000;0
50442;2075;54;63;37;5;32;.865;3600000;0
50442;2689;54;0;0;0;0;.00nan;0;0
50442;3101;37;0;0;0;0;.00nan;0;0
50442;3395;37;75;28;2;26;.929;3600000;0
51316;704;36;78;45;3;42;.933;3900000;0
51316;1269;56;0;0;0;0;.00nan;0;0
51316;2845;36;0;0;0;0;.00nan;0;0
51316;5820;56;73;35;3;32;.914;3900000;0
50557;457;32;100;40;0;40;1.000;3600000;0
50557;526;59;64;28;3;25;.893;3600000;0
50557;892;59;0;0;0;0;.00nan;0;0
50557;2746;32;0;0;0;0;.00nan;0;0
50457;1531;153;88;40;3;37;.925;3564000;0
50457;1547;48;74;32;2;30;.938;3600000;0
50457;1852;153;0;0;0;0;.00nan;0;0
50457;1959;48;0;0;0;0;.00nan;0;0
50774;889;62;94;36;1;35;.972;3600000;0
50774;1926;47;68;35;3;32;.914;3528000;0
50774;3066;62;0;0;0;0;.00nan;0;0
50774;5740;47;0;0;0;0;.00nan;0;0
50459;977;40;0;0;0;0;.00nan;0;0
50459;1831;57;0;0;0;0;.00nan;0;0
50459;3756;57;60;24;3;21;.875;3600000;0
50459;5923;40;54;28;4;24;.857;3600000;0
50470;930;55;71;25;2;23;.920;3600000;0
50470;1269;56;64;32;4;28;.875;3512000;0
50470;3319;55;0;0;0;0;.00nan;0;0
50470;5820;56;0;0;0;0;.00nan;0;0
50431;1044;43;0;0;0;0;.00nan;0;0
50431;3101;37;86;54;4;50;.926;3600000;0
50431;3395;37;0;0;0;0;.00nan;0;0
50431;5949;43;84;27;2;25;.926;3600000;0
50477;124;123;0;0;0;0;.00nan;0;0
50477;1633;38;0;0;0;0;.00nan;0;0
50477;6493;123;71;31;3;28;.903;3900000;0
50477;6571;38;64;30;3;27;.900;3900000;0
50448;551;50;30;9;3;6;.667;560000;0
50448;737;50;37;22;5;17;.773;3040000;0
50448;1771;45;58;31;4;27;.871;3600000;0
50448;2115;45;0;0;0;0;.00nan;0;0
50444;1264;58;65;43;6;37;.860;3900000;0
50444;1919;34;41;29;6;23;.793;3324000;0
50444;2021;34;55;5;0;5;1.000;576000;0
50444;5948;58;0;0;0;0;.00nan;0;0
50441;8;44;0;0;0;0;.00nan;0;0
50441;294;125;0;0;0;0;.00nan;0;0
50441;665;125;58;33;5;28;.848;3574000;0
50441;2653;44;49;26;4;22;.846;3600000;0
51357;977;40;83;39;2;37;.949;3544000;0
51357;1831;57;72;19;1;18;.947;3600000;0
51357;3756;57;0;0;0;0;.00nan;0;0
51357;5923;40;0;0;0;0;.00nan;0;0
51367;124;123;85;45;3;42;.933;3600000;0
51367;2921;60;61;19;2;17;.895;3600000;0
51367;3391;60;0;0;0;0;.00nan;0;0
51367;6493;123;0;0;0;0;.00nan;0;0
50456;102;53;37;27;6;21;.778;2962000;0
50456;930;55;0;0;0;0;.00nan;0;0
50456;958;53;60;4;0;4;1.000;638000;0
50456;3319;55;54;29;4;25;.862;3600000;0
50462;294;125;0;0;0;0;.00nan;0;0
50462;665;125;67;16;1;15;.938;3600000;0
50462;704;36;0;0;0;0;.00nan;0;0
50462;2845;36;64;32;3;29;.906;3588000;0
50465;1919;34;0;0;0;0;.00nan;0;0
50465;2021;34;90;42;3;39;.929;3600000;0
50465;2075;54;39;35;6;29;.829;3600000;0
50465;2689;54;0;0;0;0;.00nan;0;0
51295;1507;41;62;29;4;25;.862;3311000;0
51295;1633;38;80;34;3;31;.912;3600000;0
51295;2116;41;50;1;0;1;1.000;262000;0
51295;6571;38;0;0;0;0;.00nan;0;0
51359;526;59;0;0;0;0;.00nan;0;0
51359;892;59;73;25;2;23;.920;3600000;0
51359;2075;54;0;0;0;0;.00nan;0;0
51359;2689;54;36;40;7;33;.825;3600000;0
50476;8;44;0;0;0;0;.00nan;0;0
50476;1531;153;0;0;0;0;.00nan;0;0
50476;1852;153;92;32;1;31;.969;3600000;0
50476;2653;44;49;28;4;24;.857;3600000;0
51333;1771;45;91;25;0;25;1.000;3128000;0
51333;1835;33;82;36;4;32;.889;3545000;0
51333;2115;45;36;9;3;6;.667;472000;0
51333;5668;33;0;0;0;0;.00nan;0;0
51374;977;40;0;0;0;0;.00nan;0;0
51374;1831;57;0;0;0;0;.00nan;0;0
51374;3756;57;38;22;5;17;.773;3572000;0
51374;5923;40;91;40;3;37;.925;3600000;0
50522;889;62;0;0;0;0;.00nan;0;0
50522;1547;48;0;0;0;0;.00nan;0;0
50522;1959;48;98;44;2;42;.955;3600000;0
50522;3066;62;60;11;1;10;.909;3600000;0
50524;457;32;69;25;2;23;.920;3600000;0
50524;1919;34;0;0;0;0;.00nan;0;0
50524;2021;34;34;16;4;12;.750;3524000;0
50524;2746;32;0;0;0;0;.00nan;0;0
50449;551;50;0;0;0;0;.00nan;0;0
50449;737;50;50;32;5;27;.844;3559000;0
50449;2921;60;76;37;3;34;.919;3600000;0
50449;3391;60;0;0;0;0;.00nan;0;0
50485;526;59;61;25;3;22;.880;3569000;0
50485;892;59;0;0;0;0;.00nan;0;0
50485;1264;58;0;0;0;0;.00nan;0;0
50485;5948;58;80;28;2;26;.929;3600000;0
50474;704;36;70;34;3;31;.912;3600000;0
50474;2845;36;0;0;0;0;.00nan;0;0
50474;3101;37;0;0;0;0;.00nan;0;0
50474;3395;37;66;38;4;34;.895;3551000;0
50468;102;53;0;0;0;0;.00nan;0;0
50468;958;53;62;34;4;30;.882;3600000;0
50468;1269;56;0;0;0;0;.00nan;0;0
50468;5820;56;52;34;5;29;.853;3546000;0
50499;294;125;0;0;0;0;.00nan;0;0
50499;665;125;42;41;6;35;.854;3600000;0
50499;930;55;84;35;2;33;.943;3600000;0
50499;3319;55;0;0;0;0;.00nan;0;0
50559;457;32;0;0;0;0;.00nan;0;0
50559;1531;153;0;0;0;0;.00nan;0;0
50559;1852;153;91;39;2;37;.949;3676000;0
50559;2746;32;61;26;3;23;.885;3676000;0
50685;294;125;50;27;4;23;.852;3600000;0
50685;665;125;0;0;0;0;.00nan;0;0
50685;1633;38;0;0;0;0;.00nan;0;0
50685;6571;38;34;21;5;16;.762;3562000;0
50518;1264;58;68;26;2;24;.923;3884000;0
50518;1771;45;0;0;0;0;.00nan;0;0
50518;2115;45;87;46;3;43;.935;3884000;0
50518;5948;58;0;0;0;0;.00nan;0;0
50525;8;44;39;41;7;34;.829;3600000;0
50525;1831;57;54;23;3;20;.870;3600000;0
50525;2653;44;0;0;0;0;.00nan;0;0
50525;3756;57;0;0;0;0;.00nan;0;0
50473;102;53;89;18;0;18;1.000;3600000;0
50473;704;36;0;0;0;0;.00nan;0;0
50473;958;53;0;0;0;0;.00nan;0;0
50473;2845;36;93;30;1;29;.967;3569000;0
50453;1044;43;62;37;4;33;.892;3775000;0
50453;2921;60;0;0;0;0;.00nan;0;0
50453;3391;60;58;36;5;31;.861;3775000;0
50453;5949;43;0;0;0;0;.00nan;0;0
50491;1269;56;66;31;3;28;.903;3844000;0
50491;2075;54;85;35;2;33;.943;3844000;0
50491;2689;54;0;0;0;0;.00nan;0;0
50491;5820;56;0;0;0;0;.00nan;0;0
50489;930;55;0;0;0;0;.00nan;0;0
50489;1926;47;87;33;2;31;.939;3600000;0
50489;3319;55;91;42;3;39;.929;3544000;0
50489;5740;47;0;0;0;0;.00nan;0;0
50484;124;123;61;37;4;33;.892;3548000;0
50484;1835;33;0;0;0;0;.00nan;0;0
50484;5668;33;81;38;3;35;.921;3600000;0
50484;6493;123;0;0;0;0;.00nan;0;0
50488;977;40;90;44;3;41;.932;3900000;0
50488;1507;41;64;30;3;27;.900;3900000;0
50488;2116;41;0;0;0;0;.00nan;0;0
50488;5923;40;0;0;0;0;.00nan;0;0
50501;1507;41;0;0;0;0;.00nan;0;0
50501;1919;34;81;23;1;22;.957;3600000;0
50501;2021;34;0;0;0;0;.00nan;0;0
50501;2116;41;61;28;3;25;.893;3514000;0
50464;124;123;0;0;0;0;.00nan;0;0
50464;1044;43;0;0;0;0;.00nan;0;0
50464;5949;43;100;45;0;45;1.000;3600000;0
50464;6493;123;63;28;3;25;.893;3600000;0
50529;889;62;0;0;0;0;.00nan;0;0
50529;1264;58;75;28;2;26;.929;3569000;0
50529;3066;62;99;49;1;48;.980;3600000;0
50529;5948;58;0;0;0;0;.00nan;0;0
50454;704;36;88;34;2;32;.941;3600000;0
50454;2845;36;0;0;0;0;.00nan;0;0
50454;3101;37;0;0;0;0;.00nan;0;0
50454;3395;37;88;27;1;26;.963;3600000;0
50463;1771;45;0;0;0;0;.00nan;0;0
50463;2075;54;78;37;4;33;.892;3600000;0
50463;2115;45;75;30;2;28;.933;3600000;0
50463;2689;54;0;0;0;0;.00nan;0;0
50481;102;53;57;27;3;24;.889;3600000;0
50481;958;53;0;0;0;0;.00nan;0;0
50481;977;40;0;0;0;0;.00nan;0;0
50481;5923;40;88;38;2;36;.947;3600000;0
50495;1633;38;0;0;0;0;.00nan;0;0
50495;1831;57;0;0;0;0;.00nan;0;0
50495;3756;57;73;28;2;26;.929;3600000;0
50495;6571;38;78;21;1;20;.952;3600000;0
50511;526;59;0;0;0;0;.00nan;0;0
50511;892;59;43;27;5;22;.815;3600000;0
50511;1835;33;75;31;2;29;.935;3600000;0
50511;5668;33;0;0;0;0;.00nan;0;0
50502;930;55;82;29;1;28;.966;3600000;0
50502;1547;48;0;0;0;0;.00nan;0;0
50502;1959;48;57;28;3;25;.893;3542000;0
50502;3319;55;0;0;0;0;.00nan;0;0
50450;551;50;0;0;0;0;.00nan;0;0
50450;737;50;66;22;2;20;.909;3600000;0
50450;1531;153;0;0;0;0;.00nan;0;0
50450;1852;153;74;37;3;34;.919;3559000;0
50543;8;44;21;22;6;16;.727;2193000;0
50543;1771;45;73;42;4;38;.905;3600000;0
50543;2115;45;0;0;0;0;.00nan;0;0
50543;2653;44;66;25;2;23;.920;1407000;0
50586;1531;153;75;33;3;30;.909;3600000;0
50586;1852;153;0;0;0;0;.00nan;0;0
50586;1926;47;51;29;4;25;.862;3599000;0
50586;5740;47;0;0;0;0;.00nan;0;0
51321;102;53;0;0;0;0;.00nan;0;0
51321;958;53;36;37;6;31;.838;3600000;0
51321;1507;41;83;33;2;31;.939;3600000;0
51321;2116;41;0;0;0;0;.00nan;0;0
50500;977;40;79;50;5;45;.900;3565000;0
50500;3101;37;58;25;3;22;.880;3600000;0
50500;3395;37;0;0;0;0;.00nan;0;0
50500;5923;40;0;0;0;0;.00nan;0;0
50528;457;32;78;27;1;26;.963;3600000;0
50528;1269;56;0;0;0;0;.00nan;0;0
50528;2746;32;0;0;0;0;.00nan;0;0
50528;5820;56;88;39;2;37;.949;3560000;0
50530;889;62;85;36;2;34;.944;3600000;0
50530;1835;33;0;0;0;0;.00nan;0;0
50530;3066;62;0;0;0;0;.00nan;0;0
50530;5668;33;76;40;3;37;.925;3560000;0
50532;294;125;0;0;0;0;.00nan;0;0
50532;665;125;76;34;3;31;.912;3600000;0
50532;1831;57;74;25;2;23;.920;3600000;0
50532;3756;57;0;0;0;0;.00nan;0;0
50493;124;123;0;0;0;0;.00nan;0;0
50493;1547;48;65;48;5;43;.896;3900000;0
50493;1959;48;0;0;0;0;.00nan;0;0
50493;6493;123;57;29;5;24;.828;3900000;0
51384;1044;43;0;0;0;0;.00nan;0;0
51384;2921;60;71;33;3;30;.909;3600000;0
51384;3391;60;0;0;0;0;.00nan;0;0
51384;5949;43;69;40;4;36;.900;3600000;0
51371;457;32;0;0;0;0;.00nan;0;0
51371;1264;58;0;0;0;0;.00nan;0;0
51371;2746;32;88;28;1;27;.964;3600000;0
51371;5948;58;67;27;2;25;.926;3550000;0
50508;8;44;30;15;4;11;.733;1375000;0
50508;2075;54;59;27;3;24;.889;3600000;0
50508;2653;44;28;34;7;27;.794;2225000;0
50508;2689;54;0;0;0;0;.00nan;0;0
51263;526;59;0;0;0;0;.00nan;0;0
51263;892;59;62;30;4;26;.867;3600000;0
51263;1633;38;0;0;0;0;.00nan;0;0
51263;6571;38;100;31;0;31;1.000;3600000;0
50479;1919;34;0;0;0;0;.00nan;0;0
50479;2021;34;56;27;4;23;.852;3570000;0
50479;2921;60;0;0;0;0;.00nan;0;0
50479;3391;60;61;26;3;23;.885;3600000;0
50613;1507;41;0;0;0;0;.00nan;0;0
50613;1926;47;0;0;0;0;.00nan;0;0
50613;2116;41;47;28;5;23;.821;3578000;0
50613;5740;47;70;34;3;31;.912;3600000;0
51368;1269;56;0;0;0;0;.00nan;0;0
51368;1547;48;0;0;0;0;.00nan;0;0
51368;1959;48;91;49;4;45;.918;3543000;0
51368;5820;56;67;27;3;24;.889;3600000;0
50490;551;50;60;30;3;27;.900;3560000;0
50490;737;50;0;0;0;0;.00nan;0;0
50490;1044;43;0;0;0;0;.00nan;0;0
50490;5949;43;72;32;2;30;.938;3600000;0
50556;8;44;0;0;0;0;.00nan;0;0
50556;1507;41;56;29;3;26;.897;3544000;0
50556;2116;41;0;0;0;0;.00nan;0;0
50556;2653;44;85;32;1;31;.969;3600000;0
50482;294;125;0;0;0;0;.00nan;0;0
50482;665;125;65;41;5;36;.878;3600000;0
50482;704;36;0;0;0;0;.00nan;0;0
50482;1893;36;33;28;6;22;.786;3576000;0
50494;977;40;0;0;0;0;.00nan;0;0
50494;2921;60;0;0;0;0;.00nan;0;0
50494;3391;60;92;35;2;33;.943;3600000;0
50494;5923;40;89;50;5;45;.900;3600000;0
50512;958;53;0;0;0;0;.00nan;0;0
50512;1633;38;0;0;0;0;.00nan;0;0
50512;2123;53;49;32;5;27;.844;3566000;0
50512;6571;38;52;23;3;20;.870;3600000;0
50472;1044;43;90;47;3;44;.936;3558000;0
50472;3101;37;0;0;0;0;.00nan;0;0
50472;3395;37;91;30;1;29;.967;3600000;0
50472;5949;43;0;0;0;0;.00nan;0;0
50637;1269;56;40;23;4;19;.826;3525000;0
50637;2075;54;78;33;2;31;.939;3600000;0
50637;2689;54;0;0;0;0;.00nan;0;0
50637;5820;56;0;0;0;0;.00nan;0;0
50936;457;32;88;38;2;36;.947;3600000;0
50936;1771;45;0;0;0;0;.00nan;0;0
50936;2115;45;83;24;1;23;.958;3600000;0
50936;2746;32;0;0;0;0;.00nan;0;0
50635;889;62;0;0;0;0;.00nan;0;0
50635;1919;34;0;0;0;0;.00nan;0;0
50635;2021;34;57;39;5;34;.872;3600000;0
50635;3066;62;49;26;4;22;.846;3600000;0
50504;1547;48;0;0;0;0;.00nan;0;0
50504;1926;47;50;41;6;35;.854;3551000;0
50504;1959;48;61;33;4;29;.879;3600000;0
50504;5740;47;0;0;0;0;.00nan;0;0
50521;1771;45;82;31;2;29;.935;3600000;0
50521;2115;45;0;0;0;0;.00nan;0;0
50521;3101;37;39;26;5;21;.808;3600000;0
50521;3395;37;0;0;0;0;.00nan;0;0
50496;958;53;35;19;4;15;.789;3600000;0
50496;1633;38;78;29;2;27;.931;3600000;0
50496;2123;53;0;0;0;0;.00nan;0;0
50496;6571;38;0;0;0;0;.00nan;0;0
50498;526;59;0;0;0;0;.00nan;0;0
50498;551;50;0;0;0;0;.00nan;0;0
50498;737;50;56;23;3;20;.870;3600000;0
50498;892;59;42;26;5;21;.808;3591000;0
50503;704;36;33;30;6;24;.800;3515000;0
50503;1507;41;0;0;0;0;.00nan;0;0
50503;1893;36;0;0;0;0;.00nan;0;0
50503;2116;41;60;33;4;29;.879;3600000;0
50554;1531;153;0;0;0;0;.00nan;0;0
50554;1835;33;66;19;2;17;.895;3900000;0
50554;1852;153;87;43;2;41;.953;3900000;0
50554;5668;33;0;0;0;0;.00nan;0;0
50510;124;123;51;33;5;28;.848;3600000;0
50510;294;125;0;0;0;0;.00nan;0;0
50510;665;125;67;29;2;27;.931;3600000;0
50510;6493;123;0;0;0;0;.00nan;0;0
50568;889;62;55;4;0;4;1.000;242000;0
50568;930;55;71;36;3;33;.917;3600000;0
50568;3066;62;24;26;6;20;.769;3358000;0
50568;3319;55;0;0;0;0;.00nan;0;0
50545;1831;57;0;0;0;0;.00nan;0;0
50545;1926;47;76;45;4;41;.911;3600000;0
50545;3756;57;80;23;1;22;.957;3600000;0
50545;5740;47;0;0;0;0;.00nan;0;0
50515;124;123;0;0;0;0;.00nan;0;0
50515;977;40;0;0;0;0;.00nan;0;0
50515;5923;40;92;29;1;28;.966;3600000;0
50515;6493;123;56;23;3;20;.870;3556000;0
50851;457;32;91;37;3;34;.919;3544000;0
50851;2075;54;83;29;2;27;.931;3600000;0
50851;2689;54;0;0;0;0;.00nan;0;0
50851;2746;32;0;0;0;0;.00nan;0;0
50487;8;44;100;32;0;32;1.000;3600000;0
50487;958;53;0;0;0;0;.00nan;0;0
50487;2123;53;76;37;3;34;.919;3600000;0
50487;2653;44;0;0;0;0;.00nan;0;0
50523;1264;58;99;41;2;39;.951;3900000;0
50523;3101;37;0;0;0;0;.00nan;0;0
50523;3395;37;83;34;2;32;.941;3900000;0
50523;5948;58;0;0;0;0;.00nan;0;0
50533;1044;43;88;31;1;30;.968;3547000;0
50533;1831;57;92;21;0;21;1.000;3600000;0
50533;3756;57;0;0;0;0;.00nan;0;0
50533;5949;43;0;0;0;0;.00nan;0;0
50519;930;55;93;38;1;37;.974;3600000;0
50519;1633;38;0;0;0;0;.00nan;0;0
50519;3319;55;0;0;0;0;.00nan;0;0
50519;6571;38;63;25;2;23;.920;3570000;0
50593;551;50;0;0;0;0;.00nan;0;0
50593;737;50;91;23;1;22;.957;3600000;0
50593;1531;153;0;0;0;0;.00nan;0;0
50593;1852;153;69;34;4;30;.882;3600000;0
50506;1547;48;0;0;0;0;.00nan;0;0
50506;1959;48;100;28;1;27;.964;3900000;0
50506;2921;60;0;0;0;0;.00nan;0;0
50506;3391;60;74;24;1;23;.958;3900000;0
50509;704;36;0;0;0;0;.00nan;0;0
50509;1269;56;0;0;0;0;.00nan;0;0
50509;1893;36;85;42;3;39;.929;3799000;0
50509;5820;56;58;27;4;23;.852;3799000;0
50544;526;59;0;0;0;0;.00nan;0;0
50544;892;59;66;22;2;20;.909;3600000;0
50544;1919;34;56;40;5;35;.875;3600000;0
50544;2021;34;0;0;0;0;.00nan;0;0
50567;1835;33;0;0;0;0;.00nan;0;0
50567;2075;54;0;0;0;0;.00nan;0;0
50567;2689;54;67;41;5;36;.878;3600000;0
50567;5668;33;67;24;2;22;.917;3600000;0
51330;124;123;0;0;0;0;.00nan;0;0
51330;1633;38;58;29;3;26;.897;3600000;0
51330;6493;123;93;25;0;25;1.000;3600000;0
51330;6571;38;0;0;0;0;.00nan;0;0
50534;1269;56;52;32;4;28;.875;3579000;0
50534;1926;47;0;0;0;0;.00nan;0;0
50534;5740;47;73;33;3;30;.909;3600000;0
50534;5820;56;0;0;0;0;.00nan;0;0
50540;1507;41;71;22;2;20;.909;3543000;0
50540;1547;48;81;28;1;27;.964;3600000;0
50540;1959;48;0;0;0;0;.00nan;0;0
50540;2116;41;0;0;0;0;.00nan;0;0
50561;1264;58;61;7;0;7;1.000;890000;0
50561;1771;45;0;0;0;0;.00nan;0;0
50561;2115;45;43;23;4;19;.826;3600000;0
50561;5948;58;47;43;7;36;.837;2710000;0
50531;8;44;77;32;2;30;.938;3600000;0
50531;1044;43;55;3;0;3;1.000;320000;0
50531;2653;44;0;0;0;0;.00nan;0;0
50531;5949;43;47;38;7;31;.816;3280000;0
51343;1835;33;31;28;6;22;.786;3515000;0
51343;1919;34;0;0;0;0;.00nan;0;0
51343;2021;34;75;43;4;39;.907;3600000;0
51343;5668;33;0;0;0;0;.00nan;0;0
50517;124;123;0;0;0;0;.00nan;0;0
50517;2921;60;30;41;7;34;.829;3600000;0
50517;3391;60;0;0;0;0;.00nan;0;0
50517;6493;123;81;43;3;40;.930;3600000;0
50604;551;50;0;0;0;0;.00nan;0;0
50604;737;50;53;28;4;24;.857;3900000;0
50604;977;40;0;0;0;0;.00nan;0;0
50604;5923;40;64;32;4;28;.875;3900000;0
51388;704;36;0;0;0;0;.00nan;0;0
51388;1893;36;64;43;5;38;.884;3579000;0
51388;1926;47;64;28;3;25;.893;3600000;0
51388;5740;47;0;0;0;0;.00nan;0;0
50887;457;32;65;19;1;18;.947;3600000;0
50887;1531;153;0;0;0;0;.00nan;0;0
50887;1852;153;62;35;3;32;.914;3520000;0
50887;2746;32;0;0;0;0;.00nan;0;0
50538;294;125;0;0;0;0;.00nan;0;0
50538;665;125;25;29;6;23;.793;3561000;0
50538;889;62;0;0;0;0;.00nan;0;0
50538;3066;62;58;28;4;24;.857;3600000;0
50550;526;59;97;34;2;32;.941;3600000;0
50550;892;59;0;0;0;0;.00nan;0;0
50550;2075;54;72;38;3;35;.921;3571000;0
50550;2689;54;0;0;0;0;.00nan;0;0
51344;930;55;90;40;2;38;.950;3600000;0
51344;1507;41;0;0;0;0;.00nan;0;0
51344;2116;41;68;33;3;30;.909;3582000;0
51344;3319;55;0;0;0;0;.00nan;0;0
50729;889;62;79;22;1;21;.955;3600000;0
50729;930;55;59;37;5;32;.865;3600000;0
50729;3066;62;0;0;0;0;.00nan;0;0
50729;3319;55;0;0;0;0;.00nan;0;0
51380;1269;56;0;0;0;0;.00nan;0;0
51380;1531;153;95;31;1;30;.968;3600000;0
51380;1852;153;0;0;0;0;.00nan;0;0
51380;5820;56;29;30;6;24;.800;3600000;0
50608;1835;33;0;0;0;0;.00nan;0;0
50608;1919;34;0;0;0;0;.00nan;0;0
50608;2021;34;56;33;4;29;.879;3528000;0
50608;5668;33;82;36;2;34;.944;3600000;0
50585;1264;58;88;29;2;27;.931;3900000;0
50585;1831;57;73;33;2;31;.939;3900000;0
50585;3756;57;0;0;0;0;.00nan;0;0
50585;5948;58;0;0;0;0;.00nan;0;0
50520;526;59;0;0;0;0;.00nan;0;0
50520;892;59;61;34;4;30;.882;3558000;0
50520;2921;60;73;28;3;25;.893;3600000;0
50520;3391;60;0;0;0;0;.00nan;0;0
50553;1547;48;0;0;0;0;.00nan;0;0
50553;1919;34;34;31;6;25;.806;3574000;0
50553;1959;48;65;34;5;29;.853;3600000;0
50553;2021;34;0;0;0;0;.00nan;0;0
50539;124;123;0;0;0;0;.00nan;0;0
50539;1771;45;0;0;0;0;.00nan;0;0
50539;2115;45;57;20;2;18;.900;3600000;0
50539;6493;123;71;39;4;35;.897;3588000;0
51375;1264;58;0;0;0;0;.00nan;0;0
51375;1926;47;52;39;6;33;.846;3694000;0
51375;5740;47;0;0;0;0;.00nan;0;0
51375;5948;58;51;35;5;30;.857;3694000;0
50625;1507;41;62;33;4;29;.879;3600000;0
50625;1633;38;0;0;0;0;.00nan;0;0
50625;2116;41;0;0;0;0;.00nan;0;0
50625;6571;38;100;22;0;22;1.000;3600000;0
50548;457;32;85;41;4;37;.902;3900000;0
50548;1044;43;81;45;4;41;.911;3900000;0
50548;2746;32;0;0;0;0;.00nan;0;0
50548;5949;43;0;0;0;0;.00nan;0;0
50513;294;50;0;0;0;0;.00nan;0;0
50513;551;50;69;26;2;24;.923;3550000;0
50513;958;53;0;0;0;0;.00nan;0;0
50513;2123;53;92;34;1;33;.971;3600000;0
50754;1531;153;0;0;0;0;.00nan;0;0
50754;1633;38;0;0;0;0;.00nan;0;0
50754;1852;153;88;36;2;34;.944;3552000;0
50754;6571;38;73;20;1;19;.950;3600000;0
50602;1269;56;0;0;0;0;.00nan;0;0
50602;1926;47;89;44;3;41;.932;3055000;0
50602;5740;47;27;6;3;3;.500;545000;0
50602;5820;56;100;27;0;27;1.000;3600000;0
50526;8;44;47;40;6;34;.850;3600000;0
50526;2653;44;0;0;0;0;.00nan;0;0
50526;2921;60;68;41;4;37;.902;3061000;0
50526;3391;60;25;5;3;2;.400;506000;0
50541;930;55;80;27;1;26;.963;3600000;0
50541;3101;37;0;0;0;0;.00nan;0;0
50541;3319;55;0;0;0;0;.00nan;0;0
50541;3395;37;90;39;2;37;.949;3590000;0
50573;665;125;26;35;7;28;.800;3353000;0
50573;1153;125;50;1;0;1;1.000;247000;0
50573;1831;57;0;0;0;0;.00nan;0;0
50573;3756;57;70;26;2;24;.923;3600000;0
50546;704;36;0;0;0;0;.00nan;0;0
50546;1771;45;76;33;2;31;.939;3600000;0
50546;1893;36;90;37;3;34;.919;3600000;0
50546;2115;45;0;0;0;0;.00nan;0;0
50577;1835;33;39;32;6;26;.813;2438000;0
50577;2075;54;0;0;0;0;.00nan;0;0
50577;2689;54;79;33;2;31;.939;3600000;0
50577;5668;33;49;17;3;14;.824;1162000;0
50651;1531;153;0;0;0;0;.00nan;0;0
50651;1852;153;55;26;3;23;.885;3900000;0
50651;2075;54;81;32;3;29;.906;3900000;0
50651;2689;54;0;0;0;0;.00nan;0;0
50551;977;40;0;0;0;0;.00nan;0;0
50551;1044;43;63;44;5;39;.886;3900000;0
50551;5923;40;67;42;5;37;.881;3900000;0
50551;5949;43;0;0;0;0;.00nan;0;0
50514;889;62;0;0;0;0;.00nan;0;0
50514;958;53;36;34;6;28;.824;3600000;0
50514;2123;53;0;0;0;0;.00nan;0;0
50514;3066;62;83;27;1;26;.963;3600000;0
50566;8;44;0;0;0;0;.00nan;0;0
50566;1264;58;75;35;4;31;.886;3578000;0
50566;2653;44;91;46;3;43;.935;3600000;0
50566;5948;58;0;0;0;0;.00nan;0;0
50527;124;123;0;0;0;0;.00nan;0;0
50527;1547;48;0;0;0;0;.00nan;0;0
50527;1959;48;70;36;3;33;.917;3900000;0
50527;6493;123;82;38;3;35;.921;3900000;0
50547;889;62;84;38;2;36;.947;3600000;0
50547;3066;62;0;0;0;0;.00nan;0;0
50547;3101;37;0;0;0;0;.00nan;0;0
50547;3395;37;76;39;4;35;.897;3537000;0
50677;1507;41;0;0;0;0;.00nan;0;0
50677;1926;47;100;36;1;35;.972;3600000;0
50677;2116;41;98;50;2;48;.960;3568000;0
50677;5740;47;0;0;0;0;.00nan;0;0
50587;665;125;46;34;6;28;.824;3579000;0
50587;704;36;0;0;0;0;.00nan;0;0
50587;1153;125;0;0;0;0;.00nan;0;0
50587;1893;36;66;45;5;40;.889;3600000;0
50536;457;32;0;0;0;0;.00nan;0;0
50536;2746;32;100;35;2;33;.943;3600000;0
50536;2921;60;42;24;4;20;.833;3536000;0
50536;3391;60;0;0;0;0;.00nan;0;0
50575;1771;45;0;0;0;0;.00nan;0;0
50575;1831;57;0;0;0;0;.00nan;0;0
50575;2115;45;54;23;3;20;.870;3600000;0
50575;3756;57;56;34;4;30;.882;3600000;0
51349;1507;41;81;31;2;29;.935;3559000;0
51349;2075;54;84;28;1;27;.964;3600000;0
51349;2116;41;0;0;0;0;.00nan;0;0
51349;2689;54;0;0;0;0;.00nan;0;0
50652;930;55;66;19;2;17;.895;3600000;0
50652;1926;47;0;0;0;0;.00nan;0;0
50652;3319;55;0;0;0;0;.00nan;0;0
50652;5740;47;98;49;3;46;.939;3595000;0
50535;294;50;78;32;2;30;.938;3600000;0
50535;551;50;0;0;0;0;.00nan;0;0
50535;1044;43;68;48;5;43;.896;3600000;0
50535;5949;43;0;0;0;0;.00nan;0;0
50576;8;44;71;15;1;14;.933;3600000;0
50576;977;40;0;0;0;0;.00nan;0;0
50576;2653;44;0;0;0;0;.00nan;0;0
50576;5923;40;89;38;2;36;.947;3600000;0
50571;526;59;47;29;4;25;.862;3600000;0
50571;892;59;0;0;0;0;.00nan;0;0
50571;1547;48;0;0;0;0;.00nan;0;0
50571;1959;48;68;20;1;19;.950;3600000;0
50583;704;36;69;35;3;32;.914;3600000;0
50583;1831;57;0;0;0;0;.00nan;0;0
50583;1893;36;0;0;0;0;.00nan;0;0
50583;3756;57;38;22;4;18;.818;3574000;0
50537;958;53;100;40;0;40;1.000;3745000;0
50537;1264;58;72;18;1;17;.944;3745000;0
50537;2123;53;0;0;0;0;.00nan;0;0
50537;5948;58;0;0;0;0;.00nan;0;0
50692;1633;38;0;0;0;0;.00nan;0;0
50692;1919;34;0;0;0;0;.00nan;0;0
50692;2021;34;38;25;4;21;.840;3581000;0
50692;6571;38;76;29;2;27;.931;3600000;0
50596;457;32;68;28;3;25;.893;3600000;0
50596;665;125;69;11;0;11;1.000;1588000;0
50596;1153;125;48;28;4;24;.857;2012000;0
50596;2746;32;0;0;0;0;.00nan;0;0
50589;1269;56;0;0;0;0;.00nan;0;0
50589;1835;33;72;19;1;18;.947;3600000;0
50589;5668;33;0;0;0;0;.00nan;0;0
50589;5820;56;50;24;4;20;.833;3600000;0
50644;930;55;0;0;0;0;.00nan;0;0
50644;1269;56;57;25;3;22;.880;3568000;0
50644;3319;55;79;37;2;35;.946;3600000;0
50644;5820;56;0;0;0;0;.00nan;0;0
50664;1531;153;0;0;0;0;.00nan;0;0
50664;1852;153;73;38;3;35;.921;3900000;0
50664;2075;54;0;0;0;0;.00nan;0;0
50664;2689;54;64;31;3;28;.903;3899000;0
50594;1264;58;73;32;3;29;.906;3573000;0
50594;3101;37;0;0;0;0;.00nan;0;0
50594;3395;37;98;29;1;28;.966;3600000;0
50594;5948;58;0;0;0;0;.00nan;0;0
50542;124;123;42;35;5;30;.857;3596000;0
50542;294;50;0;0;0;0;.00nan;0;0
50542;551;50;57;20;3;17;.850;3600000;0
50542;6493;123;0;0;0;0;.00nan;0;0
50581;977;40;62;33;4;29;.879;3569000;0
50581;1835;33;0;0;0;0;.00nan;0;0
50581;5668;33;61;25;3;22;.880;3600000;0
50581;5923;40;0;0;0;0;.00nan;0;0
50560;526;59;0;0;0;0;.00nan;0;0
50560;889;62;0;0;0;0;.00nan;0;0
50560;892;59;63;28;3;25;.893;3553000;0
50560;3066;62;81;34;2;32;.941;3600000;0
51369;1507;41;58;6;0;6;1.000;348000;0
51369;1633;38;0;0;0;0;.00nan;0;0
51369;2116;41;42;41;7;34;.829;3252000;0
51369;6571;38;63;30;3;27;.900;3600000;0
50621;1771;45;0;0;0;0;.00nan;0;0
50621;1919;34;31;18;5;13;.722;2155000;0
50621;2021;34;50;9;1;8;.889;1445000;0
50621;2115;45;87;38;2;36;.947;3600000;0
50882;665;125;68;32;3;29;.906;3523000;0
50882;1153;125;0;0;0;0;.00nan;0;0
50882;2075;54;100;39;1;38;.974;3600000;0
50882;2689;54;0;0;0;0;.00nan;0;0
50580;8;44;58;26;3;23;.885;3600000;0
50580;1831;57;64;42;5;37;.881;3518000;0
50580;2653;44;0;0;0;0;.00nan;0;0
50580;5889;57;0;0;0;0;.00nan;0;0
50558;124;123;0;0;0;0;.00nan;0;0
50558;958;53;78;42;3;39;.929;3900000;0
50558;2123;53;0;0;0;0;.00nan;0;0
50558;6493;123;91;32;3;29;.906;3900000;0
50656;1919;34;0;0;0;0;.00nan;0;0
50656;2021;34;82;42;3;39;.929;3600000;0
50656;3101;37;0;0;0;0;.00nan;0;0
50656;3395;37;51;34;5;29;.853;3520000;0
51372;526;59;0;0;0;0;.00nan;0;0
51372;892;59;63;14;1;13;.929;3600000;0
51372;1507;41;74;39;3;36;.923;3580000;0
51372;2116;41;0;0;0;0;.00nan;0;0
50601;889;62;0;0;0;0;.00nan;0;0
50601;1547;48;0;0;0;0;.00nan;0;0
50601;1959;48;98;52;3;49;.942;3588000;0
50601;3066;62;71;20;1;19;.950;3600000;0
50620;294;50;61;21;2;19;.905;3600000;0
50620;551;50;0;0;0;0;.00nan;0;0
50620;977;40;0;0;0;0;.00nan;0;0
50620;5923;40;71;47;5;42;.894;3600000;0
50609;704;36;48;13;2;11;.846;1216000;0
50609;1264;58;76;28;2;26;.929;3600000;0
50609;1893;36;34;31;6;25;.806;2384000;0
50609;5948;58;0;0;0;0;.00nan;0;0
50615;1269;56;0;0;0;0;.00nan;0;0
50615;1835;33;20;26;6;20;.769;3600000;0
50615;5668;33;0;0;0;0;.00nan;0;0
50615;5820;56;89;29;1;28;.966;3600000;0
50552;1633;38;65;29;3;26;.897;3900000;0
50552;2921;60;0;0;0;0;.00nan;0;0
50552;3391;60;74;32;3;29;.906;3900000;0
50552;6571;38;0;0;0;0;.00nan;0;0
50570;124;123;62;34;4;30;.882;3600000;0
50570;1269;56;91;20;0;20;1.000;3600000;0
50570;5820;56;0;0;0;0;.00nan;0;0
50570;6493;123;0;0;0;0;.00nan;0;0
50555;8;44;45;31;5;26;.839;3600000;0
50555;1044;43;75;22;1;21;.955;3600000;0
50555;2653;44;0;0;0;0;.00nan;0;0
50555;5949;43;0;0;0;0;.00nan;0;0
50572;526;59;78;22;1;21;.955;3600000;0
50572;892;59;0;0;0;0;.00nan;0;0
50572;1771;45;73;54;6;48;.889;3600000;0
50572;2115;45;0;0;0;0;.00nan;0;0
50592;1835;33;0;0;0;0;.00nan;0;0
50592;3101;37;60;43;5;38;.884;3600000;0
50592;3395;37;0;0;0;0;.00nan;0;0
50592;5668;33;100;36;0;36;1.000;3600000;0
50666;665;125;0;0;0;0;.00nan;0;0
50666;930;55;57;16;2;14;.875;3600000;0
50666;1153;125;56;25;3;22;.880;3551000;0
50666;3319;55;0;0;0;0;.00nan;0;0
50605;294;50;0;0;0;0;.00nan;0;0
50605;551;50;36;19;4;15;.789;3600000;0
50605;1547;48;78;30;3;27;.900;3600000;0
50605;1959;48;0;0;0;0;.00nan;0;0
50598;704;36;65;29;3;26;.897;3513000;0
50598;1264;58;0;0;0;0;.00nan;0;0
50598;1893;36;0;0;0;0;.00nan;0;0
50598;5948;58;100;38;1;37;.974;3600000;0
50563;977;40;71;42;5;37;.881;3900000;0
50563;1044;43;0;0;0;0;.00nan;0;0
50563;5923;40;0;0;0;0;.00nan;0;0
50563;5949;43;51;37;5;32;.865;3892000;0
50579;1771;45;0;0;0;0;.00nan;0;0
50579;1926;47;71;34;3;31;.912;3600000;0
50579;2115;45;89;20;0;20;1.000;3600000;0
50579;5740;47;0;0;0;0;.00nan;0;0
50599;889;62;0;0;0;0;.00nan;0;0
50599;3066;62;51;20;3;17;.850;3550000;0
50599;3101;37;0;0;0;0;.00nan;0;0
50599;3395;37;100;40;2;38;.950;3600000;0
50699;457;32;100;32;0;32;1.000;3600000;0
50699;1919;34;49;22;3;19;.864;3600000;0
50699;2021;34;0;0;0;0;.00nan;0;0
50699;2746;32;0;0;0;0;.00nan;0;0
50595;526;59;0;0;0;0;.00nan;0;0
50595;892;59;58;25;3;22;.880;3600000;0
50595;1531;153;0;0;0;0;.00nan;0;0
50595;1852;153;100;30;0;30;1.000;3600000;0
50564;124;123;49;1;0;1;1.000;283000;0
50564;2921;60;0;0;0;0;.00nan;0;0
50564;3391;60;53;29;4;25;.862;3600000;0
50564;6493;123;11;38;10;28;.737;3317000;0
50629;977;40;0;0;0;0;.00nan;0;0
50629;2075;54;91;28;1;27;.964;3600000;0
50629;2689;54;0;0;0;0;.00nan;0;0
50629;5923;40;96;34;2;32;.941;3569000;0
50611;704;36;73;38;3;35;.921;3640000;0
50611;1633;38;0;0;0;0;.00nan;0;0
50611;1893;36;0;0;0;0;.00nan;0;0
50611;6571;38;70;34;4;30;.882;3640000;0
51103;665;125;30;16;4;12;.750;978000;0
51103;1153;125;65;25;3;22;.880;2622000;0
51103;1507;41;100;21;0;21;1.000;3600000;0
51103;2116;41;0;0;0;0;.00nan;0;0
50562;8;44;61;34;4;30;.882;3600000;0
50562;958;53;35;32;6;26;.813;3289000;0
50562;2123;53;43;3;1;2;.667;311000;0
50562;2653;44;0;0;0;0;.00nan;0;0
50736;1531;153;0;0;0;0;.00nan;0;0
50736;1852;153;88;29;1;28;.966;3600000;0
50736;1926;47;79;35;3;32;.914;3514000;0
50736;5740;47;0;0;0;0;.00nan;0;0
50565;958;53;0;0;0;0;.00nan;0;0
50565;1633;38;79;29;2;27;.931;3657000;0
50565;2123;53;76;30;3;27;.900;3657000;0
50565;6571;38;0;0;0;0;.00nan;0;0
50614;1044;43;98;54;4;50;.926;3600000;0
50614;1771;45;0;0;0;0;.00nan;0;0
50614;2115;45;91;29;1;28;.966;3600000;0
50614;5949;43;0;0;0;0;.00nan;0;0
50612;1547;48;0;0;0;0;.00nan;0;0
50612;1919;34;0;0;0;0;.00nan;0;0
50612;1959;48;80;32;3;29;.906;3600000;0
50612;2021;34;26;32;6;26;.813;3600000;0
50639;930;55;85;27;1;26;.963;3900000;0
50639;1835;33;0;0;0;0;.00nan;0;0
50639;3319;55;0;0;0;0;.00nan;0;0
50639;5668;33;100;38;1;37;.974;3884000;0
50578;1831;57;0;0;0;0;.00nan;0;0
50578;2921;60;58;48;7;41;.854;3600000;0
50578;3391;60;0;0;0;0;.00nan;0;0
50578;5889;57;75;35;4;31;.886;3600000;0
50591;294;50;93;16;0;16;1.000;3600000;0
50591;526;59;69;33;3;30;.909;3600000;0
50591;551;50;0;0;0;0;.00nan;0;0
50591;892;59;0;0;0;0;.00nan;0;0
51381;704;36;0;0;0;0;.00nan;0;0
51381;1264;58;57;29;4;25;.862;3522000;0
51381;1893;36;64;23;2;21;.913;3600000;0
51381;5948;58;0;0;0;0;.00nan;0;0
51379;1835;33;63;46;5;41;.891;3592000;0
51379;3101;37;0;0;0;0;.00nan;0;0
51379;3395;37;86;39;3;36;.923;3600000;0
51379;5668;33;0;0;0;0;.00nan;0;0
51291;665;125;75;33;3;30;.909;3600000;0
51291;1153;125;0;0;0;0;.00nan;0;0
51291;1547;48;100;31;0;31;1.000;3600000;0
51291;1959;48;0;0;0;0;.00nan;0;0
50603;1926;47;0;0;0;0;.00nan;0;0
50603;2746;32;26;6;3;3;.500;513000;0
50603;5740;47;100;51;2;49;.961;3600000;0
50603;5944;32;47;13;2;11;.846;3087000;0
50600;1264;58;66;32;4;28;.875;3600000;0
50600;1831;57;86;28;1;27;.964;3600000;0
50600;5889;57;0;0;0;0;.00nan;0;0
50600;5948;58;0;0;0;0;.00nan;0;0
50865;1507;41;45;25;4;21;.840;3562000;0
50865;2116;41;0;0;0;0;.00nan;0;0
50865;2746;32;66;32;3;29;.906;3600000;0
50865;5944;32;0;0;0;0;.00nan;0;0
50678;889;62;0;0;0;0;.00nan;0;0
50678;1269;56;80;42;3;39;.929;3573000;0
50678;3066;62;85;26;1;25;.962;3600000;0
50678;5820;56;0;0;0;0;.00nan;0;0
50768;930;55;66;32;4;28;.875;3600000;0
50768;1531;153;0;0;0;0;.00nan;0;0
50768;1852;153;42;28;5;23;.821;3600000;0
50768;3319;55;0;0;0;0;.00nan;0;0
50668;665;125;0;0;0;0;.00nan;0;0
50668;704;36;74;24;1;23;.958;3600000;0
50668;1153;125;62;31;3;28;.903;3533000;0
50668;1893;36;0;0;0;0;.00nan;0;0
50658;8;44;77;31;2;29;.935;3600000;0
50658;977;40;20;9;4;5;.556;724000;0
50658;2653;44;0;0;0;0;.00nan;0;0
50658;5923;40;68;26;2;24;.923;2876000;0
50617;1044;43;56;29;4;25;.862;3600000;0
50617;1547;48;76;46;5;41;.891;3593000;0
50617;1959;48;0;0;0;0;.00nan;0;0
50617;5949;43;0;0;0;0;.00nan;0;0
50590;124;123;0;0;0;0;.00nan;0;0
50590;526;59;0;0;0;0;.00nan;0;0
50590;892;59;89;16;0;16;1.000;3600000;0
50590;6493;123;69;54;6;48;.889;3600000;0
50720;889;62;0;0;0;0;.00nan;0;0
50720;3066;62;71;21;2;19;.905;3900000;0
50720;3101;37;0;0;0;0;.00nan;0;0
50720;3395;37;80;37;2;35;.946;3900000;0
50569;958;53;74;42;4;38;.905;3571000;0
50569;2123;53;0;0;0;0;.00nan;0;0
50569;2921;60;0;0;0;0;.00nan;0;0
50569;3391;60;79;33;2;31;.939;3600000;0
50636;665;125;93;24;0;24;1.000;3600000;0
50636;977;40;52;31;4;27;.871;3600000;0
50636;1153;125;0;0;0;0;.00nan;0;0
50636;5923;40;0;0;0;0;.00nan;0;0
50662;8;44;0;0;0;0;.00nan;0;0
50662;1919;34;59;24;3;21;.875;3600000;0
50662;2021;34;0;0;0;0;.00nan;0;0
50662;2653;44;43;32;6;26;.813;3600000;0
50679;930;55;59;34;4;30;.882;3600000;0
50679;1264;58;77;25;1;24;.960;3600000;0
50679;3319;55;0;0;0;0;.00nan;0;0
50679;5948;58;0;0;0;0;.00nan;0;0
50619;1831;57;37;19;4;15;.789;2300000;0
50619;1835;33;75;37;3;34;.919;3600000;0
50619;5668;33;0;0;0;0;.00nan;0;0
50619;5889;57;62;11;0;11;1.000;1254000;0
50584;124;123;51;35;5;30;.857;3515000;0
50584;1531;153;0;0;0;0;.00nan;0;0
50584;1852;153;82;34;3;31;.912;3600000;0
50584;6493;123;0;0;0;0;.00nan;0;0
50616;294;50;59;20;2;18;.900;3600000;0
50616;551;50;0;0;0;0;.00nan;0;0
50616;1547;48;0;0;0;0;.00nan;0;0
50616;1959;48;28;30;6;24;.800;3600000;0
50657;704;36;0;0;0;0;.00nan;0;0
50657;1771;45;0;0;0;0;.00nan;0;0
50657;1893;36;100;39;1;38;.974;3600000;0
50657;2115;45;62;22;2;20;.909;3577000;0
50634;294;50;0;0;0;0;.00nan;0;0
50634;551;50;72;41;4;37;.902;3531000;0
50634;1264;58;0;0;0;0;.00nan;0;0
50634;5948;58;78;28;2;26;.929;3600000;0
50606;526;59;0;0;0;0;.00nan;0;0
50606;892;59;73;25;2;23;.920;3600000;0
50606;1531;153;0;0;0;0;.00nan;0;0
50606;1852;153;56;33;4;29;.879;3600000;0
50719;1919;34;0;0;0;0;.00nan;0;0
50719;1926;47;63;37;4;33;.892;3600000;0
50719;2021;34;80;26;1;25;.962;3600000;0
50719;5740;47;0;0;0;0;.00nan;0;0
50655;1835;33;0;0;0;0;.00nan;0;0
50655;2746;32;0;0;0;0;.00nan;0;0
50655;5668;33;63;37;4;33;.892;3600000;0
50655;5944;32;34;23;5;18;.783;3559000;0
50624;1507;41;0;0;0;0;.00nan;0;0
50624;1831;57;55;1;0;1;1.000;399000;0
50624;2116;41;64;25;2;23;.920;3600000;0
50624;5889;57;36;33;6;27;.818;3201000;0
50745;1633;38;45;22;5;17;.773;3515000;0
50745;3101;37;0;0;0;0;.00nan;0;0
50745;3395;37;99;50;3;47;.940;3600000;0
50745;6571;38;0;0;0;0;.00nan;0;0
50588;124;123;0;0;0;0;.00nan;0;0
50588;977;40;76;44;4;40;.909;3600000;0
50588;5923;40;0;0;0;0;.00nan;0;0
50588;6493;123;62;21;2;19;.905;3600000;0
50549;958;53;0;0;0;0;.00nan;0;0
50549;1507;41;53;19;3;16;.842;3600000;0
50549;2116;41;0;0;0;0;.00nan;0;0
50549;2123;53;33;28;5;23;.821;3541000;0
50680;930;55;88;40;3;37;.925;3600000;0
50680;1269;56;40;5;2;3;.600;1062000;0
50680;3319;55;0;0;0;0;.00nan;0;0
50680;5820;56;25;25;6;19;.760;2538000;0
50627;1547;48;0;0;0;0;.00nan;0;0
50627;1926;47;0;0;0;0;.00nan;0;0
50627;1959;48;30;27;6;21;.778;3600000;0
50627;5740;47;75;40;3;37;.925;3600000;0
50631;1044;43;47;27;5;22;.815;2108000;0
50631;1771;45;0;0;0;0;.00nan;0;0
50631;2115;45;71;26;2;24;.923;3600000;0
50631;5949;43;35;13;3;10;.769;1492000;0
50618;8;44;66;43;4;39;.907;3900000;0
50618;526;59;52;27;4;23;.852;3900000;0
50618;892;59;0;0;0;0;.00nan;0;0
50618;2653;44;0;0;0;0;.00nan;0;0
50847;704;36;86;35;2;33;.943;3600000;0
50847;1893;36;0;0;0;0;.00nan;0;0
50847;2075;54;54;14;2;12;.857;2532000;0
50847;2689;54;23;12;4;8;.667;1068000;0
50646;2746;32;74;25;2;23;.920;3556000;0
50646;2921;60;0;0;0;0;.00nan;0;0
50646;3391;60;98;34;1;33;.971;3600000;0
50646;5944;32;0;0;0;0;.00nan;0;0
51395;1547;48;50;27;4;23;.852;3600000;0
51395;1633;38;0;0;0;0;.00nan;0;0
51395;1959;48;0;0;0;0;.00nan;0;0
51395;6571;38;59;43;6;37;.860;3577000;0
50623;665;125;37;22;5;17;.773;3600000;0
50623;1153;125;0;0;0;0;.00nan;0;0
50623;2921;60;59;56;8;48;.857;3600000;0
50623;3391;60;0;0;0;0;.00nan;0;0
50628;1831;57;54;29;4;25;.862;3581000;0
50628;2075;54;0;0;0;0;.00nan;0;0
50628;2689;54;75;28;2;26;.929;3600000;0
50628;5889;57;0;0;0;0;.00nan;0;0
50700;1269;56;73;23;1;22;.957;3600000;0
50700;1919;34;0;0;0;0;.00nan;0;0
50700;2021;34;53;27;3;24;.889;3578000;0
50700;5820;56;0;0;0;0;.00nan;0;0
50645;294;50;62;20;2;18;.900;3600000;0
50645;551;50;0;0;0;0;.00nan;0;0
50645;1835;33;34;33;6;27;.818;3600000;0
50645;5668;33;0;0;0;0;.00nan;0;0
50691;2746;32;0;0;0;0;.00nan;0;0
50691;3101;37;0;0;0;0;.00nan;0;0
50691;3395;37;30;38;8;30;.789;3600000;0
50691;5944;32;21;37;7;30;.811;3600000;0
50739;889;62;57;5;0;5;1.000;332000;0
50739;1771;45;0;0;0;0;.00nan;0;0
50739;2115;45;62;33;4;29;.879;3600000;0
50739;3066;62;37;36;7;29;.806;3268000;0
50632;1044;43;85;38;3;35;.921;3900000;0
50632;1507;41;0;0;0;0;.00nan;0;0
50632;2116;41;83;41;3;38;.927;3900000;0
50632;5949;43;0;0;0;0;.00nan;0;0
50582;930;55;73;26;2;24;.923;3600000;0
50582;958;53;0;0;0;0;.00nan;0;0
50582;2123;53;75;49;4;45;.918;3523000;0
50582;3319;55;0;0;0;0;.00nan;0;0
50867;124;123;77;33;2;31;.939;3544000;0
50867;1264;58;75;20;1;19;.950;3600000;0
50867;5948;58;0;0;0;0;.00nan;0;0
50867;6493;123;0;0;0;0;.00nan;0;0
50716;1531;153;0;0;0;0;.00nan;0;0
50716;1835;33;56;30;4;26;.867;3600000;0
50716;1852;153;53;35;5;30;.857;3550000;0
50716;5668;33;0;0;0;0;.00nan;0;0
50916;889;62;83;28;2;26;.929;3600000;0
50916;2075;54;0;0;0;0;.00nan;0;0
50916;2689;54;77;38;3;35;.921;3600000;0
50916;3066;62;0;0;0;0;.00nan;0;0
50725;1269;56;0;0;0;0;.00nan;0;0
50725;1926;47;48;33;5;28;.848;3534000;0
50725;5740;47;0;0;0;0;.00nan;0;0
50725;5820;56;54;24;3;21;.875;3600000;0
50665;977;40;85;54;6;48;.889;3900000;0
50665;2746;32;24;19;6;13;.684;3900000;0
50665;5923;40;0;0;0;0;.00nan;0;0
50665;5944;32;0;0;0;0;.00nan;0;0
50778;930;55;65;25;3;22;.880;3600000;0
50778;1926;47;0;0;0;0;.00nan;0;0
50778;3319;55;0;0;0;0;.00nan;0;0
50778;5740;47;70;50;5;45;.900;3571000;0
50663;1633;38;0;0;0;0;.00nan;0;0
50663;1835;33;33;17;4;13;.765;2434000;0
50663;5668;33;24;13;4;9;.692;1166000;0
50663;6571;38;93;37;2;35;.946;3600000;0
50647;294;50;62;16;2;14;.875;3869000;0
50647;551;50;0;0;0;0;.00nan;0;0
50647;3101;37;0;0;0;0;.00nan;0;0
50647;3395;37;87;33;1;32;.970;3869000;0
50672;8;44;92;43;2;41;.953;3600000;0
50672;1264;58;61;26;3;23;.885;3600000;0
50672;2653;44;0;0;0;0;.00nan;0;0
50672;5948;58;0;0;0;0;.00nan;0;0
50597;958;53;55;4;0;4;1.000;310000;0
50597;1507;41;74;35;4;31;.886;3600000;0
50597;2116;41;0;0;0;0;.00nan;0;0
50597;2123;53;47;34;6;28;.824;3290000;0
51377;124;123;59;35;4;31;.886;3578000;0
51377;1831;57;74;25;2;23;.920;3600000;0
51377;5889;57;0;0;0;0;.00nan;0;0
51377;6493;123;0;0;0;0;.00nan;0;0
50648;704;36;73;41;4;37;.902;3600000;0
50648;1893;36;0;0;0;0;.00nan;0;0
50648;2921;60;0;0;0;0;.00nan;0;0
50648;3391;60;100;33;1;32;.970;3600000;0
50730;1269;56;0;0;0;0;.00nan;0;0
50730;1771;45;0;0;0;0;.00nan;0;0
50730;2115;45;56;36;5;31;.861;3574000;0
50730;5820;56;61;23;3;20;.870;3600000;0
50640;1044;43;40;28;5;23;.821;3542000;0
50640;1264;58;0;0;0;0;.00nan;0;0
50640;5948;58;63;31;3;28;.903;3600000;0
50640;5949;43;0;0;0;0;.00nan;0;0
50607;124;123;0;0;0;0;.00nan;0;0
50607;958;53;92;41;2;39;.951;3560000;0
50607;2123;53;0;0;0;0;.00nan;0;0
50607;6493;123;86;28;1;27;.964;3600000;0
50766;1507;41;0;0;0;0;.00nan;0;0
50766;2116;41;51;24;3;21;.875;3600000;0
50766;3101;37;31;29;6;23;.793;2830000;0
50766;3395;37;55;5;0;5;1.000;770000;0
50626;526;59;0;0;0;0;.00nan;0;0
50626;892;59;69;26;3;23;.885;3522000;0
50626;2746;32;0;0;0;0;.00nan;0;0
50626;5944;32;92;30;1;29;.967;3600000;0
50698;889;62;0;0;0;0;.00nan;0;0
50698;1831;57;0;0;0;0;.00nan;0;0
50698;3066;62;80;27;2;25;.926;3682000;0
50698;5889;57;79;33;3;30;.909;3682000;0
50927;930;55;0;0;0;0;.00nan;0;0
50927;2075;54;52;27;4;23;.852;3900000;0
50927;2689;54;0;0;0;0;.00nan;0;0
50927;3319;55;64;40;4;36;.900;3900000;0
50633;1547;48;0;0;0;0;.00nan;0;0
50633;1919;34;0;0;0;0;.00nan;0;0
50633;1959;48;63;26;3;23;.885;3900000;0
50633;2021;34;92;41;3;38;.927;3900000;0
50649;526;59;71;35;3;32;.914;3900000;0
50649;892;59;0;0;0;0;.00nan;0;0
50649;1044;43;48;25;3;22;.880;3900000;0
50649;5949;43;0;0;0;0;.00nan;0;0
50654;294;50;0;0;0;0;.00nan;0;0
50654;551;50;96;37;1;36;.973;3600000;0
50654;1919;34;72;30;2;28;.933;3600000;0
50654;2021;34;0;0;0;0;.00nan;0;0
50638;704;36;93;33;1;32;.970;3600000;0
50638;1547;48;67;29;3;26;.897;3526000;0
50638;1893;36;0;0;0;0;.00nan;0;0
50638;1959;48;0;0;0;0;.00nan;0;0
50610;958;53;0;0;0;0;.00nan;0;0
50610;977;40;85;27;1;26;.963;3600000;0
50610;2123;53;97;45;2;43;.956;3558000;0
50610;5923;40;0;0;0;0;.00nan;0;0
50791;1507;41;0;0;0;0;.00nan;0;0
50791;1531;153;0;0;0;0;.00nan;0;0
50791;1852;153;55;23;3;20;.870;3900000;0
50791;2116;41;88;39;3;36;.923;3900000;0
50674;1633;38;0;0;0;0;.00nan;0;0
50674;2921;60;0;0;0;0;.00nan;0;0
50674;3391;60;81;39;3;36;.923;3600000;0
50674;6571;38;81;24;1;23;.958;3600000;0
50718;8;44;80;28;3;25;.893;3600000;0
50718;1771;45;0;0;0;0;.00nan;0;0
50718;2115;45;58;36;5;31;.861;3544000;0
50718;2653;44;0;0;0;0;.00nan;0;0
50693;665;125;65;40;4;36;.900;3577000;0
50693;1153;125;0;0;0;0;.00nan;0;0
50693;1264;58;88;34;2;32;.941;3600000;0
50693;5948;58;0;0;0;0;.00nan;0;0
50709;889;62;0;0;0;0;.00nan;0;0
50709;930;55;86;36;2;34;.944;3795000;0
50709;3066;62;63;26;3;23;.885;3795000;0
50709;3319;55;0;0;0;0;.00nan;0;0
50661;1269;56;0;0;0;0;.00nan;0;0
50661;1835;33;45;41;6;35;.854;2670000;0
50661;5668;33;53;13;1;12;.923;930000;0
50661;5820;56;82;26;1;25;.962;3600000;0
50630;124;123;86;28;1;27;.964;3600000;0
50630;3101;37;0;0;0;0;.00nan;0;0
50630;3395;37;73;40;4;36;.900;3600000;0
50630;6493;123;0;0;0;0;.00nan;0;0
50676;294;50;74;32;2;30;.938;3679000;0
50676;551;50;0;0;0;0;.00nan;0;0
50676;665;125;0;0;0;0;.00nan;0;0
50676;1153;125;65;30;3;27;.900;3679000;0
50728;889;62;78;25;1;24;.960;3600000;0
50728;2746;32;0;0;0;0;.00nan;0;0
50728;3066;62;0;0;0;0;.00nan;0;0
50728;5944;32;45;34;6;28;.824;3600000;0
50643;526;59;0;0;0;0;.00nan;0;0
50643;892;59;88;38;3;35;.921;3600000;0
50643;1831;57;65;32;4;28;.875;3594000;0
50643;5889;57;0;0;0;0;.00nan;0;0
50689;977;40;0;0;0;0;.00nan;0;0
50689;2075;54;48;28;4;24;.857;3600000;0
50689;2689;54;0;0;0;0;.00nan;0;0
50689;5923;40;50;35;5;30;.857;3600000;0
50641;704;36;28;15;4;11;.733;913000;0
50641;1547;48;0;0;0;0;.00nan;0;0
50641;1893;36;61;20;3;17;.850;2687000;0
50641;1959;48;91;28;1;27;.964;3600000;0
50724;1835;33;0;0;0;0;.00nan;0;0
50724;1926;47;75;33;3;30;.909;3546000;0
50724;5668;33;88;32;1;31;.969;3600000;0
50724;5740;47;0;0;0;0;.00nan;0;0
50697;1633;38;91;29;1;28;.966;3600000;0
50697;2921;60;56;42;5;37;.881;3600000;0
50697;3391;60;0;0;0;0;.00nan;0;0
50697;6571;38;0;0;0;0;.00nan;0;0
50785;1269;56;0;0;0;0;.00nan;0;0
50785;1531;153;48;0;0;0;.00nan;363000;0
50785;1852;153;48;34;6;28;.824;3237000;0
50785;5820;56;66;23;2;21;.913;3600000;0
50787;8;44;65;31;4;27;.871;3581000;0
50787;1771;45;0;0;0;0;.00nan;0;0
50787;2115;45;63;27;3;24;.889;3600000;0
50787;2653;44;0;0;0;0;.00nan;0;0
51378;526;59;93;30;1;29;.967;3558000;0
51378;892;59;0;0;0;0;.00nan;0;0
51378;3101;37;95;24;0;24;1.000;3600000;0
51378;3395;37;0;0;0;0;.00nan;0;0
51282;930;55;44;32;6;26;.813;3600000;0
51282;2746;32;63;31;4;27;.871;3600000;0
51282;3319;55;0;0;0;0;.00nan;0;0
51282;5944;32;0;0;0;0;.00nan;0;0
50812;1919;34;0;0;0;0;.00nan;0;0
50812;2021;34;84;39;3;36;.923;3600000;0
50812;2075;54;0;0;0;0;.00nan;0;0
50812;2689;54;69;48;5;43;.896;3600000;0
50667;1044;43;79;30;2;28;.933;3600000;0
50667;1831;57;0;0;0;0;.00nan;0;0
50667;5889;57;57;22;3;19;.864;3600000;0
50667;5949;43;0;0;0;0;.00nan;0;0
50642;124;123;0;0;0;0;.00nan;0;0
50642;1926;47;0;0;0;0;.00nan;0;0
50642;5740;47;100;39;0;39;1.000;3600000;0
50642;6493;123;80;36;2;34;.944;3526000;0
50763;665;125;21;26;6;20;.769;2514000;0
50763;1153;125;52;2;0;2;1.000;1086000;0
50763;1531;153;74;27;2;25;.926;3600000;0
50763;1852;153;0;0;0;0;.00nan;0;0
50702;1044;43;49;35;5;30;.857;3593000;0
50702;1835;33;64;32;4;28;.875;3600000;0
50702;5668;33;0;0;0;0;.00nan;0;0
50702;5949;43;0;0;0;0;.00nan;0;0
50711;1264;58;90;34;2;32;.941;3600000;0
50711;1831;57;71;27;3;24;.889;3572000;0
50711;5889;57;0;0;0;0;.00nan;0;0
50711;5948;58;0;0;0;0;.00nan;0;0
50671;124;123;55;24;3;21;.875;3600000;0
50671;1771;45;0;0;0;0;.00nan;0;0
50671;2115;45;48;28;4;24;.857;3600000;0
50671;6493;123;0;0;0;0;.00nan;0;0
50670;526;59;0;0;0;0;.00nan;0;0
50670;892;59;51;37;5;32;.865;3600000;0
50670;1269;56;0;0;0;0;.00nan;0;0
50670;5820;56;68;26;2;24;.923;3600000;0
50737;294;50;0;0;0;0;.00nan;0;0
50737;551;50;51;30;4;26;.867;3600000;0
50737;3101;37;55;40;5;35;.875;3556000;0
50737;3395;37;0;0;0;0;.00nan;0;0
50925;930;55;87;37;2;35;.946;3600000;0
50925;2075;54;55;34;5;29;.853;3600000;0
50925;2689;54;0;0;0;0;.00nan;0;0
50925;3319;55;0;0;0;0;.00nan;0;0
50683;526;59;89;29;1;28;.966;3600000;0
50683;892;59;0;0;0;0;.00nan;0;0
50683;1926;47;0;0;0;0;.00nan;0;0
50683;5740;47;65;22;2;20;.909;3577000;0
50959;1531;153;0;0;0;0;.00nan;0;0
50959;1852;153;61;31;3;28;.903;3600000;0
50959;2746;32;0;0;0;0;.00nan;0;0
50959;5944;32;100;24;0;24;1.000;3600000;0
50781;889;62;0;0;0;0;.00nan;0;0
50781;3066;62;54;29;4;25;.862;3600000;0
50781;3101;37;46;31;5;26;.839;3159000;0
50781;3395;37;37;13;3;10;.769;441000;0
50681;1919;34;63;41;5;36;.878;3600000;0
50681;2021;34;0;0;0;0;.00nan;0;0
50681;2921;60;80;37;3;34;.919;3600000;0
50681;3391;60;0;0;0;0;.00nan;0;0
50704;1771;45;57;37;5;32;.865;3600000;0
50704;1831;57;0;0;0;0;.00nan;0;0
50704;2115;45;0;0;0;0;.00nan;0;0
50704;5889;57;100;26;0;26;1.000;3600000;0
50696;977;40;85;35;2;33;.943;3600000;0
50696;1633;38;77;32;3;29;.906;3578000;0
50696;5923;40;0;0;0;0;.00nan;0;0
50696;6571;38;0;0;0;0;.00nan;0;0
50760;1507;41;75;25;2;23;.920;3600000;0
50760;1835;33;0;0;0;0;.00nan;0;0
50760;2116;41;0;0;0;0;.00nan;0;0
50760;5668;33;72;38;3;35;.921;3600000;0
50714;8;44;59;33;4;29;.879;3547000;0
50714;665;125;78;32;2;30;.938;3600000;0
50714;1153;125;0;0;0;0;.00nan;0;0
50714;2653;44;0;0;0;0;.00nan;0;0
50707;704;36;100;37;1;36;.973;3600000;0
50707;1044;43;0;0;0;0;.00nan;0;0
50707;1893;36;0;0;0;0;.00nan;0;0
50707;5949;43;70;34;3;31;.912;3600000;0
50723;294;50;39;33;5;28;.848;3556000;0
50723;551;50;0;0;0;0;.00nan;0;0
50723;1269;56;76;35;3;32;.914;3600000;0
50723;5820;56;0;0;0;0;.00nan;0;0
50622;102;53;0;0;0;0;.00nan;0;0
50622;124;123;73;24;1;23;.958;3600000;0
50622;2123;53;58;42;5;37;.881;3600000;0
50622;6493;123;0;0;0;0;.00nan;0;0
50687;1547;48;95;34;1;33;.971;3600000;0
50687;1959;48;0;0;0;0;.00nan;0;0
50687;2075;54;0;0;0;0;.00nan;0;0
50687;2689;54;44;26;4;22;.846;3600000;0
50650;1264;58;39;32;6;26;.813;3895000;0
50650;1547;48;0;0;0;0;.00nan;0;0
50650;1959;48;56;43;6;37;.860;3900000;0
50650;5948;58;0;0;0;0;.00nan;0;0
50738;889;62;0;0;0;0;.00nan;0;0
50738;1269;56;0;0;0;0;.00nan;0;0
50738;3066;62;69;27;2;25;.926;3533000;0
50738;5820;56;100;37;0;37;1.000;3600000;0
50722;3101;37;0;0;0;0;.00nan;0;0
50722;3395;37;70;32;3;29;.906;3819000;0
50722;3756;57;0;0;0;0;.00nan;0;0
50722;5889;57;64;25;2;23;.920;3819000;0
50708;977;40;72;46;5;41;.891;3600000;0
50708;2921;60;82;35;2;33;.943;3600000;0
50708;3391;60;0;0;0;0;.00nan;0;0
50708;5923;40;0;0;0;0;.00nan;0;0
50829;1531;153;0;0;0;0;.00nan;0;0
50829;1852;153;46;20;3;17;.850;3535000;0
50829;1919;34;0;0;0;0;.00nan;0;0
50829;2021;34;95;46;2;44;.957;3600000;0
50734;930;55;70;34;3;31;.912;3600000;0
50734;1835;33;77;34;4;30;.882;3600000;0
50734;3319;55;0;0;0;0;.00nan;0;0
50734;5668;33;0;0;0;0;.00nan;0;0
50694;526;59;0;0;0;0;.00nan;0;0
50694;704;36;80;41;3;38;.927;3520000;0
50694;892;59;95;33;1;32;.970;3600000;0
50694;1893;36;0;0;0;0;.00nan;0;0
50915;665;125;67;44;5;39;.886;3600000;0
50915;1153;125;0;0;0;0;.00nan;0;0
50915;1771;45;0;0;0;0;.00nan;0;0
50915;2115;45;94;33;1;32;.970;3600000;0
50767;8;44;66;29;3;26;.897;3600000;0
50767;1633;38;0;0;0;0;.00nan;0;0
50767;2653;44;0;0;0;0;.00nan;0;0
50767;6571;38;68;30;4;26;.867;3552000;0
50727;294;50;0;0;0;0;.00nan;0;0
50727;1507;50;41;28;5;23;.821;3526000;0
50727;1926;47;66;31;4;27;.871;3600000;0
50727;5740;47;0;0;0;0;.00nan;0;0
50653;102;53;0;0;0;0;.00nan;0;0
50653;124;123;96;44;2;42;.955;3900000;0
50653;2123;53;86;29;2;27;.931;3900000;0
50653;6493;123;0;0;0;0;.00nan;0;0
50771;665;125;59;39;4;35;.897;3523000;0
50771;1153;125;0;0;0;0;.00nan;0;0
50771;1926;47;0;0;0;0;.00nan;0;0
50771;5740;47;73;28;2;26;.929;3600000;0
50825;8;44;0;0;0;0;.00nan;0;0
50825;930;55;0;0;0;0;.00nan;0;0
50825;2653;44;50;43;6;37;.860;3600000;0
50825;3319;55;99;34;1;33;.971;3600000;0
50750;889;62;55;35;4;31;.886;3578000;0
50750;1919;34;82;47;2;45;.957;3600000;0
50750;2021;34;0;0;0;0;.00nan;0;0
50750;3066;62;0;0;0;0;.00nan;0;0
51387;1771;45;99;42;1;41;.976;3600000;0
51387;1835;33;0;0;0;0;.00nan;0;0
51387;2115;45;0;0;0;0;.00nan;0;0
51387;5668;33;36;28;5;23;.821;3600000;0
51151;1531;153;67;37;4;33;.892;3900000;0
51151;1633;38;62;38;4;34;.895;3900000;0
51151;1852;153;0;0;0;0;.00nan;0;0
51151;6571;38;0;0;0;0;.00nan;0;0
50712;2116;41;74;25;1;24;.960;3900000;0
50712;2921;60;0;0;0;0;.00nan;0;0
50712;3028;41;0;0;0;0;.00nan;0;0
50712;3391;60;98;34;1;33;.971;3900000;0
50701;977;40;57;27;3;24;.889;3900000;0
50701;2746;32;0;0;0;0;.00nan;0;0
50701;5923;40;0;0;0;0;.00nan;0;0
50701;5944;32;67;37;3;34;.919;3900000;0
50726;1547;48;0;0;0;0;.00nan;0;0
50726;1959;48;92;27;1;26;.963;3600000;0
50726;2116;41;0;0;0;0;.00nan;0;0
50726;3028;41;69;36;4;32;.889;3600000;0
50684;1044;43;49;29;4;25;.862;3600000;0
50684;1264;58;75;21;1;20;.952;3600000;0
50684;5948;58;0;0;0;0;.00nan;0;0
50684;5949;43;0;0;0;0;.00nan;0;0
51161;526;59;0;0;0;0;.00nan;0;0
51161;892;59;56;43;5;38;.884;3600000;0
51161;1269;56;0;0;0;0;.00nan;0;0
51161;5820;56;93;41;1;40;.976;3600000;0
51393;124;123;0;0;0;0;.00nan;0;0
51393;3756;57;0;0;0;0;.00nan;0;0
51393;5889;57;68;24;2;22;.917;3600000;0
51393;6493;123;66;50;6;44;.880;3600000;0
50713;704;36;95;42;2;40;.952;3600000;0
50713;1893;36;0;0;0;0;.00nan;0;0
50713;2746;32;34;22;5;17;.773;3064000;0
50713;5944;32;50;1;0;1;1.000;536000;0
50675;102;53;77;31;2;29;.935;3600000;0
50675;2075;54;61;31;4;27;.871;3576000;0
50675;2123;53;0;0;0;0;.00nan;0;0
50675;2689;54;0;0;0;0;.00nan;0;0
51308;889;62;0;0;0;0;.00nan;0;0
51308;930;55;54;36;5;31;.861;3758000;0
51308;3066;62;53;30;4;26;.867;3758000;0
51308;3319;55;0;0;0;0;.00nan;0;0
50741;665;125;77;37;3;34;.919;3580000;0
50741;1044;43;77;23;1;22;.957;3600000;0
50741;1153;125;0;0;0;0;.00nan;0;0
50741;5949;43;0;0;0;0;.00nan;0;0
50838;294;50;0;0;0;0;.00nan;0;0
50838;930;55;0;0;0;0;.00nan;0;0
50838;1507;50;97;20;0;20;1.000;3600000;0
50838;3319;55;47;37;5;32;.865;3600000;0
50733;1264;58;77;28;1;27;.964;3600000;0
50733;3756;57;0;0;0;0;.00nan;0;0
50733;5889;57;96;44;2;42;.955;3600000;0
50733;5948;58;0;0;0;0;.00nan;0;0
50794;1919;34;69;32;3;29;.906;3668000;0
50794;2021;34;0;0;0;0;.00nan;0;0
50794;3101;37;0;0;0;0;.00nan;0;0
50794;3395;37;67;23;2;21;.913;3668000;0
50803;1633;38;0;0;0;0;.00nan;0;0
50803;2116;41;0;0;0;0;.00nan;0;0
50803;3028;41;47;48;8;40;.833;3600000;0
50803;6571;38;56;19;2;17;.895;3600000;0
50715;977;40;54;35;4;31;.886;3600000;0
50715;2921;60;100;24;0;24;1.000;3600000;0
50715;3391;60;0;0;0;0;.00nan;0;0
50715;5923;40;0;0;0;0;.00nan;0;0
50758;102;53;0;0;0;0;.00nan;0;0
50758;665;125;77;30;2;28;.933;3900000;0
50758;1153;125;0;0;0;0;.00nan;0;0
50758;2123;53;85;34;2;32;.941;3900000;0
50816;1269;56;0;0;0;0;.00nan;0;0
50816;1919;34;59;5;0;5;1.000;258000;0
50816;2021;34;35;39;6;33;.846;3342000;0
50816;5820;56;50;23;4;19;.826;3600000;0
50682;124;123;56;33;5;28;.848;3600000;0
50682;1531;153;0;0;0;0;.00nan;0;0
50682;1852;153;82;28;1;27;.964;3600000;0
50682;6493;123;0;0;0;0;.00nan;0;0
50782;2075;54;97;54;3;51;.944;3900000;0
50782;2689;54;0;0;0;0;.00nan;0;0
50782;3101;37;69;31;3;28;.903;3900000;0
50782;3395;37;0;0;0;0;.00nan;0;0
50710;526;59;0;0;0;0;.00nan;0;0
50710;892;59;82;35;2;33;.943;3600000;0
50710;2746;32;0;0;0;0;.00nan;0;0
50710;5944;32;48;28;4;24;.857;3572000;0
50744;1044;43;0;0;0;0;.00nan;0;0
50744;2116;41;66;37;4;33;.892;3623000;0
50744;3028;41;0;0;0;0;.00nan;0;0
50744;5949;43;51;24;3;21;.875;3623000;0
50740;1547;48;0;0;0;0;.00nan;0;0
50740;1926;47;99;32;1;31;.969;3600000;0
50740;1959;48;64;24;3;21;.875;3530000;0
50740;5740;47;0;0;0;0;.00nan;0;0
50717;704;36;0;0;0;0;.00nan;0;0
50717;1893;36;63;29;3;26;.897;3588000;0
50717;3756;57;71;25;2;23;.920;3600000;0
50717;5889;57;0;0;0;0;.00nan;0;0
50746;8;44;92;33;1;32;.970;3600000;0
50746;889;62;0;0;0;0;.00nan;0;0
50746;2653;44;0;0;0;0;.00nan;0;0
50746;3066;62;84;33;2;31;.939;3550000;0
50721;1771;45;0;0;0;0;.00nan;0;0
50721;2115;45;90;36;1;35;.972;3600000;0
50721;2921;60;88;49;3;46;.939;3566000;0
50721;3391;60;0;0;0;0;.00nan;0;0
50752;294;50;0;0;0;0;.00nan;0;0
50752;1507;50;74;21;2;19;.905;3600000;0
50752;1835;33;74;47;4;43;.915;3600000;0
50752;5668;33;0;0;0;0;.00nan;0;0
50948;889;62;0;0;0;0;.00nan;0;0
50948;1633;38;0;0;0;0;.00nan;0;0
50948;3066;62;81;32;1;31;.969;3868000;0
50948;6571;38;75;24;2;22;.917;3868000;0
50706;526;59;0;0;0;0;.00nan;0;0
50706;892;59;69;31;3;28;.903;3600000;0
50706;2075;54;100;30;0;30;1.000;3600000;0
50706;2689;54;0;0;0;0;.00nan;0;0
50777;977;40;72;44;4;40;.909;3600000;0
50777;1771;45;0;0;0;0;.00nan;0;0
50777;2115;45;84;25;1;24;.960;3600000;0
50777;5923;40;0;0;0;0;.00nan;0;0
50759;102;53;0;0;0;0;.00nan;0;0
50759;958;53;52;35;5;30;.857;3600000;0
50759;1919;34;81;30;2;28;.933;3600000;0
50759;2021;34;0;0;0;0;.00nan;0;0
50755;665;125;0;0;0;0;.00nan;0;0
50755;704;36;93;44;3;41;.932;3771000;0
50755;1153;125;64;25;2;23;.920;3771000;0
50755;1893;36;0;0;0;0;.00nan;0;0
50810;1926;47;96;41;1;40;.976;3600000;0
50810;2746;32;0;0;0;0;.00nan;0;0
50810;5740;47;0;0;0;0;.00nan;0;0
50810;5944;32;54;18;3;15;.833;3600000;0
50732;1531;153;0;0;0;0;.00nan;0;0
50732;1852;153;78;28;2;26;.929;3544000;0
50732;2921;60;83;32;1;31;.969;3600000;0
50732;3391;60;0;0;0;0;.00nan;0;0
50673;124;123;0;0;0;0;.00nan;0;0
50673;1264;58;100;20;0;20;1.000;3600000;0
50673;5948;58;0;0;0;0;.00nan;0;0
50673;6493;123;66;43;4;39;.907;3600000;0
50893;1835;33;87;34;2;32;.941;3600000;0
50893;2116;41;48;39;5;34;.872;3600000;0
50893;3028;41;0;0;0;0;.00nan;0;0
50893;5668;33;0;0;0;0;.00nan;0;0
51061;1633;38;75;28;2;26;.929;3600000;0
51061;2075;54;56;31;4;27;.871;3583000;0
51061;2689;54;0;0;0;0;.00nan;0;0
51061;6571;38;0;0;0;0;.00nan;0;0
50765;8;44;80;28;1;27;.964;3600000;0
50765;1264;58;73;32;2;30;.938;3544000;0
50765;2653;44;0;0;0;0;.00nan;0;0
50765;5948;58;0;0;0;0;.00nan;0;0
50983;977;40;46;29;5;24;.828;3591000;0
50983;1044;43;42;25;4;21;.840;3600000;0
50983;5923;40;0;0;0;0;.00nan;0;0
50983;5949;43;0;0;0;0;.00nan;0;0
50799;294;50;0;0;0;0;.00nan;0;0
50799;1507;50;74;30;2;28;.933;3600000;0
50799;1531;153;49;24;3;21;.875;3584000;0
50799;1852;153;0;0;0;0;.00nan;0;0
50815;1269;56;0;0;0;0;.00nan;0;0
50815;2746;32;79;35;2;33;.943;3555000;0
50815;5820;56;92;33;1;32;.970;3600000;0
50815;5944;32;0;0;0;0;.00nan;0;0
50731;526;59;0;0;0;0;.00nan;0;0
50731;892;59;42;27;5;22;.815;3570000;0
50731;1547;48;0;0;0;0;.00nan;0;0
50731;1959;48;88;36;3;33;.917;3600000;0
50749;930;55;83;35;2;33;.943;3555000;0
50749;3319;55;0;0;0;0;.00nan;0;0
50749;3756;57;0;0;0;0;.00nan;0;0
50749;5889;57;88;30;1;29;.967;3600000;0
50770;8;44;0;0;0;0;.00nan;0;0
50770;704;36;98;23;0;23;1.000;3600000;0
50770;1893;36;0;0;0;0;.00nan;0;0
50770;2653;44;38;19;4;15;.789;3600000;0
50686;124;123;0;0;0;0;.00nan;0;0
50686;3101;37;0;0;0;0;.00nan;0;0
50686;3395;37;79;42;4;38;.905;3600000;0
50686;6493;123;58;39;5;34;.872;3591000;0
50940;889;62;0;0;0;0;.00nan;0;0
50940;930;55;0;0;0;0;.00nan;0;0
50940;3066;62;68;24;2;22;.917;3600000;0
50940;3319;55;52;29;4;25;.862;3584000;0
50805;102;53;79;40;4;36;.900;3600000;0
50805;958;53;0;0;0;0;.00nan;0;0
50805;1771;45;0;0;0;0;.00nan;0;0
50805;2115;45;72;29;2;27;.931;3600000;0
50747;1044;43;53;32;4;28;.875;3571000;0
50747;1269;56;0;0;0;0;.00nan;0;0
50747;5820;56;59;22;3;19;.864;3600000;0
50747;5949;43;0;0;0;0;.00nan;0;0
50751;977;40;69;20;2;18;.900;3600000;0
50751;1926;47;57;27;3;24;.889;3600000;0
50751;5740;47;0;0;0;0;.00nan;0;0
50751;5923;40;0;0;0;0;.00nan;0;0
50756;1547;48;0;0;0;0;.00nan;0;0
50756;1835;33;52;36;5;31;.861;3600000;0
50756;1959;48;100;27;1;26;.963;3600000;0
50756;5668;33;0;0;0;0;.00nan;0;0
50695;124;123;0;0;0;0;.00nan;0;0
50695;1044;43;78;44;4;40;.909;3600000;0
50695;5949;43;0;0;0;0;.00nan;0;0
50695;6493;123;59;16;1;15;.938;3600000;0
50793;1264;58;64;39;5;34;.872;3600000;0
50793;2075;54;64;45;6;39;.867;3580000;0
50793;2689;54;0;0;0;0;.00nan;0;0
50793;5948;58;0;0;0;0;.00nan;0;0
50788;889;62;0;0;0;0;.00nan;0;0
50788;3066;62;43;29;5;24;.828;3540000;0
50788;3756;57;0;0;0;0;.00nan;0;0
50788;5889;57;52;15;3;12;.800;3600000;0
50792;704;36;65;41;4;37;.902;3600000;0
50792;1633;38;0;0;0;0;.00nan;0;0
50792;1893;36;0;0;0;0;.00nan;0;0
50792;6571;38;25;22;5;17;.773;3548000;0
50735;1835;33;0;0;0;0;.00nan;0;0
50735;2921;60;76;33;2;31;.939;3600000;0
50735;3391;60;0;0;0;0;.00nan;0;0
50735;5668;33;89;18;0;18;1.000;3600000;0
50834;1269;56;65;26;2;24;.923;3600000;0
50834;2116;41;0;0;0;0;.00nan;0;0
50834;3028;41;78;37;4;33;.892;3515000;0
50834;5820;56;0;0;0;0;.00nan;0;0
50743;8;44;0;0;0;0;.00nan;0;0
50743;526;59;0;0;0;0;.00nan;0;0
50743;892;59;63;31;3;28;.903;3556000;0
50743;2653;44;70;30;2;28;.933;3600000;0
50776;1531;153;0;0;0;0;.00nan;0;0
50776;1852;153;77;30;3;27;.900;3900000;0
50776;3756;57;80;37;3;34;.919;3900000;0
50776;5889;57;0;0;0;0;.00nan;0;0
50827;1633;38;55;22;3;19;.864;3900000;0
50827;1926;47;72;31;3;28;.903;3900000;0
50827;5740;47;0;0;0;0;.00nan;0;0
50827;6571;38;0;0;0;0;.00nan;0;0
50779;526;59;100;36;0;36;1.000;3600000;0
50779;665;125;47;26;5;21;.808;3600000;0
50779;892;59;0;0;0;0;.00nan;0;0
50779;1153;125;0;0;0;0;.00nan;0;0
50688;124;123;78;37;3;34;.919;3568000;0
50688;2746;32;0;0;0;0;.00nan;0;0
50688;5944;32;84;33;2;31;.939;3600000;0
50688;6493;123;0;0;0;0;.00nan;0;0
50997;294;50;0;0;0;0;.00nan;0;0
50997;889;62;87;31;2;29;.935;3900000;0
50997;1507;50;83;31;2;29;.935;3900000;0
50997;3066;62;0;0;0;0;.00nan;0;0
50786;1547;48;0;0;0;0;.00nan;0;0
50786;1919;34;77;38;3;35;.921;3600000;0
50786;1959;48;59;19;2;17;.895;3600000;0
50786;2021;34;0;0;0;0;.00nan;0;0
50775;8;44;88;35;2;33;.943;3900000;0
50775;977;40;100;53;2;51;.962;3900000;0
50775;2653;44;0;0;0;0;.00nan;0;0
50775;5923;40;0;0;0;0;.00nan;0;0
50818;102;53;61;34;4;30;.882;3600000;0
50818;958;53;0;0;0;0;.00nan;0;0
50818;2075;54;0;0;0;0;.00nan;0;0
50818;2689;54;39;26;5;21;.808;3560000;0
50761;1547;48;0;0;0;0;.00nan;0;0
50761;1959;48;80;31;3;28;.903;3600000;0
50761;3101;37;0;0;0;0;.00nan;0;0
50761;3395;37;49;26;4;22;.846;3548000;0
50757;930;55;60;33;4;29;.879;3570000;0
50757;1044;43;73;34;3;31;.912;3600000;0
50757;3319;55;0;0;0;0;.00nan;0;0
50757;5949;43;0;0;0;0;.00nan;0;0
50814;1269;56;0;0;0;0;.00nan;0;0
50814;1531;153;94;41;3;38;.927;3600000;0
50814;1852;153;0;0;0;0;.00nan;0;0
50814;5820;56;45;27;5;22;.815;3515000;0
50769;2116;41;50;23;3;20;.870;3765000;0
50769;2921;60;90;45;4;41;.911;3765000;0
50769;3028;41;0;0;0;0;.00nan;0;0
50769;3391;60;0;0;0;0;.00nan;0;0
50690;124;123;0;0;0;0;.00nan;0;0
50690;977;40;33;36;7;29;.806;3121000;0
50690;5923;40;50;1;0;1;1.000;479000;0
50690;6493;123;62;30;3;27;.900;3600000;0
50918;704;36;81;23;1;22;.957;3600000;0
50918;1771;45;0;0;0;0;.00nan;0;0
50918;1893;36;0;0;0;0;.00nan;0;0
50918;2115;45;54;25;3;22;.880;3566000;0
50780;526;59;85;38;2;36;.947;3600000;0
50780;892;59;0;0;0;0;.00nan;0;0
50780;3756;57;0;0;0;0;.00nan;0;0
50780;5889;57;46;22;3;19;.864;3542000;0
50813;1835;33;0;0;0;0;.00nan;0;0
50813;1926;47;76;20;1;19;.950;3900000;0
50813;5668;33;82;35;1;34;.971;3900000;0
50813;5740;47;0;0;0;0;.00nan;0;0
50753;1044;43;26;37;8;29;.784;3274000;0
50753;2075;54;69;34;3;31;.912;3600000;0
50753;2689;54;0;0;0;0;.00nan;0;0
50753;5949;43;32;3;2;1;.333;326000;0
51070;294;50;0;0;0;0;.00nan;0;0
51070;889;62;0;0;0;0;.00nan;0;0
51070;1507;50;78;32;2;30;.938;3600000;0
51070;3066;62;41;22;4;18;.818;3538000;0
50798;1264;58;81;26;1;25;.962;3600000;0
50798;2746;32;0;0;0;0;.00nan;0;0
50798;5944;32;43;37;6;31;.838;3600000;0
50798;5948;58;0;0;0;0;.00nan;0;0
50742;102;53;70;29;3;26;.897;3582000;0
50742;958;53;0;0;0;0;.00nan;0;0
50742;2921;60;0;0;0;0;.00nan;0;0
50742;3391;60;61;11;1;10;.909;3600000;0
51080;294;50;74;27;2;25;.926;3704000;0
51080;1507;50;0;0;0;0;.00nan;0;0
51080;1771;45;73;32;3;29;.906;3704000;0
51080;2115;45;0;0;0;0;.00nan;0;0
50808;102;53;0;0;0;0;.00nan;0;0
50808;958;53;40;20;3;17;.850;3550000;0
50808;2116;41;97;36;2;34;.944;3600000;0
50808;3028;41;0;0;0;0;.00nan;0;0
50899;704;36;0;0;0;0;.00nan;0;0
50899;1835;33;57;25;3;22;.880;3600000;0
50899;1893;36;63;36;4;32;.889;3600000;0
50899;5668;33;0;0;0;0;.00nan;0;0
50796;977;40;0;0;0;0;.00nan;0;0
50796;1919;34;54;28;4;24;.857;3600000;0
50796;2021;34;0;0;0;0;.00nan;0;0
50796;5923;40;91;30;1;29;.967;3600000;0
50789;8;44;0;0;0;0;.00nan;0;0
50789;2653;44;68;21;1;20;.952;3600000;0
50789;3101;37;0;0;0;0;.00nan;0;0
50789;3395;37;57;29;4;25;.862;3600000;0
50881;665;125;59;43;6;37;.860;3600000;0
50881;1153;125;0;0;0;0;.00nan;0;0
50881;1264;58;68;33;3;30;.909;3600000;0
50881;5948;58;0;0;0;0;.00nan;0;0
51227;889;62;70;26;2;24;.923;3600000;0
51227;1547;48;0;0;0;0;.00nan;0;0
51227;1959;48;95;47;3;44;.936;3568000;0
51227;3066;62;0;0;0;0;.00nan;0;0
50870;1269;56;0;0;0;0;.00nan;0;0
50870;2746;32;0;0;0;0;.00nan;0;0
50870;5820;56;61;29;3;26;.897;3528000;0
50870;5944;32;100;43;1;42;.977;3600000;0
50883;665;125;89;46;3;43;.935;3600000;0
50883;1153;125;0;0;0;0;.00nan;0;0
50883;1926;47;70;39;4;35;.897;3592000;0
50883;5740;47;0;0;0;0;.00nan;0;0
50804;930;55;66;24;2;22;.917;3600000;0
50804;1547;48;73;44;5;39;.886;3600000;0
50804;1959;48;0;0;0;0;.00nan;0;0
50804;3319;55;0;0;0;0;.00nan;0;0
50801;1531;153;0;0;0;0;.00nan;0;0
50801;1852;153;95;25;0;25;1.000;3600000;0
50801;3101;37;93;42;2;40;.952;3545000;0
50801;3395;37;0;0;0;0;.00nan;0;0
50854;930;55;0;0;0;0;.00nan;0;0
50854;1919;34;42;23;4;19;.826;3600000;0
50854;2021;34;0;0;0;0;.00nan;0;0
50854;3319;55;70;22;1;21;.955;3600000;0
50853;977;40;56;44;6;38;.864;3600000;0
50853;1633;38;0;0;0;0;.00nan;0;0
50853;5923;40;0;0;0;0;.00nan;0;0
50853;6571;38;54;16;2;14;.875;3600000;0
50830;1269;56;0;0;0;0;.00nan;0;0
50830;1531;153;0;0;0;0;.00nan;0;0
50830;1852;153;66;36;5;31;.861;3893000;0
50830;5820;56;42;24;4;20;.833;3893000;0
50952;1926;47;74;35;3;32;.914;3573000;0
50952;2746;32;0;0;0;0;.00nan;0;0
50952;5740;47;0;0;0;0;.00nan;0;0
50952;5944;32;87;27;1;26;.963;3600000;0
50772;8;44;56;34;5;29;.853;3548000;0
50772;1044;43;0;0;0;0;.00nan;0;0
50772;2653;44;0;0;0;0;.00nan;0;0
50772;5949;43;55;26;4;22;.846;3600000;0
50802;2075;54;71;40;4;36;.900;3570000;0
50802;2689;54;0;0;0;0;.00nan;0;0
50802;2921;60;59;24;3;21;.875;3600000;0
50802;3391;60;0;0;0;0;.00nan;0;0
51046;665;125;35;39;7;32;.821;3600000;0
51046;1153;125;0;0;0;0;.00nan;0;0
51046;1835;33;85;39;3;36;.923;3600000;0
51046;5668;33;0;0;0;0;.00nan;0;0
50748;124;123;100;34;1;33;.971;3600000;0
50748;1633;38;57;29;4;25;.862;3600000;0
50748;6493;123;0;0;0;0;.00nan;0;0
50748;6571;38;0;0;0;0;.00nan;0;0
50862;102;53;23;24;6;18;.750;2523000;0
50862;958;53;46;12;2;10;.833;1077000;0
50862;1771;45;0;0;0;0;.00nan;0;0
50862;2115;45;85;29;3;26;.897;3600000;0
50858;294;50;0;0;0;0;.00nan;0;0
50858;1507;50;80;30;2;28;.933;3600000;0
50858;3756;57;0;0;0;0;.00nan;0;0
50858;5889;57;71;38;3;35;.921;3557000;0
50982;704;36;37;32;6;26;.813;3600000;0
50982;1893;36;0;0;0;0;.00nan;0;0
50982;2116;41;70;20;2;18;.900;3600000;0
50982;3028;41;0;0;0;0;.00nan;0;0
51221;526;59;0;0;0;0;.00nan;0;0
51221;889;62;0;0;0;0;.00nan;0;0
51221;892;59;100;47;1;46;.979;3600000;0
51221;3066;62;56;19;2;17;.895;3544000;0
50783;8;44;0;0;0;0;.00nan;0;0
50783;1264;58;62;35;4;31;.886;3551000;0
50783;2653;44;93;47;2;45;.957;3600000;0
50783;5948;58;0;0;0;0;.00nan;0;0
50762;1044;43;93;45;1;44;.978;3600000;0
50762;1531;153;75;35;3;32;.914;3581000;0
50762;1852;153;0;0;0;0;.00nan;0;0
50762;5949;43;0;0;0;0;.00nan;0;0
50895;665;125;48;30;4;26;.867;3600000;0
50895;1153;125;0;0;0;0;.00nan;0;0
50895;1269;56;96;24;0;24;1.000;3600000;0
50895;5820;56;0;0;0;0;.00nan;0;0
50821;526;59;0;0;0;0;.00nan;0;0
50821;892;59;47;33;5;28;.848;3571000;0
50821;2116;41;68;36;4;32;.889;3600000;0
50821;3028;41;0;0;0;0;.00nan;0;0
50859;294;50;63;37;4;33;.892;3600000;0
50859;1507;50;0;0;0;0;.00nan;0;0
50859;2075;54;0;0;0;0;.00nan;0;0
50859;2689;54;53;40;5;35;.875;3600000;0
50856;1771;45;81;28;1;27;.964;3600000;0
50856;2115;45;0;0;0;0;.00nan;0;0
50856;2921;60;57;38;5;33;.868;3600000;0
50856;3391;60;0;0;0;0;.00nan;0;0
50822;2746;32;73;18;0;18;1.000;1382000;0
50822;3101;37;0;0;0;0;.00nan;0;0
50822;3395;37;68;33;3;30;.909;3600000;0
50822;5944;32;24;20;5;15;.750;2218000;0
50819;1547;48;0;0;0;0;.00nan;0;0
50819;1919;34;71;25;2;23;.920;3549000;0
50819;1959;48;93;18;0;18;1.000;3600000;0
50819;2021;34;0;0;0;0;.00nan;0;0
50908;704;36;0;0;0;0;.00nan;0;0
50908;977;40;64;8;0;8;1.000;1263000;0
50908;1893;36;79;34;3;31;.912;3600000;0
50908;5923;40;26;22;5;17;.773;2259000;0
51081;889;62;84;24;1;23;.958;3565000;0
51081;1835;33;0;0;0;0;.00nan;0;0
51081;3066;62;0;0;0;0;.00nan;0;0
51081;5668;33;91;21;0;21;1.000;3600000;0
50934;930;55;69;20;3;17;.850;3900000;0
50934;3101;37;97;39;3;36;.923;3900000;0
50934;3319;55;0;0;0;0;.00nan;0;0
50934;3395;37;0;0;0;0;.00nan;0;0
50703;124;123;54;5;0;5;1.000;658000;0
50703;1633;38;0;0;0;0;.00nan;0;0
50703;6493;123;15;37;8;29;.784;2942000;0
50703;6571;38;66;16;1;15;.938;3600000;0
50826;102;53;31;27;6;21;.778;3600000;0
50826;958;53;0;0;0;0;.00nan;0;0
50826;1264;58;82;16;0;16;1.000;1330000;0
50826;5948;58;39;19;4;15;.789;2270000;0
50795;102;53;36;30;6;24;.800;3057000;0
50795;958;53;25;13;4;9;.692;543000;0
50795;2921;60;95;32;1;31;.969;3600000;0
50795;3391;60;0;0;0;0;.00nan;0;0
50844;8;44;0;0;0;0;.00nan;0;0
50844;1771;45;0;0;0;0;.00nan;0;0
50844;2115;45;40;31;5;26;.839;3581000;0
50844;2653;44;57;30;4;26;.867;3600000;0
51267;889;62;0;0;0;0;.00nan;0;0
51267;1926;47;23;32;7;25;.781;3600000;0
51267;3066;62;82;32;2;30;.938;3600000;0
51267;5740;47;0;0;0;0;.00nan;0;0
50932;930;55;0;0;0;0;.00nan;0;0
50932;3319;55;81;39;2;37;.949;3600000;0
50932;3756;57;0;0;0;0;.00nan;0;0
50932;5889;57;78;28;1;27;.964;3600000;0
50811;1547;48;0;0;0;0;.00nan;0;0
50811;1959;48;82;52;5;47;.904;3683000;0
50811;2075;54;53;40;6;34;.850;3683000;0
50811;2689;54;0;0;0;0;.00nan;0;0
50886;1531;153;0;0;0;0;.00nan;0;0
50886;1835;33;32;10;3;7;.700;1340000;0
50886;1852;153;100;35;0;35;1.000;3600000;0
50886;5668;33;43;24;4;20;.833;2260000;0
50828;294;50;0;0;0;0;.00nan;0;0
50828;526;59;0;0;0;0;.00nan;0;0
50828;892;59;61;40;5;35;.875;3600000;0
50828;1507;50;80;28;1;27;.964;3600000;0
50764;124;123;85;35;2;33;.943;3529000;0
50764;1919;34;98;21;0;21;1.000;3600000;0
50764;2021;34;0;0;0;0;.00nan;0;0
50764;6493;123;0;0;0;0;.00nan;0;0
50857;1044;43;56;40;5;35;.875;3600000;0
50857;2746;32;83;28;1;27;.964;3600000;0
50857;5944;32;0;0;0;0;.00nan;0;0
50857;5949;43;0;0;0;0;.00nan;0;0
50855;704;36;80;43;4;39;.907;3600000;0
50855;1893;36;0;0;0;0;.00nan;0;0
50855;2116;41;81;30;1;29;.967;3600000;0
50855;3028;41;0;0;0;0;.00nan;0;0
50841;977;40;91;37;2;35;.946;3581000;0
50841;1633;38;86;32;1;31;.969;3600000;0
50841;5923;40;0;0;0;0;.00nan;0;0
50841;6571;38;0;0;0;0;.00nan;0;0
50896;889;62;0;0;0;0;.00nan;0;0
50896;1264;58;74;45;5;40;.889;3600000;0
50896;3066;62;86;30;1;29;.967;3600000;0
50896;5948;58;0;0;0;0;.00nan;0;0
50773;124;123;55;28;4;24;.857;3600000;0
50773;665;125;68;20;1;19;.950;3600000;0
50773;1153;125;0;0;0;0;.00nan;0;0
50773;6493;123;0;0;0;0;.00nan;0;0
50852;102;53;0;0;0;0;.00nan;0;0
50852;958;53;69;31;3;28;.903;3600000;0
50852;1926;47;93;41;2;39;.951;3600000;0
50852;5740;47;0;0;0;0;.00nan;0;0
50809;2921;60;21;27;6;21;.778;3578000;0
50809;3101;37;0;0;0;0;.00nan;0;0
50809;3391;60;0;0;0;0;.00nan;0;0
50809;3395;37;63;25;3;22;.880;3600000;0
50833;1919;34;79;32;2;30;.938;3900000;0
50833;2021;34;0;0;0;0;.00nan;0;0
50833;2075;54;96;51;2;49;.961;3900000;0
50833;2689;54;0;0;0;0;.00nan;0;0
50823;977;40;69;28;3;25;.893;3600000;0
50823;2116;41;39;25;5;20;.800;3518000;0
50823;3028;41;0;0;0;0;.00nan;0;0
50823;5923;40;0;0;0;0;.00nan;0;0
50956;930;55;81;27;1;26;.963;3600000;0
50956;1547;48;0;0;0;0;.00nan;0;0
50956;1959;48;90;46;3;43;.935;3561000;0
50956;3319;55;0;0;0;0;.00nan;0;0
50784;1044;43;80;38;3;35;.921;3898000;0
50784;1771;45;0;0;0;0;.00nan;0;0
50784;2115;45;76;33;2;31;.939;3898000;0
50784;5949;43;0;0;0;0;.00nan;0;0
50909;704;36;68;39;4;35;.897;3600000;0
50909;1531;153;0;0;0;0;.00nan;0;0
50909;1852;153;99;29;1;28;.966;3600000;0
50909;1893;36;0;0;0;0;.00nan;0;0
51079;665;125;0;0;0;0;.00nan;0;0
51079;1153;125;63;52;7;45;.865;3577000;0
51079;2746;32;70;11;0;11;1.000;1280000;0
51079;5944;32;15;20;6;14;.700;2320000;0
50807;1269;56;100;30;0;30;1.000;3600000;0
50807;2921;60;0;0;0;0;.00nan;0;0
50807;3391;60;54;26;4;22;.846;3600000;0
50807;5820;56;0;0;0;0;.00nan;0;0
50817;102;53;59;40;5;35;.875;3826000;0
50817;526;59;0;0;0;0;.00nan;0;0
50817;892;59;41;22;4;18;.818;3826000;0
50817;958;53;0;0;0;0;.00nan;0;0
50863;294;50;46;18;3;15;.833;2993000;0
50863;930;55;0;0;0;0;.00nan;0;0
50863;1507;50;29;8;3;5;.625;539000;0
50863;3319;55;62;24;4;20;.833;3600000;0
50962;1264;58;0;0;0;0;.00nan;0;0
50962;1771;45;48;22;4;18;.818;3900000;0
50962;2115;45;0;0;0;0;.00nan;0;0
50962;5948;58;52;28;4;24;.857;3900000;0
50840;1919;34;0;0;0;0;.00nan;0;0
50840;2021;34;58;16;1;15;.938;3600000;0
50840;3101;37;44;30;5;25;.833;3600000;0
50840;3395;37;0;0;0;0;.00nan;0;0
50843;8;44;0;0;0;0;.00nan;0;0
50843;1926;47;0;0;0;0;.00nan;0;0
50843;2653;44;72;46;4;42;.913;3600000;0
50843;5740;47;35;29;5;24;.828;3544000;0
50790;124;123;65;11;0;11;1.000;1426000;0
50790;2116;41;74;25;2;23;.920;3600000;0
50790;3028;41;0;0;0;0;.00nan;0;0
50790;6493;123;31;27;6;21;.778;2174000;0
50849;1547;48;0;0;0;0;.00nan;0;0
50849;1959;48;36;25;5;20;.800;3600000;0
50849;3756;57;0;0;0;0;.00nan;0;0
50849;5889;57;100;43;0;43;1.000;3600000;0
50820;1919;34;77;39;3;36;.923;3900000;0
50820;2021;34;0;0;0;0;.00nan;0;0
50820;3756;57;0;0;0;0;.00nan;0;0
50820;5889;57;87;31;3;28;.903;3900000;0
50914;294;50;0;0;0;0;.00nan;0;0
50914;1507;50;63;30;3;27;.900;3900000;0
50914;1835;33;62;28;3;25;.893;3900000;0
50914;5668;33;0;0;0;0;.00nan;0;0
50872;704;36;77;38;3;35;.921;3568000;0
50872;1893;36;0;0;0;0;.00nan;0;0
50872;2746;32;86;27;1;26;.963;3600000;0
50872;5944;32;0;0;0;0;.00nan;0;0
50831;526;59;0;0;0;0;.00nan;0;0
50831;892;59;98;38;1;37;.974;3900000;0
50831;930;55;82;24;1;23;.958;3900000;0
50831;3319;55;0;0;0;0;.00nan;0;0
50832;8;44;0;0;0;0;.00nan;0;0
50832;1264;58;100;22;0;22;1.000;3600000;0
50832;2653;44;88;27;1;26;.963;3542000;0
50832;5948;58;0;0;0;0;.00nan;0;0
50848;977;40;23;4;3;1;.250;402000;0
50848;1633;38;0;0;0;0;.00nan;0;0
50848;5923;40;74;27;1;26;.963;3180000;0
50848;6571;38;64;22;2;20;.909;3600000;0
50797;124;123;59;21;3;18;.857;3600000;0
50797;2116;41;40;30;6;24;.800;3600000;0
50797;3028;41;0;0;0;0;.00nan;0;0
50797;6493;123;0;0;0;0;.00nan;0;0
50942;665;125;81;32;3;29;.906;3600000;0
50942;1044;43;77;47;4;43;.915;3571000;0
50942;1153;125;0;0;0;0;.00nan;0;0
50942;5949;43;0;0;0;0;.00nan;0;0
50836;2075;54;94;30;1;29;.967;3600000;0
50836;2689;54;0;0;0;0;.00nan;0;0
50836;3101;37;0;0;0;0;.00nan;0;0
50836;3395;37;55;23;3;20;.870;3600000;0
50999;704;36;0;0;0;0;.00nan;0;0
50999;1771;45;53;2;0;2;1.000;600000;0
50999;1893;36;49;36;6;30;.833;3600000;0
50999;2115;45;15;25;7;18;.720;2988000;0
50845;1044;43;0;0;0;0;.00nan;0;0
50845;1633;38;76;12;0;12;1.000;3600000;0
50845;5949;43;61;40;4;36;.900;3600000;0
50845;6571;38;0;0;0;0;.00nan;0;0
50861;102;53;84;49;3;46;.939;3592000;0
50861;958;53;0;0;0;0;.00nan;0;0
50861;977;40;66;22;2;20;.909;3600000;0
50861;5923;40;0;0;0;0;.00nan;0;0
50892;889;62;0;0;0;0;.00nan;0;0
50892;2075;54;0;0;0;0;.00nan;0;0
50892;2689;54;38;37;6;31;.838;3900000;0
50892;3066;62;51;32;6;26;.813;3900000;0
50911;1269;56;62;28;3;25;.893;3600000;0
50911;1835;33;0;0;0;0;.00nan;0;0
50911;5668;33;10;43;9;34;.791;3600000;0
50911;5820;56;0;0;0;0;.00nan;0;0
50900;1547;48;0;0;0;0;.00nan;0;0
50900;1959;48;76;31;2;29;.935;3600000;0
50900;2746;32;0;0;0;0;.00nan;0;0
50900;5944;32;77;35;3;32;.914;3545000;0
50800;526;59;86;44;3;41;.932;3600000;0
50800;892;59;0;0;0;0;.00nan;0;0
50800;1531;153;0;0;0;0;.00nan;0;0
50800;1852;153;60;37;5;32;.865;3513000;0
50835;8;44;0;0;0;0;.00nan;0;0
50835;2653;44;60;36;5;31;.861;3543000;0
50835;2921;60;79;35;4;31;.886;3600000;0
50835;3391;60;0;0;0;0;.00nan;0;0
50968;1269;56;0;0;0;0;.00nan;0;0
50968;3756;57;87;28;1;27;.964;3600000;0
50968;5820;56;67;29;3;26;.897;3574000;0
50968;5889;57;0;0;0;0;.00nan;0;0
51279;294;50;0;0;0;0;.00nan;0;0
51279;889;62;56;27;4;23;.852;3554000;0
51279;1507;50;66;33;3;30;.909;3600000;0
51279;3066;62;0;0;0;0;.00nan;0;0
50860;1531;153;95;42;2;40;.952;3600000;0
50860;1852;153;0;0;0;0;.00nan;0;0
50860;1926;47;48;26;4;22;.846;3523000;0
50860;5740;47;0;0;0;0;.00nan;0;0
50894;864;33;0;0;0;0;.00nan;0;0
50894;1633;38;67;24;2;22;.917;3551000;0
50894;1835;33;78;28;1;27;.964;3600000;0
50894;6571;38;0;0;0;0;.00nan;0;0
51364;2746;32;0;0;0;0;.00nan;0;0
51364;3756;57;0;0;0;0;.00nan;0;0
51364;5889;57;77;31;2;29;.935;3600000;0
51364;5944;32;74;46;4;42;.913;3517000;0
50950;665;125;51;26;3;23;.885;3519000;0
50950;1044;43;75;27;1;26;.963;3600000;0
50950;1153;125;0;0;0;0;.00nan;0;0
50950;5949;43;0;0;0;0;.00nan;0;0
51111;889;62;0;0;0;0;.00nan;0;0
51111;977;40;72;39;3;36;.923;3600000;0
51111;3066;62;39;21;4;17;.810;3600000;0
51111;5923;40;0;0;0;0;.00nan;0;0
50874;2075;54;65;37;5;32;.865;3600000;0
50874;2689;54;0;0;0;0;.00nan;0;0
50874;3101;37;0;0;0;0;.00nan;0;0
50874;3395;37;94;27;1;26;.963;3600000;0
50958;930;55;53;27;4;23;.852;3900000;0
50958;1633;38;0;0;0;0;.00nan;0;0
50958;3319;55;0;0;0;0;.00nan;0;0
50958;6571;38;52;37;4;33;.892;3900000;0
50864;102;53;96;20;0;20;1.000;3600000;0
50864;958;53;0;0;0;0;.00nan;0;0
50864;2116;41;0;0;0;0;.00nan;0;0
50864;3028;41;91;37;1;36;.973;3583000;0
50837;294;50;0;0;0;0;.00nan;0;0
50837;526;59;0;0;0;0;.00nan;0;0
50837;892;59;91;47;3;44;.936;3600000;0
50837;1507;50;40;26;6;20;.769;3600000;0
50866;102;53;63;40;4;36;.900;3900000;0
50866;958;53;0;0;0;0;.00nan;0;0
50866;977;40;85;19;0;19;1.000;1706000;0
50866;5923;40;35;17;4;13;.765;2194000;0
50921;1531;153;0;0;0;0;.00nan;0;0
50921;1547;48;77;32;2;30;.938;2994000;0
50921;1852;153;60;23;3;20;.870;3600000;0
50921;1959;48;31;11;3;8;.727;576000;0
50877;8;44;0;0;0;0;.00nan;0;0
50877;2653;44;54;33;5;28;.848;3560000;0
50877;3101;37;88;41;3;38;.927;3600000;0
50877;3395;37;0;0;0;0;.00nan;0;0
50876;1264;58;84;29;1;28;.966;3600000;0
50876;2116;41;63;28;3;25;.893;3549000;0
50876;3028;41;0;0;0;0;.00nan;0;0
50876;5948;58;0;0;0;0;.00nan;0;0
50875;1926;47;74;34;3;31;.912;3600000;0
50875;2746;32;47;33;5;28;.848;3578000;0
50875;5740;47;0;0;0;0;.00nan;0;0
50875;5944;32;0;0;0;0;.00nan;0;0
51006;704;36;49;18;3;15;.833;3600000;0
51006;1893;36;0;0;0;0;.00nan;0;0
51006;3756;57;100;28;0;28;1.000;3600000;0
51006;5889;57;0;0;0;0;.00nan;0;0
50806;124;123;80;38;3;35;.921;3600000;0
50806;1919;34;40;42;7;35;.833;3600000;0
50806;2021;34;0;0;0;0;.00nan;0;0
50806;6493;123;0;0;0;0;.00nan;0;0
50897;294;50;58;27;3;24;.889;3537000;0
50897;1507;50;0;0;0;0;.00nan;0;0
50897;2075;54;0;0;0;0;.00nan;0;0
50897;2689;54;90;31;1;30;.968;3600000;0
51229;864;33;0;0;0;0;.00nan;0;0
51229;1269;56;0;0;0;0;.00nan;0;0
51229;1835;33;95;31;0;31;1.000;3900000;0
51229;5820;56;96;20;0;20;1.000;3900000;0
50963;665;125;61;31;4;27;.871;3615000;0
50963;1044;43;0;0;0;0;.00nan;0;0
50963;1153;125;0;0;0;0;.00nan;0;0
50963;5949;43;48;35;5;30;.857;3615000;0
50842;526;59;87;33;2;31;.939;3600000;0
50842;892;59;0;0;0;0;.00nan;0;0
50842;2921;60;42;25;4;21;.840;3525000;0
50842;3391;60;0;0;0;0;.00nan;0;0
51101;889;62;78;13;0;13;1.000;3600000;0
51101;1771;45;0;0;0;0;.00nan;0;0
51101;2115;45;81;36;2;34;.944;3600000;0
51101;3066;62;0;0;0;0;.00nan;0;0
50989;930;55;0;0;0;0;.00nan;0;0
50989;1547;48;0;0;0;0;.00nan;0;0
50989;1959;48;59;42;5;37;.881;3600000;0
50989;3319;55;70;20;2;18;.900;3600000;0
50879;8;44;0;0;0;0;.00nan;0;0
50879;704;36;57;32;4;28;.875;3557000;0
50879;1893;36;0;0;0;0;.00nan;0;0
50879;2653;44;80;29;2;27;.931;3600000;0
50878;102;53;64;31;3;28;.903;3516000;0
50878;889;62;82;23;1;22;.957;3600000;0
50878;958;53;0;0;0;0;.00nan;0;0
50878;3066;62;0;0;0;0;.00nan;0;0
50984;864;33;0;0;0;0;.00nan;0;0
50984;1835;33;90;20;0;20;1.000;3600000;0
50984;2746;32;74;26;1;25;.962;3550000;0
50984;5944;32;0;0;0;0;.00nan;0;0
50912;1264;58;38;35;6;29;.829;3536000;0
50912;1531;153;0;0;0;0;.00nan;0;0
50912;1852;153;81;46;4;42;.913;3600000;0
50912;5948;58;0;0;0;0;.00nan;0;0
50888;1633;38;0;0;0;0;.00nan;0;0
50888;1926;47;46;30;6;24;.800;2554000;0
50888;5740;47;38;7;2;5;.714;1046000;0
50888;6571;38;32;19;5;14;.737;3600000;0
51110;1771;45;0;0;0;0;.00nan;0;0
51110;2115;45;63;36;4;32;.889;3569000;0
51110;3756;57;82;31;2;29;.935;3600000;0
51110;5889;57;0;0;0;0;.00nan;0;0
50824;124;123;69;32;3;29;.906;3900000;0
50824;665;125;80;35;3;32;.914;3900000;0
50824;1153;125;0;0;0;0;.00nan;0;0
50824;6493;123;0;0;0;0;.00nan;0;0
50846;526;59;0;0;0;0;.00nan;0;0
50846;892;59;64;24;2;22;.917;3589000;0
50846;977;40;99;38;1;37;.974;3600000;0
50846;5923;40;0;0;0;0;.00nan;0;0
50987;1264;58;0;0;0;0;.00nan;0;0
50987;1633;38;83;32;2;30;.938;3549000;0
50987;5948;58;84;18;0;18;1.000;3600000;0
50987;6571;38;0;0;0;0;.00nan;0;0
50873;977;40;53;2;0;2;1.000;297000;0
50873;1919;34;62;35;4;31;.886;3600000;0
50873;2021;34;0;0;0;0;.00nan;0;0
50873;5923;40;63;44;6;38;.864;3295000;0
51290;294;50;0;0;0;0;.00nan;0;0
51290;526;59;68;49;5;44;.898;3600000;0
51290;892;59;0;0;0;0;.00nan;0;0
51290;1507;50;97;36;1;35;.972;3600000;0
51033;889;62;0;0;0;0;.00nan;0;0
51033;1547;48;0;0;0;0;.00nan;0;0
51033;1959;48;86;28;1;27;.964;3900000;0
51033;3066;62;81;34;1;33;.971;3900000;0
50839;124;123;0;0;0;0;.00nan;0;0
50839;2921;60;50;21;3;18;.857;3600000;0
50839;3391;60;0;0;0;0;.00nan;0;0
50839;6493;123;79;47;6;41;.872;3600000;0
50945;1269;56;0;0;0;0;.00nan;0;0
50945;2746;32;49;1;0;1;1.000;265000;0
50945;5820;56;47;27;5;22;.815;3600000;0
50945;5944;32;58;39;6;33;.846;3306000;0
50902;1926;47;0;0;0;0;.00nan;0;0
50902;3101;37;0;0;0;0;.00nan;0;0
50902;3395;37;70;40;5;35;.875;3900000;0
50902;5740;47;42;33;5;28;.848;3900000;0
50981;704;36;0;0;0;0;.00nan;0;0
50981;1044;43;77;19;1;18;.947;3600000;0
50981;1893;36;64;35;3;32;.914;3600000;0
50981;5949;43;0;0;0;0;.00nan;0;0
51115;930;55;84;36;2;34;.944;3600000;0
51115;2075;54;64;29;3;26;.897;3590000;0
51115;2689;54;0;0;0;0;.00nan;0;0
51115;3319;55;0;0;0;0;.00nan;0;0
51197;1269;56;80;27;1;26;.963;3600000;0
51197;1771;45;0;0;0;0;.00nan;0;0
51197;2115;45;69;28;2;26;.929;3546000;0
51197;5820;56;0;0;0;0;.00nan;0;0
50926;294;50;95;23;0;23;1.000;3600000;0
50926;1507;50;0;0;0;0;.00nan;0;0
50926;1531;153;0;0;0;0;.00nan;0;0
50926;1852;153;71;39;4;35;.897;3600000;0
50869;1831;57;0;0;0;0;.00nan;0;0
50869;1919;34;60;47;6;41;.872;3577000;0
50869;2021;34;0;0;0;0;.00nan;0;0
50869;5889;57;64;35;3;32;.914;3600000;0
50850;2116;41;0;0;0;0;.00nan;0;0
50850;2921;60;71;27;2;25;.926;3600000;0
50850;3028;41;64;38;4;34;.895;3572000;0
50850;3391;60;0;0;0;0;.00nan;0;0
50889;8;44;0;0;0;0;.00nan;0;0
50889;864;33;0;0;0;0;.00nan;0;0
50889;1835;33;95;31;1;30;.968;3600000;0
50889;2653;44;82;35;2;33;.943;3563000;0
50891;124;123;83;38;2;36;.947;3600000;0
50891;2075;54;75;30;2;28;.933;3559000;0
50891;2689;54;0;0;0;0;.00nan;0;0
50891;6493;123;0;0;0;0;.00nan;0;0
50903;102;53;95;36;2;34;.944;3600000;0
50903;665;125;36;22;4;18;.818;3588000;0
50903;958;53;0;0;0;0;.00nan;0;0
50903;1153;125;0;0;0;0;.00nan;0;0
50901;8;44;70;11;0;11;1.000;1548000;0
50901;1831;57;86;35;2;33;.943;3600000;0
50901;2653;44;23;22;7;15;.682;2052000;0
50901;5889;57;0;0;0;0;.00nan;0;0
51069;889;62;0;0;0;0;.00nan;0;0
51069;1531;153;0;0;0;0;.00nan;0;0
51069;1852;153;89;41;3;38;.927;3900000;0
51069;3066;62;90;44;3;41;.932;3900000;0
50898;2075;54;0;0;0;0;.00nan;0;0
50898;2116;41;44;12;2;10;.833;855000;0
50898;2689;54;56;35;4;31;.886;3600000;0
50898;3028;41;36;33;6;27;.818;2745000;0
50931;1771;45;0;0;0;0;.00nan;0;0
50931;1926;47;47;42;5;37;.881;3600000;0
50931;2115;45;86;33;1;32;.970;3600000;0
50931;5740;47;0;0;0;0;.00nan;0;0
50913;526;59;0;0;0;0;.00nan;0;0
50913;704;36;85;33;2;31;.939;3568000;0
50913;892;59;68;20;1;19;.950;3600000;0
50913;1893;36;0;0;0;0;.00nan;0;0
50947;294;50;72;31;4;27;.871;3600000;0
50947;864;33;0;0;0;0;.00nan;0;0
50947;1507;50;0;0;0;0;.00nan;0;0
50947;1835;33;91;26;1;25;.962;3600000;0
50868;977;40;93;37;2;35;.946;3600000;0
50868;2921;60;72;43;4;39;.907;3536000;0
50868;3391;60;0;0;0;0;.00nan;0;0
50868;5923;40;0;0;0;0;.00nan;0;0
51268;1547;48;43;7;2;5;.714;539000;0
51268;1959;48;32;30;6;24;.800;3061000;0
51268;2746;32;0;0;0;0;.00nan;0;0
51268;5944;32;61;23;3;20;.870;3600000;0
50885;1633;38;0;0;0;0;.00nan;0;0
50885;1919;34;55;39;5;34;.872;3575000;0
50885;2021;34;0;0;0;0;.00nan;0;0
50885;6571;38;58;26;4;22;.846;3600000;0
50992;1044;43;61;33;4;29;.879;3583000;0
50992;1269;56;0;0;0;0;.00nan;0;0
50992;5820;56;84;29;2;27;.931;3600000;0
50992;5949;43;0;0;0;0;.00nan;0;0
50990;930;55;85;32;2;30;.938;3600000;0
50990;3101;37;34;41;7;34;.829;3600000;0
50990;3319;55;0;0;0;0;.00nan;0;0
50990;3395;37;0;0;0;0;.00nan;0;0
50979;665;125;66;36;4;32;.889;3736000;0
50979;864;33;92;54;5;49;.907;3736000;0
50979;1153;125;0;0;0;0;.00nan;0;0
50979;1835;33;0;0;0;0;.00nan;0;0
50969;8;44;0;0;0;0;.00nan;0;0
50969;704;36;0;0;0;0;.00nan;0;0
50969;1893;36;66;35;4;31;.886;3600000;0
50969;2653;44;85;25;1;24;.960;3600000;0
51206;1269;56;98;34;1;33;.971;3600000;0
51206;1547;48;58;31;4;27;.871;3600000;0
51206;1959;48;0;0;0;0;.00nan;0;0
51206;5820;56;0;0;0;0;.00nan;0;0
50935;889;62;73;30;2;28;.933;3557000;0
50935;2116;41;88;29;1;28;.966;3600000;0
50935;3028;41;0;0;0;0;.00nan;0;0
50935;3066;62;0;0;0;0;.00nan;0;0
50905;124;123;49;30;5;25;.833;3600000;0
50905;2075;54;96;36;2;34;.944;3600000;0
50905;2689;54;0;0;0;0;.00nan;0;0
50905;6493;123;0;0;0;0;.00nan;0;0
51098;930;55;56;34;4;30;.882;3600000;0
51098;2746;32;0;0;0;0;.00nan;0;0
51098;3319;55;0;0;0;0;.00nan;0;0
51098;5944;32;84;35;3;32;.914;3600000;0
50923;977;40;91;37;2;35;.946;3900000;0
50923;1264;58;0;0;0;0;.00nan;0;0
50923;5923;40;0;0;0;0;.00nan;0;0
50923;5948;58;82;27;2;25;.926;3900000;0
50880;1831;57;0;0;0;0;.00nan;0;0
50880;2921;60;0;0;0;0;.00nan;0;0
50880;3391;60;72;23;1;22;.957;3600000;0
50880;5889;57;72;36;3;33;.917;3538000;0
50890;102;53;88;33;2;31;.939;3900000;0
50890;958;53;0;0;0;0;.00nan;0;0
50890;1919;34;96;37;2;35;.946;3900000;0
50890;2021;34;0;0;0;0;.00nan;0;0
50924;294;50;0;0;0;0;.00nan;0;0
50924;1507;50;64;32;4;28;.875;3553000;0
50924;1926;47;72;35;3;32;.914;3600000;0
50924;5740;47;0;0;0;0;.00nan;0;0
50884;526;59;93;35;1;34;.971;3600000;0
50884;892;59;0;0;0;0;.00nan;0;0
50884;1771;45;0;0;0;0;.00nan;0;0
50884;2115;45;54;29;4;25;.862;3600000;0
50871;102;53;0;0;0;0;.00nan;0;0
50871;124;123;0;0;0;0;.00nan;0;0
50871;958;53;91;46;3;43;.935;3600000;0
50871;6493;123;66;45;4;41;.911;3549000;0
51055;864;33;0;0;0;0;.00nan;0;0
51055;1835;33;93;41;1;40;.976;3600000;0
51055;3101;37;0;0;0;0;.00nan;0;0
51055;3395;37;79;34;2;32;.941;3574000;0
51099;1547;48;0;0;0;0;.00nan;0;0
51099;1959;48;71;27;2;25;.926;3600000;0
51099;2075;54;0;0;0;0;.00nan;0;0
51099;2689;54;88;47;3;44;.936;3600000;0
50904;1831;57;51;22;3;19;.864;3600000;0
50904;2116;41;0;0;0;0;.00nan;0;0
50904;3028;41;63;43;5;38;.884;3551000;0
50904;5889;57;0;0;0;0;.00nan;0;0
50980;1044;43;0;0;0;0;.00nan;0;0
50980;1926;47;72;31;4;27;.871;3559000;0
50980;5740;47;0;0;0;0;.00nan;0;0
50980;5949;43;68;29;2;27;.931;3600000;0
50939;977;40;0;0;0;0;.00nan;0;0
50939;1633;38;0;0;0;0;.00nan;0;0
50939;5923;40;83;28;1;27;.964;3600000;0
50939;6571;38;59;16;2;14;.875;3564000;0
50993;665;125;56;38;5;33;.868;3600000;0
50993;1153;125;0;0;0;0;.00nan;0;0
50993;1264;58;100;22;0;22;1.000;3600000;0
50993;5948;58;0;0;0;0;.00nan;0;0
50910;930;55;80;37;2;35;.946;3724000;0
50910;2921;60;73;31;3;28;.903;3724000;0
50910;3319;55;0;0;0;0;.00nan;0;0
50910;3391;60;0;0;0;0;.00nan;0;0
51071;889;62;0;0;0;0;.00nan;0;0
51071;3066;62;55;21;3;18;.857;3600000;0
51071;3101;37;78;41;4;37;.902;3600000;0
51071;3395;37;0;0;0;0;.00nan;0;0
50920;526;59;33;31;6;25;.806;2173000;0
50920;892;59;55;19;2;17;.895;1427000;0
50920;1269;56;0;0;0;0;.00nan;0;0
50920;5820;56;82;33;2;31;.939;3600000;0
50907;1531;153;0;0;0;0;.00nan;0;0
50907;1852;153;79;43;4;39;.907;3900000;0
50907;1919;34;68;34;4;30;.882;3900000;0
50907;2021;34;0;0;0;0;.00nan;0;0
50906;8;44;0;0;0;0;.00nan;0;0
50906;1044;43;30;31;6;25;.806;3600000;0
50906;2653;44;73;31;3;28;.903;3600000;0
50906;5949;43;0;0;0;0;.00nan;0;0
50965;294;50;0;0;0;0;.00nan;0;0
50965;1507;50;75;30;2;28;.933;3557000;0
50965;1633;38;78;28;1;27;.964;3600000;0
50965;6571;38;0;0;0;0;.00nan;0;0
50985;1531;153;67;40;4;36;.900;3600000;0
50985;1771;45;0;0;0;0;.00nan;0;0
50985;1852;153;0;0;0;0;.00nan;0;0
50985;2115;45;97;26;0;26;1.000;3600000;0
51297;704;36;70;44;5;39;.886;3600000;0
51297;1264;58;84;23;1;22;.957;3600000;0
51297;1893;36;0;0;0;0;.00nan;0;0
51297;5948;58;0;0;0;0;.00nan;0;0
50954;124;123;0;0;0;0;.00nan;0;0
50954;1044;43;63;21;2;19;.905;3600000;0
50954;5949;43;0;0;0;0;.00nan;0;0
50954;6493;123;58;35;5;30;.857;3600000;0
50977;2116;41;0;0;0;0;.00nan;0;0
50977;2746;32;0;0;0;0;.00nan;0;0
50977;3028;41;53;33;5;28;.848;3600000;0
50977;5944;32;100;34;0;34;1.000;3600000;0
50944;977;40;65;32;4;28;.875;3900000;0
50944;1547;48;0;0;0;0;.00nan;0;0
50944;1959;48;52;33;4;29;.879;3900000;0
50944;5923;40;0;0;0;0;.00nan;0;0
50991;1926;47;29;35;7;28;.800;3600000;0
50991;2075;54;76;40;4;36;.900;3600000;0
50991;2689;54;0;0;0;0;.00nan;0;0
50991;5740;47;0;0;0;0;.00nan;0;0
50998;1771;45;0;0;0;0;.00nan;0;0
50998;2115;45;43;34;5;29;.853;3600000;0
50998;3101;37;9;20;6;14;.700;2676000;0
50998;3395;37;46;7;1;6;.857;886000;0
50933;526;59;93;37;2;35;.946;3600000;0
50933;892;59;0;0;0;0;.00nan;0;0
50933;930;55;66;24;3;21;.875;3543000;0
50933;3319;55;0;0;0;0;.00nan;0;0
51051;889;62;0;0;0;0;.00nan;0;0
51051;2075;54;0;0;0;0;.00nan;0;0
51051;2689;54;84;48;4;44;.917;3593000;0
51051;3066;62;58;16;2;14;.875;3600000;0
50953;102;53;98;34;2;32;.941;3600000;0
50953;958;53;0;0;0;0;.00nan;0;0
50953;1269;56;0;0;0;0;.00nan;0;0
50953;5820;56;57;25;3;22;.880;3585000;0
50937;864;33;0;0;0;0;.00nan;0;0
50937;1835;33;69;29;3;26;.897;3600000;0
50937;2921;60;97;20;0;20;1.000;3600000;0
50937;3391;60;0;0;0;0;.00nan;0;0
50928;1531;153;0;0;0;0;.00nan;0;0
50928;1831;57;0;0;0;0;.00nan;0;0
50928;1852;153;79;32;2;30;.938;3600000;0
50928;5889;57;34;21;4;17;.810;3554000;0
51121;704;36;48;37;6;31;.838;3600000;0
51121;1264;58;100;24;0;24;1.000;3600000;0
51121;2845;36;0;0;0;0;.00nan;0;0
51121;5948;58;0;0;0;0;.00nan;0;0
50930;665;125;67;18;1;17;.944;3600000;0
50930;1153;125;0;0;0;0;.00nan;0;0
50930;1919;34;61;31;3;28;.903;3514000;0
50930;2021;34;0;0;0;0;.00nan;0;0
51023;294;50;0;0;0;0;.00nan;0;0
51023;1507;50;84;28;1;27;.964;3600000;0
51023;1633;38;52;34;6;28;.824;3600000;0
51023;6571;38;0;0;0;0;.00nan;0;0
51032;1926;47;0;0;0;0;.00nan;0;0
51032;3101;37;0;0;0;0;.00nan;0;0
51032;3395;37;40;36;6;30;.833;3600000;0
51032;5740;47;96;35;2;33;.943;3600000;0
50960;1044;43;0;0;0;0;.00nan;0;0
50960;2116;41;66;27;3;24;.889;3569000;0
50960;3028;41;0;0;0;0;.00nan;0;0
50960;5949;43;62;20;2;18;.900;3600000;0
50922;8;44;0;0;0;0;.00nan;0;0
50922;124;123;81;23;1;22;.957;3600000;0
50922;2653;44;17;26;6;20;.769;3600000;0
50922;6493;123;0;0;0;0;.00nan;0;0
50970;930;55;0;0;0;0;.00nan;0;0
50970;977;40;42;35;6;29;.829;3056000;0
50970;3319;55;59;23;3;20;.870;3600000;0
50970;5923;40;38;13;3;10;.769;544000;0
50917;526;59;0;0;0;0;.00nan;0;0
50917;892;59;82;30;1;29;.967;3600000;0
50917;1919;34;55;33;4;29;.879;3600000;0
50917;2021;34;0;0;0;0;.00nan;0;0
50964;1633;38;95;32;1;31;.969;3900000;0
50964;2921;60;93;29;1;28;.966;3900000;0
50964;3391;60;0;0;0;0;.00nan;0;0
50964;6571;38;0;0;0;0;.00nan;0;0
50949;8;44;0;0;0;0;.00nan;0;0
50949;1831;57;0;0;0;0;.00nan;0;0
50949;2653;44;88;41;3;38;.927;3661000;0
50949;5889;57;83;37;2;35;.946;3661000;0
50946;102;53;95;47;5;42;.894;3600000;0
50946;958;53;0;0;0;0;.00nan;0;0
50946;2746;32;0;0;0;0;.00nan;0;0
50946;5944;32;81;35;2;33;.943;3600000;0
51008;864;33;0;0;0;0;.00nan;0;0
51008;1531;153;0;0;0;0;.00nan;0;0
51008;1835;33;74;21;1;20;.952;3600000;0
51008;1852;153;39;45;7;38;.844;3600000;0
51114;889;62;0;0;0;0;.00nan;0;0
51114;1547;48;0;0;0;0;.00nan;0;0
51114;1959;48;79;38;3;35;.921;3600000;0
51114;3066;62;30;27;6;21;.778;3600000;0
50943;294;50;0;0;0;0;.00nan;0;0
50943;526;59;68;35;3;32;.914;3600000;0
50943;892;59;0;0;0;0;.00nan;0;0
50943;1507;50;94;18;0;18;1.000;3600000;0
51052;665;125;97;37;1;36;.973;3900000;0
51052;1153;125;0;0;0;0;.00nan;0;0
51052;1771;45;0;0;0;0;.00nan;0;0
51052;2115;45;100;32;1;31;.969;3900000;0
50941;1269;56;0;0;0;0;.00nan;0;0
50941;2116;41;0;0;0;0;.00nan;0;0
50941;3028;41;69;33;3;30;.909;3576000;0
50941;5820;56;78;27;1;26;.963;3600000;0
50951;1044;43;58;24;3;21;.875;3600000;0
50951;1919;34;61;36;4;32;.889;3556000;0
50951;2021;34;0;0;0;0;.00nan;0;0
50951;5949;43;0;0;0;0;.00nan;0;0
50975;665;125;0;0;0;0;.00nan;0;0
50975;1153;125;80;39;3;36;.923;3600000;0
50975;1633;38;0;0;0;0;.00nan;0;0
50975;6571;38;76;28;2;26;.929;3600000;0
50919;1264;58;37;28;5;23;.821;3600000;0
50919;2921;60;0;0;0;0;.00nan;0;0
50919;3391;60;100;40;1;39;.975;3600000;0
50919;5948;58;0;0;0;0;.00nan;0;0
51035;1531;153;0;0;0;0;.00nan;0;0
51035;1852;153;63;39;5;34;.872;3583000;0
51035;3101;37;55;32;4;28;.875;3600000;0
51035;3395;37;0;0;0;0;.00nan;0;0
50938;8;44;0;0;0;0;.00nan;0;0
50938;102;53;0;0;0;0;.00nan;0;0
50938;958;53;84;30;2;28;.933;3600000;0
50938;2653;44;51;40;5;35;.875;3600000;0
51107;864;33;65;25;2;23;.920;3600000;0
51107;1835;33;0;0;0;0;.00nan;0;0
51107;1926;47;79;45;4;41;.911;3600000;0
51107;5740;47;0;0;0;0;.00nan;0;0
51012;704;36;26;6;3;3;.500;324000;0
51012;1831;57;72;26;2;24;.923;3600000;0
51012;2845;36;86;33;1;32;.970;3256000;0
51012;5889;57;0;0;0;0;.00nan;0;0
50929;124;123;96;45;3;42;.933;3594000;0
50929;930;55;77;22;1;21;.955;3600000;0
50929;3319;55;0;0;0;0;.00nan;0;0
50929;6493;123;0;0;0;0;.00nan;0;0
51194;889;62;91;26;0;26;1.000;3600000;0
51194;2746;32;73;31;3;28;.903;3600000;0
51194;3066;62;0;0;0;0;.00nan;0;0
51194;5944;32;0;0;0;0;.00nan;0;0
50974;977;40;99;52;2;50;.962;3600000;0
50974;1264;58;48;25;4;21;.840;3516000;0
50974;5923;40;0;0;0;0;.00nan;0;0
50974;5948;58;0;0;0;0;.00nan;0;0
51116;704;36;67;44;4;40;.909;3600000;0
51116;1771;45;0;0;0;0;.00nan;0;0
51116;2115;45;44;28;5;23;.821;3544000;0
51116;2845;36;0;0;0;0;.00nan;0;0
51126;1547;48;0;0;0;0;.00nan;0;0
51126;1959;48;47;42;6;36;.857;3600000;0
51126;2075;54;94;27;1;26;.963;3600000;0
51126;2689;54;0;0;0;0;.00nan;0;0
51018;294;50;0;0;0;0;.00nan;0;0
51018;1269;56;0;0;0;0;.00nan;0;0
51018;1507;50;54;33;4;29;.879;3551000;0
51018;5820;56;88;29;2;27;.931;3600000;0
50988;977;40;97;46;2;44;.957;3900000;0
50988;1531;153;0;0;0;0;.00nan;0;0
50988;1852;153;83;23;2;21;.913;3900000;0
50988;5923;40;0;0;0;0;.00nan;0;0
50966;124;123;47;37;6;31;.838;2719000;0
50966;1831;57;0;0;0;0;.00nan;0;0
50966;5889;57;76;19;1;18;.947;3600000;0
50966;6493;123;40;8;2;6;.750;881000;0
50972;1919;34;91;36;2;34;.944;3600000;0
50972;2021;34;0;0;0;0;.00nan;0;0
50972;2746;32;0;0;0;0;.00nan;0;0
50972;5944;32;56;31;4;27;.871;3531000;0
51016;526;59;0;0;0;0;.00nan;0;0
51016;864;33;0;0;0;0;.00nan;0;0
51016;892;59;88;47;3;44;.936;3600000;0
51016;1835;33;87;17;0;17;1.000;3600000;0
51009;1264;58;58;25;4;21;.840;3600000;0
51009;1926;47;71;43;5;38;.884;3554000;0
51009;5740;47;0;0;0;0;.00nan;0;0
51009;5948;58;0;0;0;0;.00nan;0;0
51040;2075;54;63;36;5;31;.861;3612000;0
51040;2689;54;0;0;0;0;.00nan;0;0
51040;3101;37;51;30;4;26;.867;3657000;0
51040;3395;37;0;0;0;0;.00nan;0;0
51004;8;44;0;0;0;0;.00nan;0;0
51004;1771;45;0;0;0;0;.00nan;0;0
51004;2115;45;87;32;2;30;.938;3600000;0
51004;2653;44;78;39;3;36;.923;3560000;0
51057;1547;48;0;0;0;0;.00nan;0;0
51057;1831;57;100;22;0;22;1.000;3600000;0
51057;1959;48;80;43;4;39;.907;3600000;0
51057;5889;57;0;0;0;0;.00nan;0;0
51003;704;36;89;50;4;46;.920;3600000;0
51003;1044;43;87;32;1;31;.969;3600000;0
51003;2845;36;0;0;0;0;.00nan;0;0
51003;5949;43;0;0;0;0;.00nan;0;0
51056;1633;38;89;38;3;35;.921;3559000;0
51056;2746;32;84;36;2;34;.944;3600000;0
51056;5944;32;0;0;0;0;.00nan;0;0
51056;6571;38;0;0;0;0;.00nan;0;0
51001;8;44;0;0;0;0;.00nan;0;0
51001;294;50;0;0;0;0;.00nan;0;0
51001;1507;50;15;23;7;16;.696;3600000;0
51001;2653;44;89;34;2;32;.941;3600000;0
51074;930;55;80;26;1;25;.962;3600000;0
51074;1531;153;0;0;0;0;.00nan;0;0
51074;1852;153;70;34;3;31;.912;3580000;0
51074;3319;55;0;0;0;0;.00nan;0;0
51109;1269;56;0;0;0;0;.00nan;0;0
51109;3101;37;0;0;0;0;.00nan;0;0
51109;3395;37;99;39;1;38;.974;3600000;0
51109;5820;56;59;19;2;17;.895;3549000;0
50976;665;125;98;27;1;26;.963;3600000;0
50976;977;40;0;0;0;0;.00nan;0;0
50976;1153;125;0;0;0;0;.00nan;0;0
50976;5923;40;80;48;4;44;.917;3600000;0
51031;889;62;85;23;1;22;.957;3600000;0
51031;1919;34;62;35;4;31;.886;3600000;0
51031;2021;34;0;0;0;0;.00nan;0;0
51031;3066;62;0;0;0;0;.00nan;0;0
50961;526;59;39;26;5;21;.808;3600000;0
50961;892;59;0;0;0;0;.00nan;0;0
50961;1926;47;0;0;0;0;.00nan;0;0
50961;5740;47;93;47;1;46;.979;3600000;0
51005;1044;43;0;0;0;0;.00nan;0;0
51005;1264;58;76;24;1;23;.958;3600000;0
51005;5948;58;0;0;0;0;.00nan;0;0
51005;5949;43;70;39;3;36;.923;3600000;0
50955;102;53;28;7;3;4;.571;485000;0
50955;864;33;0;0;0;0;.00nan;0;0
50955;958;53;98;39;1;38;.974;3115000;0
50955;1835;33;100;34;0;34;1.000;3600000;0
51199;665;125;92;40;2;38;.950;3600000;0
51199;1153;125;0;0;0;0;.00nan;0;0
51199;2075;54;70;30;3;27;.900;3566000;0
51199;2689;54;0;0;0;0;.00nan;0;0
51022;8;44;0;0;0;0;.00nan;0;0
51022;1926;47;89;49;2;47;.959;3587000;0
51022;2653;44;81;18;1;17;.944;3600000;0
51022;5740;47;0;0;0;0;.00nan;0;0
51030;704;36;85;37;2;35;.946;3600000;0
51030;1831;57;57;11;1;10;.909;3600000;0
51030;2845;36;0;0;0;0;.00nan;0;0
51030;5889;57;0;0;0;0;.00nan;0;0
51168;930;55;95;38;1;37;.974;3600000;0
51168;2746;32;0;0;0;0;.00nan;0;0
51168;3319;55;0;0;0;0;.00nan;0;0
51168;5944;32;83;38;2;36;.947;3600000;0
51045;889;62;0;0;0;0;.00nan;0;0
51045;1919;34;58;48;6;42;.875;3600000;0
51045;2021;34;0;0;0;0;.00nan;0;0
51045;3066;62;71;24;2;22;.917;3600000;0
50996;102;53;66;30;3;27;.900;3555000;0
50996;958;53;0;0;0;0;.00nan;0;0
50996;977;40;81;38;2;36;.947;3600000;0
50996;5923;40;0;0;0;0;.00nan;0;0
51020;294;50;0;0;0;0;.00nan;0;0
51020;1269;56;0;0;0;0;.00nan;0;0
51020;1507;50;61;32;4;28;.875;3600000;0
51020;5820;56;41;29;5;24;.828;3582000;0
50986;1264;58;0;0;0;0;.00nan;0;0
50986;2921;60;44;24;5;19;.792;3514000;0
50986;3391;60;0;0;0;0;.00nan;0;0
50986;5948;58;88;39;3;36;.923;3600000;0
50994;124;123;82;40;2;38;.950;3900000;0
50994;2116;41;56;18;2;16;.889;3900000;0
50994;3028;41;0;0;0;0;.00nan;0;0
50994;6493;123;0;0;0;0;.00nan;0;0
50957;526;59;0;0;0;0;.00nan;0;0
50957;864;33;0;0;0;0;.00nan;0;0
50957;892;59;80;32;3;29;.906;3557000;0
50957;1835;33;99;45;2;43;.956;3600000;0
51017;1633;38;92;24;0;24;1.000;3600000;0
51017;1771;45;0;0;0;0;.00nan;0;0
51017;2115;45;73;38;4;34;.895;3600000;0
51017;6571;38;0;0;0;0;.00nan;0;0
51233;1269;56;79;33;2;31;.939;3615000;0
51233;2075;54;0;0;0;0;.00nan;0;0
51233;2689;54;70;36;3;33;.917;3615000;0
51233;5820;56;0;0;0;0;.00nan;0;0
51029;294;50;62;29;3;26;.897;3517000;0
51029;1507;50;0;0;0;0;.00nan;0;0
51029;1531;153;0;0;0;0;.00nan;0;0
51029;1852;153;97;43;1;42;.977;3600000;0
50978;1547;48;0;0;0;0;.00nan;0;0
50978;1959;48;48;43;7;36;.837;3600000;0
50978;2921;60;0;0;0;0;.00nan;0;0
50978;3391;60;84;23;1;22;.957;3600000;0
51075;704;36;59;35;3;32;.914;3900000;0
51075;930;55;0;0;0;0;.00nan;0;0
51075;1893;36;0;0;0;0;.00nan;0;0
51075;3319;55;66;30;3;27;.900;3900000;0
51048;889;62;85;37;2;35;.946;3600000;0
51048;1633;38;42;14;3;11;.786;3566000;0
51048;3066;62;0;0;0;0;.00nan;0;0
51048;6571;38;0;0;0;0;.00nan;0;0
51093;665;125;0;0;0;0;.00nan;0;0
51093;1153;125;75;43;5;38;.884;3600000;0
51093;1771;45;70;25;2;23;.920;3600000;0
51093;2115;45;0;0;0;0;.00nan;0;0
51026;8;44;0;0;0;0;.00nan;0;0
51026;1547;48;70;31;3;28;.903;3600000;0
51026;1959;48;0;0;0;0;.00nan;0;0
51026;2653;44;57;38;5;33;.868;3516000;0
50971;124;123;44;29;5;24;.828;3600000;0
50971;2116;41;0;0;0;0;.00nan;0;0
50971;3028;41;63;20;2;18;.900;3600000;0
50971;6493;123;0;0;0;0;.00nan;0;0
51024;102;53;28;10;3;7;.700;534000;0
51024;958;53;87;32;1;31;.969;3027000;0
51024;1044;43;80;35;3;32;.914;3600000;0
51024;5949;43;0;0;0;0;.00nan;0;0
50967;2921;60;78;31;2;29;.935;3553000;0
50967;3101;37;100;36;0;36;1.000;3600000;0
50967;3391;60;0;0;0;0;.00nan;0;0
50967;3395;37;0;0;0;0;.00nan;0;0
51143;889;62;0;0;0;0;.00nan;0;0
51143;2075;54;62;27;3;24;.889;3544000;0
51143;2689;54;0;0;0;0;.00nan;0;0
51143;3066;62;83;35;2;33;.943;3600000;0
51144;1831;57;0;0;0;0;.00nan;0;0
51144;2746;32;0;0;0;0;.00nan;0;0
51144;5889;57;80;27;1;26;.963;3600000;0
51144;5944;32;74;38;3;35;.921;3514000;0
51025;102;53;99;33;1;32;.970;3600000;0
51025;124;123;0;0;0;0;.00nan;0;0
51025;958;53;0;0;0;0;.00nan;0;0
51025;6493;123;71;32;3;29;.906;3541000;0
51113;1531;153;0;0;0;0;.00nan;0;0
51113;1852;153;53;20;3;17;.850;3600000;0
51113;3101;37;64;42;4;38;.905;3600000;0
51113;3395;37;0;0;0;0;.00nan;0;0
51015;1264;58;71;21;1;20;.952;3600000;0
51015;2116;41;58;31;3;28;.903;3516000;0
51015;3028;41;0;0;0;0;.00nan;0;0
51015;5948;58;0;0;0;0;.00nan;0;0
51000;977;40;20;21;6;15;.714;1585000;0
51000;1547;48;0;0;0;0;.00nan;0;0
51000;1959;48;47;30;5;25;.833;3600000;0
51000;5923;40;66;17;1;16;.941;1938000;0
51037;102;53;0;0;0;0;.00nan;0;0
51037;124;123;68;45;6;39;.867;3721000;0
51037;958;53;54;35;5;30;.857;3726000;0
51037;6493;123;0;0;0;0;.00nan;0;0
50995;294;50;42;3;1;2;.667;543000;0
50995;1507;50;30;34;7;27;.794;3057000;0
50995;2921;60;63;38;4;34;.895;3600000;0
50995;3391;60;0;0;0;0;.00nan;0;0
51164;1269;56;0;0;0;0;.00nan;0;0
51164;1633;38;100;47;2;45;.957;3600000;0
51164;5820;56;59;24;3;21;.875;3570000;0
51164;6571;38;0;0;0;0;.00nan;0;0
51087;1044;43;79;35;3;32;.914;3600000;0
51087;1926;47;73;38;4;34;.895;3573000;0
51087;5740;47;0;0;0;0;.00nan;0;0
51087;5949;43;0;0;0;0;.00nan;0;0
51002;8;44;0;0;0;0;.00nan;0;0
51002;665;125;75;28;3;25;.893;3577000;0
51002;1153;125;0;0;0;0;.00nan;0;0
51002;2653;44;93;40;2;38;.950;3600000;0
51027;864;33;0;0;0;0;.00nan;0;0
51027;1835;33;81;34;3;31;.912;3900000;0
51027;1919;34;85;43;3;40;.930;3900000;0
51027;2021;34;0;0;0;0;.00nan;0;0
51019;526;59;100;32;0;32;1.000;3600000;0
51019;892;59;0;0;0;0;.00nan;0;0
51019;1919;34;0;0;0;0;.00nan;0;0
51019;2021;34;57;30;4;26;.867;3600000;0
51147;864;33;64;33;3;30;.909;3600000;0
51147;1835;33;0;0;0;0;.00nan;0;0
51147;2075;54;92;28;1;27;.964;3600000;0
51147;2689;54;0;0;0;0;.00nan;0;0
51136;1269;56;88;32;1;31;.969;3900000;0
51136;1633;38;0;0;0;0;.00nan;0;0
51136;5820;56;0;0;0;0;.00nan;0;0
51136;6571;38;74;24;1;23;.958;3900000;0
51007;665;125;67;41;5;36;.878;3600000;0
51007;1153;125;0;0;0;0;.00nan;0;0
51007;2921;60;68;38;4;34;.895;3600000;0
51007;3391;60;0;0;0;0;.00nan;0;0
51038;8;44;0;0;0;0;.00nan;0;0
51038;1771;45;0;0;0;0;.00nan;0;0
51038;2115;45;100;34;0;34;1.000;3600000;0
51038;2653;44;82;40;3;37;.925;3600000;0
51013;1044;43;73;29;3;26;.897;3595000;0
51013;1264;58;73;28;2;26;.929;3600000;0
51013;5948;58;0;0;0;0;.00nan;0;0
51013;5949;43;0;0;0;0;.00nan;0;0
51077;889;62;0;0;0;0;.00nan;0;0
51077;930;55;81;25;2;23;.920;3600000;0
51077;3066;62;95;51;3;48;.941;3553000;0
51077;3319;55;0;0;0;0;.00nan;0;0
51084;124;123;66;34;4;30;.882;3600000;0
51084;2746;32;0;0;0;0;.00nan;0;0
51084;5944;32;56;36;5;31;.861;3600000;0
51084;6493;123;0;0;0;0;.00nan;0;0
51175;1926;47;88;32;2;30;.938;3012000;0
51175;3101;37;67;31;3;28;.903;3600000;0
51175;3395;37;0;0;0;0;.00nan;0;0
51175;5740;47;32;8;3;5;.625;539000;0
51034;294;50;0;0;0;0;.00nan;0;0
51034;1507;50;96;26;0;26;1.000;3600000;0
51034;2116;41;91;25;1;24;.960;3555000;0
51034;3028;41;0;0;0;0;.00nan;0;0
51060;294;50;0;0;0;0;.00nan;0;0
51060;1507;50;84;31;3;28;.903;3900000;0
51060;2746;32;88;44;3;41;.932;3900000;0
51060;5944;32;0;0;0;0;.00nan;0;0
51165;1633;38;51;36;5;31;.861;3600000;0
51165;1831;57;0;0;0;0;.00nan;0;0
51165;5889;57;79;33;2;31;.939;3600000;0
51165;6571;38;0;0;0;0;.00nan;0;0
51011;977;40;22;25;6;19;.760;2581000;0
51011;2116;41;0;0;0;0;.00nan;0;0
51011;3028;41;57;32;3;29;.906;3600000;0
51011;5923;40;57;8;0;8;1.000;1019000;0
51021;526;59;78;32;2;30;.938;3600000;0
51021;665;125;61;34;5;29;.853;2519000;0
51021;892;59;0;0;0;0;.00nan;0;0
51021;1153;125;19;9;4;5;.556;1081000;0
51183;704;36;76;41;4;37;.902;3600000;0
51183;930;55;72;21;1;20;.952;3600000;0
51183;1893;36;0;0;0;0;.00nan;0;0
51183;3319;55;0;0;0;0;.00nan;0;0
51044;8;44;83;33;2;31;.939;3600000;0
51044;1531;153;0;0;0;0;.00nan;0;0
51044;1852;153;53;22;3;19;.864;3545000;0
51044;2653;44;0;0;0;0;.00nan;0;0
51010;889;62;69;31;3;28;.903;3557000;0
51010;2921;60;0;0;0;0;.00nan;0;0
51010;3066;62;0;0;0;0;.00nan;0;0
51010;3391;60;85;32;2;30;.938;3600000;0
51043;1547;48;0;0;0;0;.00nan;0;0
51043;1919;34;87;28;1;27;.964;3600000;0
51043;1959;48;46;23;4;19;.826;3600000;0
51043;2021;34;0;0;0;0;.00nan;0;0
51162;864;33;0;0;0;0;.00nan;0;0
51162;1835;33;34;28;6;22;.786;3600000;0
51162;1926;47;85;33;2;31;.939;3600000;0
51162;5740;47;0;0;0;0;.00nan;0;0
51072;1044;43;0;0;0;0;.00nan;0;0
51072;2075;54;69;23;2;21;.913;3600000;0
51072;2689;54;0;0;0;0;.00nan;0;0
51072;5949;43;89;31;1;30;.968;3600000;0
51028;526;59;0;0;0;0;.00nan;0;0
51028;892;59;53;27;4;23;.852;3600000;0
51028;977;40;0;0;0;0;.00nan;0;0
51028;5923;40;34;24;5;19;.792;3591000;0
51286;704;36;0;0;0;0;.00nan;0;0
51286;1771;45;0;0;0;0;.00nan;0;0
51286;1893;36;74;36;3;33;.917;3573000;0
51286;2115;45;73;29;2;27;.931;3600000;0
51042;958;53;0;0;0;0;.00nan;0;0
51042;1681;53;79;47;4;43;.915;3600000;0
51042;1831;57;0;0;0;0;.00nan;0;0
51042;5889;57;66;16;1;15;.938;3600000;0
51118;1531;153;0;0;0;0;.00nan;0;0
51118;1547;48;0;0;0;0;.00nan;0;0
51118;1852;153;64;27;3;24;.889;3516000;0
51118;1959;48;79;24;1;23;.958;3600000;0
51186;1269;56;0;0;0;0;.00nan;0;0
51186;3101;37;59;14;1;13;.929;1488000;0
51186;3395;37;40;35;6;29;.829;2112000;0
51186;5820;56;84;27;1;26;.963;3600000;0
51036;930;55;34;30;6;24;.800;3600000;0
51036;1264;58;78;40;3;37;.925;3600000;0
51036;3319;55;0;0;0;0;.00nan;0;0
51036;5948;58;0;0;0;0;.00nan;0;0
51085;1264;58;0;0;0;0;.00nan;0;0
51085;1919;34;100;43;1;42;.977;3900000;0
51085;2021;34;0;0;0;0;.00nan;0;0
51085;5948;58;71;19;1;18;.947;3900000;0
51173;1633;38;50;28;4;24;.857;3563000;0
51173;2116;41;0;0;0;0;.00nan;0;0
51173;3028;41;67;27;3;24;.889;3600000;0
51173;6571;38;0;0;0;0;.00nan;0;0
51082;864;33;0;0;0;0;.00nan;0;0
51082;1044;43;56;30;4;26;.867;3600000;0
51082;1835;33;98;29;1;28;.966;3600000;0
51082;5949;43;0;0;0;0;.00nan;0;0
51262;1269;56;87;17;0;17;1.000;3600000;0
51262;1926;47;75;32;2;30;.938;3524000;0
51262;5740;47;0;0;0;0;.00nan;0;0
51262;5820;56;0;0;0;0;.00nan;0;0
51054;930;55;88;38;2;36;.947;3728000;0
51054;977;40;78;34;3;31;.912;3728000;0
51054;3319;55;0;0;0;0;.00nan;0;0
51054;5923;40;0;0;0;0;.00nan;0;0
51064;526;59;90;51;4;47;.922;3600000;0
51064;892;59;0;0;0;0;.00nan;0;0
51064;2746;32;0;0;0;0;.00nan;0;0
51064;5944;32;54;36;5;31;.861;3567000;0
51047;8;44;0;0;0;0;.00nan;0;0
51047;1831;57;81;24;1;23;.958;3600000;0
51047;2653;44;84;41;4;37;.902;3600000;0
51047;5889;57;0;0;0;0;.00nan;0;0
51049;977;40;0;0;0;0;.00nan;0;0
51049;1771;45;0;0;0;0;.00nan;0;0
51049;2115;45;80;33;3;30;.909;3600000;0
51049;5923;40;67;40;5;35;.875;3523000;0
51058;294;50;0;0;0;0;.00nan;0;0
51058;1507;50;75;20;1;19;.950;3600000;0
51058;1919;34;0;0;0;0;.00nan;0;0
51058;2021;34;71;38;4;34;.895;3600000;0
51073;526;59;0;0;0;0;.00nan;0;0
51073;892;59;61;25;3;22;.880;3600000;0
51073;3101;37;56;36;5;31;.861;3544000;0
51073;3395;37;0;0;0;0;.00nan;0;0
51119;864;33;68;40;4;36;.900;3600000;0
51119;1531;153;0;0;0;0;.00nan;0;0
51119;1835;33;0;0;0;0;.00nan;0;0
51119;1852;153;93;24;0;24;1.000;3600000;0
51124;124;123;0;0;0;0;.00nan;0;0
51124;889;62;0;0;0;0;.00nan;0;0
51124;3066;62;74;25;2;23;.920;3545000;0
51124;6493;123;99;36;1;35;.972;3600000;0
51246;704;36;71;32;4;28;.875;3600000;0
51246;1893;36;0;0;0;0;.00nan;0;0
51246;1926;47;57;37;5;32;.865;3544000;0
51246;5740;47;0;0;0;0;.00nan;0;0
51090;958;53;46;6;1;5;.833;691000;0
51090;1547;48;55;36;4;32;.889;3600000;0
51090;1681;53;22;22;6;16;.727;2909000;0
51090;1959;48;0;0;0;0;.00nan;0;0
51039;665;125;64;33;4;29;.879;3600000;0
51039;1044;43;0;0;0;0;.00nan;0;0
51039;1153;125;0;0;0;0;.00nan;0;0
51039;5949;43;86;25;1;24;.960;3600000;0
51216;1637;54;0;0;0;0;.00nan;0;0
51216;2075;54;99;25;0;25;1.000;3600000;0
51216;3101;37;0;0;0;0;.00nan;0;0
51216;3395;37;54;33;4;29;.879;3600000;0
51063;294;50;37;11;3;8;.727;567000;0
51063;1507;50;55;17;2;15;.882;3033000;0
51063;2746;32;100;29;0;29;1.000;3600000;0
51063;5944;32;0;0;0;0;.00nan;0;0
51062;930;55;74;26;2;24;.923;3600000;0
51062;2921;60;66;33;3;30;.909;3582000;0
51062;3319;55;0;0;0;0;.00nan;0;0
51062;3391;60;0;0;0;0;.00nan;0;0
51053;8;44;0;0;0;0;.00nan;0;0
51053;1633;38;85;25;1;24;.960;3900000;0
51053;2653;44;97;28;1;27;.964;3900000;0
51053;6571;38;0;0;0;0;.00nan;0;0
51083;526;59;66;30;3;27;.900;3600000;0
51083;892;59;0;0;0;0;.00nan;0;0
51083;1926;47;28;48;10;38;.792;3321000;0
51083;5740;47;55;5;0;5;1.000;279000;0
51050;930;55;68;31;4;27;.871;3900000;0
51050;1919;34;59;30;4;26;.867;3900000;0
51050;2021;34;0;0;0;0;.00nan;0;0
51050;3319;55;0;0;0;0;.00nan;0;0
51196;1531;153;57;7;0;7;1.000;1231000;0
51196;1637;54;0;0;0;0;.00nan;0;0
51196;1852;153;40;28;5;23;.821;2369000;0
51196;2075;54;68;28;3;25;.893;3600000;0
51041;8;44;78;26;1;25;.962;3600000;0
51041;665;125;90;53;5;48;.906;3600000;0
51041;1153;125;0;0;0;0;.00nan;0;0
51041;2653;44;0;0;0;0;.00nan;0;0
51066;704;36;64;35;4;31;.886;3600000;0
51066;977;40;100;35;0;35;1.000;3600000;0
51066;1893;36;0;0;0;0;.00nan;0;0
51066;5923;40;0;0;0;0;.00nan;0;0
51130;958;53;70;34;3;31;.912;3900000;0
51130;1681;53;0;0;0;0;.00nan;0;0
51130;2921;60;0;0;0;0;.00nan;0;0
51130;3391;60;66;30;3;27;.900;3900000;0
51386;889;62;78;32;3;29;.906;3600000;0
51386;2116;41;0;0;0;0;.00nan;0;0
51386;3028;41;70;43;4;39;.907;3600000;0
51386;3066;62;0;0;0;0;.00nan;0;0
51171;1547;48;0;0;0;0;.00nan;0;0
51171;1771;45;0;0;0;0;.00nan;0;0
51171;1959;48;46;30;5;25;.833;3600000;0
51171;2115;45;98;41;2;39;.951;3600000;0
51097;1264;58;68;51;5;46;.902;3600000;0
51097;1831;57;0;0;0;0;.00nan;0;0
51097;5889;57;65;26;2;24;.923;3600000;0
51097;5948;58;0;0;0;0;.00nan;0;0
51271;2116;41;72;23;2;21;.913;3600000;0
51271;3028;41;0;0;0;0;.00nan;0;0
51271;3101;37;0;0;0;0;.00nan;0;0
51271;3395;37;43;47;7;40;.851;3600000;0
51065;294;50;0;0;0;0;.00nan;0;0
51065;1507;50;61;31;4;27;.871;3708000;0
51065;1547;48;75;37;5;32;.865;3708000;0
51065;1959;48;0;0;0;0;.00nan;0;0
51059;665;125;18;22;6;16;.727;1318000;0
51059;1153;125;67;31;3;28;.903;2282000;0
51059;1831;57;69;22;2;20;.909;3600000;0
51059;5889;57;0;0;0;0;.00nan;0;0
51117;958;53;0;0;0;0;.00nan;0;0
51117;1681;53;66;38;4;34;.895;3600000;0
51117;2746;32;65;14;1;13;.929;3600000;0
51117;5944;32;0;0;0;0;.00nan;0;0
51106;1264;58;0;0;0;0;.00nan;0;0
51106;1633;38;54;35;4;31;.886;3516000;0
51106;5948;58;57;17;2;15;.882;3600000;0
51106;6571;38;0;0;0;0;.00nan;0;0
51128;124;123;0;0;0;0;.00nan;0;0
51128;704;36;0;0;0;0;.00nan;0;0
51128;1893;36;71;40;4;36;.900;3600000;0
51128;6493;123;46;18;3;15;.833;3600000;0
51185;889;62;0;0;0;0;.00nan;0;0
51185;1531;153;49;32;5;27;.844;3801000;0
51185;1852;153;0;0;0;0;.00nan;0;0
51185;3066;62;72;34;4;30;.882;3801000;0
51014;1044;43;0;0;0;0;.00nan;0;0
51014;2921;60;95;48;3;45;.938;3600000;0
51014;3391;60;0;0;0;0;.00nan;0;0
51014;5949;43;53;28;4;24;.857;3552000;0
51159;124;123;100;39;2;37;.949;3900000;0
51159;864;33;0;0;0;0;.00nan;0;0
51159;1835;33;75;33;2;31;.939;3900000;0
51159;6493;123;0;0;0;0;.00nan;0;0
51191;1637;54;0;0;0;0;.00nan;0;0
51191;1771;45;0;0;0;0;.00nan;0;0
51191;2075;54;46;26;5;21;.808;3600000;0
51191;2115;45;100;42;1;41;.976;3600000;0
51088;8;44;0;0;0;0;.00nan;0;0
51088;930;55;62;23;2;21;.913;3600000;0
51088;2653;44;63;28;3;25;.893;3600000;0
51088;3319;55;0;0;0;0;.00nan;0;0
51133;665;125;72;45;5;40;.889;3600000;0
51133;1153;125;0;0;0;0;.00nan;0;0
51133;1831;57;0;0;0;0;.00nan;0;0
51133;5889;57;77;24;2;22;.917;3600000;0
51141;704;36;94;42;2;40;.952;3600000;0
51141;958;53;0;0;0;0;.00nan;0;0
51141;1681;53;66;30;3;27;.900;3526000;0
51141;1893;36;0;0;0;0;.00nan;0;0
51131;1637;54;46;36;6;30;.833;3600000;0
51131;1798;60;0;0;0;0;.00nan;0;0
51131;2075;54;0;0;0;0;.00nan;0;0
51131;2921;60;80;27;1;26;.963;3600000;0
51129;1264;58;79;34;3;31;.912;3600000;0
51129;2116;41;0;0;0;0;.00nan;0;0
51129;3028;41;52;35;5;30;.857;3600000;0
51129;5948;58;0;0;0;0;.00nan;0;0
51245;889;62;52;24;3;21;.875;3579000;0
51245;2746;32;96;36;1;35;.972;3600000;0
51245;3066;62;0;0;0;0;.00nan;0;0
51245;5944;32;0;0;0;0;.00nan;0;0
51155;526;59;86;34;1;33;.971;3600000;0
51155;892;59;0;0;0;0;.00nan;0;0
51155;930;55;86;30;2;28;.933;3550000;0
51155;3319;55;0;0;0;0;.00nan;0;0
51096;1044;43;76;30;2;28;.933;3600000;0
51096;1547;48;0;0;0;0;.00nan;0;0
51096;1959;48;70;32;3;29;.906;3593000;0
51096;5949;43;0;0;0;0;.00nan;0;0
51264;864;33;0;0;0;0;.00nan;0;0
51264;1835;33;57;32;5;27;.844;3550000;0
51264;2746;32;0;0;0;0;.00nan;0;0
51264;5944;32;53;27;3;24;.889;3600000;0
51167;1633;38;46;32;5;27;.844;3600000;0
51167;1798;60;0;0;0;0;.00nan;0;0
51167;2921;60;87;26;1;25;.962;3600000;0
51167;6571;38;0;0;0;0;.00nan;0;0
51076;294;50;0;0;0;0;.00nan;0;0
51076;1507;50;34;22;5;17;.773;3600000;0
51076;3101;37;75;29;2;27;.931;3600000;0
51076;3395;37;0;0;0;0;.00nan;0;0
51068;8;44;100;38;0;38;1.000;3600000;0
51068;704;36;0;0;0;0;.00nan;0;0
51068;1893;36;87;26;1;25;.962;3543000;0
51068;2653;44;0;0;0;0;.00nan;0;0
51127;1264;58;0;0;0;0;.00nan;0;0
51127;1771;45;0;0;0;0;.00nan;0;0
51127;2115;45;41;32;6;26;.813;3593000;0
51127;5948;58;47;37;5;32;.865;3600000;0
51108;665;125;0;0;0;0;.00nan;0;0
51108;1153;125;66;30;3;27;.900;3600000;0
51108;1531;153;0;0;0;0;.00nan;0;0
51108;1852;153;33;32;6;26;.813;3600000;0
51091;1919;34;65;31;4;27;.871;3600000;0
51091;2021;34;0;0;0;0;.00nan;0;0
51091;2116;41;81;35;3;32;.914;3600000;0
51091;3028;41;0;0;0;0;.00nan;0;0
51146;1831;57;69;29;3;26;.897;3600000;0
51146;1926;47;0;0;0;0;.00nan;0;0
51146;5740;47;69;40;4;36;.900;3575000;0
51146;5889;57;0;0;0;0;.00nan;0;0
51298;1547;48;81;40;4;36;.900;3900000;0
51298;1959;48;0;0;0;0;.00nan;0;0
51298;3101;37;0;0;0;0;.00nan;0;0
51298;3395;37;66;39;4;35;.897;3900000;0
51092;977;40;69;42;4;38;.905;3555000;0
51092;1633;38;0;0;0;0;.00nan;0;0
51092;5923;40;0;0;0;0;.00nan;0;0
51092;6571;38;65;28;3;25;.893;3600000;0
51094;1044;43;0;0;0;0;.00nan;0;0
51094;1771;45;70;30;2;28;.933;3595000;0
51094;2115;45;0;0;0;0;.00nan;0;0
51094;5949;43;97;21;0;21;1.000;3600000;0
51389;124;123;0;0;0;0;.00nan;0;0
51389;2116;41;0;0;0;0;.00nan;0;0
51389;3028;41;80;25;1;24;.960;3600000;0
51389;6493;123;70;32;2;30;.938;3600000;0
51067;665;125;72;38;3;35;.921;3575000;0
51067;1153;125;0;0;0;0;.00nan;0;0
51067;1264;58;72;21;1;20;.952;3600000;0
51067;5948;58;0;0;0;0;.00nan;0;0
51149;958;53;0;0;0;0;.00nan;0;0
51149;1681;53;47;19;3;16;.842;3548000;0
51149;1926;47;64;21;2;19;.905;3600000;0
51149;5740;47;0;0;0;0;.00nan;0;0
51078;294;50;0;0;0;0;.00nan;0;0
51078;1507;50;45;31;5;26;.839;3559000;0
51078;1919;34;52;25;4;21;.840;3600000;0
51078;2021;34;0;0;0;0;.00nan;0;0
51179;1637;54;0;0;0;0;.00nan;0;0
51179;1831;57;0;0;0;0;.00nan;0;0
51179;2075;54;94;27;1;26;.963;3600000;0
51179;5889;57;71;36;3;33;.917;3518000;0
51089;526;59;67;31;5;26;.839;3598000;0
51089;892;59;0;0;0;0;.00nan;0;0
51089;1269;56;78;35;3;32;.914;3600000;0
51089;5820;56;0;0;0;0;.00nan;0;0
51095;889;62;0;0;0;0;.00nan;0;0
51095;977;40;100;40;0;40;1.000;3600000;0
51095;3066;62;83;41;3;38;.927;3600000;0
51095;5923;40;0;0;0;0;.00nan;0;0
51112;930;55;78;33;2;31;.939;3594000;0
51112;1919;34;0;0;0;0;.00nan;0;0
51112;2021;34;93;35;1;34;.971;3600000;0
51112;3319;55;0;0;0;0;.00nan;0;0
51157;704;36;49;36;6;30;.833;3340000;0
51157;1531;153;0;0;0;0;.00nan;0;0
51157;1852;153;83;34;2;32;.941;3600000;0
51157;1893;36;51;2;0;2;1.000;260000;0
51176;1433;38;0;0;0;0;.00nan;0;0
51176;1547;48;0;0;0;0;.00nan;0;0
51176;1633;38;80;35;3;32;.914;3600000;0
51176;1959;48;64;35;4;31;.886;3600000;0
51182;124;123;70;39;4;35;.897;3827000;0
51182;1798;60;0;0;0;0;.00nan;0;0
51182;2921;60;58;23;3;20;.870;3827000;0
51182;6493;123;0;0;0;0;.00nan;0;0
51218;864;33;0;0;0;0;.00nan;0;0
51218;1835;33;53;24;3;21;.875;3600000;0
51218;1926;47;96;44;2;42;.955;3600000;0
51218;5740;47;0;0;0;0;.00nan;0;0
51132;294;50;0;0;0;0;.00nan;0;0
51132;1507;50;66;26;2;24;.923;3559000;0
51132;1637;54;0;0;0;0;.00nan;0;0
51132;2075;54;97;29;1;28;.966;3600000;0
51248;526;59;51;32;4;28;.875;3900000;0
51248;864;33;81;37;4;33;.892;3900000;0
51248;892;59;0;0;0;0;.00nan;0;0
51248;1835;33;0;0;0;0;.00nan;0;0
51142;958;53;74;38;3;35;.921;3600000;0
51142;1681;53;0;0;0;0;.00nan;0;0
51142;1771;45;0;0;0;0;.00nan;0;0
51142;2115;45;57;33;4;29;.879;3544000;0
51120;977;40;66;34;4;30;.882;3517000;0
51120;1531;153;0;0;0;0;.00nan;0;0
51120;1852;153;100;41;2;39;.951;3600000;0
51120;5923;40;0;0;0;0;.00nan;0;0
51086;8;44;65;35;4;31;.886;3560000;0
51086;1269;56;0;0;0;0;.00nan;0;0
51086;2653;44;0;0;0;0;.00nan;0;0
51086;5820;56;77;26;2;24;.923;3600000;0
51235;1269;56;60;24;3;21;.875;3600000;0
51235;2746;32;57;37;5;32;.865;3544000;0
51235;5820;56;0;0;0;0;.00nan;0;0
51235;5944;32;0;0;0;0;.00nan;0;0
51100;889;62;0;0;0;0;.00nan;0;0
51100;1044;43;0;0;0;0;.00nan;0;0
51100;3066;62;84;37;2;35;.946;3600000;0
51100;5949;43;41;29;5;24;.828;3600000;0
51305;526;59;28;6;3;3;.500;209000;0
51305;892;59;90;25;0;25;1.000;3391000;0
51305;1547;48;24;36;8;28;.778;3600000;0
51305;1959;48;0;0;0;0;.00nan;0;0
51158;958;53;56;5;0;5;1.000;677000;0
51158;1681;53;35;31;6;25;.806;2923000;0
51158;2116;41;0;0;0;0;.00nan;0;0
51158;3028;41;65;26;3;23;.885;3600000;0
51102;8;44;0;0;0;0;.00nan;0;0
51102;1433;38;0;0;0;0;.00nan;0;0
51102;1633;38;74;20;1;19;.950;3600000;0
51102;2653;44;70;31;3;28;.903;3580000;0
51178;889;62;47;36;5;31;.861;3600000;0
51178;930;55;74;27;2;25;.926;3600000;0
51178;3066;62;0;0;0;0;.00nan;0;0
51178;3319;55;0;0;0;0;.00nan;0;0
51265;1531;153;0;0;0;0;.00nan;0;0
51265;1852;153;46;38;6;32;.842;3600000;0
51265;2746;32;0;0;0;0;.00nan;0;0
51265;5944;32;100;31;0;31;1.000;3600000;0
51150;294;50;0;0;0;0;.00nan;0;0
51150;1507;50;80;29;2;27;.931;3544000;0
51150;1926;47;85;25;1;24;.960;3600000;0
51150;5740;47;0;0;0;0;.00nan;0;0
51184;665;125;44;37;6;31;.838;3513000;0
51184;1153;125;0;0;0;0;.00nan;0;0
51184;3101;37;0;0;0;0;.00nan;0;0
51184;3395;37;57;29;4;25;.862;3600000;0
51125;1637;54;0;0;0;0;.00nan;0;0
51125;1919;34;36;20;4;16;.800;1045000;0
51125;2021;34;74;33;3;30;.909;2555000;0
51125;2075;54;89;32;1;31;.969;3600000;0
51181;124;123;35;33;6;27;.818;3566000;0
51181;1771;45;0;0;0;0;.00nan;0;0
51181;2115;45;75;38;4;34;.895;3600000;0
51181;6493;123;0;0;0;0;.00nan;0;0
51397;1926;47;41;38;5;33;.868;3600000;0
51397;2845;57;0;0;0;0;.00nan;0;0
51397;5701;57;60;24;2;22;.917;3600000;0
51397;5740;47;0;0;0;0;.00nan;0;0
51399;1331;123;0;0;0;0;.00nan;0;0
51399;2771;37;0;0;0;0;.00nan;0;0
51399;3028;37;75;38;3;35;.921;3572000;0
51399;3251;123;77;21;1;20;.952;3600000;0
51401;813;36;89;35;2;33;.943;3600000;0
51401;863;36;0;0;0;0;.00nan;0;0
51401;1637;54;0;0;0;0;.00nan;0;0
51401;3188;54;46;30;5;25;.833;3600000;0
51403;1614;58;63;20;2;18;.900;3600000;0
51403;3066;62;75;39;3;36;.923;3600000;0
51403;3343;62;0;0;0;0;.00nan;0;0
51403;5948;58;0;0;0;0;.00nan;0;0
51405;1639;34;0;0;0;0;.00nan;0;0
51405;3240;55;55;32;4;28;.875;3600000;0
51405;3319;55;0;0;0;0;.00nan;0;0
51405;6545;34;46;36;5;31;.861;3578000;0
51407;666;45;0;0;0;0;.00nan;0;0
51407;1130;33;0;0;0;0;.00nan;0;0
51407;1666;45;76;43;4;39;.907;3600000;0
51407;2130;33;44;30;5;25;.833;3543000;0
51409;167;48;0;0;0;0;.00nan;0;0
51409;1959;48;65;32;4;28;.875;3600000;0
51409;2116;41;55;40;5;35;.875;3558000;0
51409;2770;41;0;0;0;0;.00nan;0;0
51411;737;50;0;0;0;0;.00nan;0;0
51411;1784;56;86;33;1;32;.970;3600000;0
51411;3391;50;63;31;3;28;.903;3554000;0
51411;5820;56;0;0;0;0;.00nan;0;0
51413;458;44;0;0;0;0;.00nan;0;0
51413;864;153;92;40;2;38;.950;3900000;0
51413;1815;44;77;27;2;25;.926;3900000;0
51413;2921;153;0;0;0;0;.00nan;0;0
51415;1955;43;0;0;0;0;.00nan;0;0
51415;2499;40;99;43;2;41;.953;3600000;0
51415;5923;40;0;0;0;0;.00nan;0;0
51415;5949;43;52;37;5;32;.865;3600000;0
51417;457;32;91;48;3;45;.938;3900000;0
51417;1731;59;0;0;0;0;.00nan;0;0
51417;1798;32;0;0;0;0;.00nan;0;0
51417;2115;59;62;26;3;23;.885;3900000;0
51419;1351;38;54;14;1;13;.929;1355000;0
51419;1371;60;72;38;4;34;.895;3600000;0
51419;2104;60;0;0;0;0;.00nan;0;0
51419;2976;38;1;13;7;6;.462;2245000;0
51421;102;53;0;0;0;0;.00nan;0;0
51421;1897;125;27;15;4;11;.733;614000;0
51421;2720;125;56;23;3;20;.870;2986000;0
51421;5430;53;100;24;0;24;1.000;3600000;0
51423;1955;43;0;0;0;0;.00nan;0;0
51423;2771;37;0;0;0;0;.00nan;0;0
51423;3028;37;42;32;5;27;.844;3600000;0
51423;5949;43;54;19;2;17;.895;3600000;0
51425;102;53;0;0;0;0;.00nan;0;0
51425;2116;41;0;0;0;0;.00nan;0;0
51425;2770;41;100;23;0;23;1.000;3600000;0
51425;5430;53;38;18;4;14;.778;3600000;0
51427;666;45;0;0;0;0;.00nan;0;0
51427;1531;153;0;0;0;0;.00nan;0;0
51427;1666;45;91;29;1;28;.966;3600000;0
51427;2921;153;57;30;3;27;.900;3577000;0
51429;1351;38;0;0;0;0;.00nan;0;0
51429;1639;34;0;0;0;0;.00nan;0;0
51429;2976;38;52;18;2;16;.889;3594000;0
51429;6545;34;90;31;1;30;.968;3600000;0
51431;167;48;0;0;0;0;.00nan;0;0
51431;1959;48;62;28;2;26;.929;3600000;0
51431;2499;40;0;0;0;0;.00nan;0;0
51431;5923;40;63;32;3;29;.906;3557000;0
51433;1637;54;0;0;0;0;.00nan;0;0
51433;1897;125;71;43;4;39;.907;3600000;0
51433;2720;125;0;0;0;0;.00nan;0;0
51433;3188;54;70;18;1;17;.944;3600000;0
51435;813;36;85;50;3;47;.940;3600000;0
51435;863;36;0;0;0;0;.00nan;0;0
51435;1784;56;0;0;0;0;.00nan;0;0
51435;5820;56;100;23;0;23;1.000;3600000;0
51437;457;32;69;27;2;25;.926;3600000;0
51437;1614;58;0;0;0;0;.00nan;0;0
51437;1798;32;0;0;0;0;.00nan;0;0
51437;5948;58;47;21;3;18;.857;3562000;0
51439;458;44;0;0;0;0;.00nan;0;0
51439;1815;44;100;37;1;36;.973;3900000;0
51439;3240;55;0;0;0;0;.00nan;0;0
51439;3319;55;80;20;1;19;.950;3900000;0
51441;737;50;87;31;1;30;.968;3600000;0
51441;1926;47;59;22;2;20;.909;3566000;0
51441;3391;50;0;0;0;0;.00nan;0;0
51441;5740;47;0;0;0;0;.00nan;0;0
51443;1331;123;0;0;0;0;.00nan;0;0
51443;3066;62;61;21;2;19;.905;3600000;0
51443;3251;123;78;45;4;41;.911;3600000;0
51443;3343;62;0;0;0;0;.00nan;0;0
51445;1371;60;73;31;2;29;.935;3557000;0
51445;2104;60;0;0;0;0;.00nan;0;0
51445;2845;57;62;11;1;10;.909;3600000;0
51445;5701;57;0;0;0;0;.00nan;0;0
51447;1130;33;0;0;0;0;.00nan;0;0
51447;1731;59;0;0;0;0;.00nan;0;0
51447;2115;59;37;19;4;15;.789;3545000;0
51447;2130;33;93;46;3;43;.935;3600000;0
51449;1784;56;0;0;0;0;.00nan;0;0
51449;2845;57;0;0;0;0;.00nan;0;0
51449;5701;57;68;17;1;16;.941;3600000;0
51449;5820;56;68;34;3;31;.912;3584000;0
51451;167;48;75;27;2;25;.926;3600000;0
51451;1130;33;62;38;4;34;.895;3553000;0
51451;1959;48;0;0;0;0;.00nan;0;0
51451;2130;33;0;0;0;0;.00nan;0;0
51453;1331;123;59;30;3;27;.900;3600000;0
51453;2116;41;0;0;0;0;.00nan;0;0
51453;2770;41;52;49;7;42;.857;3600000;0
51453;3251;123;0;0;0;0;.00nan;0;0
51455;1731;59;47;28;4;24;.857;3600000;0
51455;2115;59;0;0;0;0;.00nan;0;0
51455;2499;40;84;31;1;30;.968;3600000;0
51455;5923;40;0;0;0;0;.00nan;0;0
51457;1531;153;49;29;4;25;.862;3581000;0
51457;2921;153;0;0;0;0;.00nan;0;0
51457;3240;55;57;22;3;19;.864;3600000;0
51457;3319;55;0;0;0;0;.00nan;0;0
51459;1351;38;91;33;1;32;.970;3600000;0
51459;1614;58;80;30;2;28;.933;3548000;0
51459;2976;38;0;0;0;0;.00nan;0;0
51459;5948;58;0;0;0;0;.00nan;0;0
51461;457;32;0;0;0;0;.00nan;0;0
51461;1371;60;0;0;0;0;.00nan;0;0
51461;1798;32;53;19;3;16;.842;3600000;0
51461;2104;60;54;35;4;31;.886;3581000;0
51463;737;50;44;5;1;4;.800;1343000;0
51463;813;36;0;0;0;0;.00nan;0;0
51463;863;36;54;25;4;21;.840;3600000;0
51463;3391;50;40;21;4;17;.810;2249000;0
51465;666;45;76;27;1;26;.963;3600000;0
51465;1666;45;0;0;0;0;.00nan;0;0
51465;1955;43;78;36;3;33;.917;3530000;0
51465;5949;43;0;0;0;0;.00nan;0;0
51467;1926;47;0;0;0;0;.00nan;0;0
51467;2771;37;85;38;2;36;.947;3900000;0
51467;3028;37;0;0;0;0;.00nan;0;0
51467;5740;47;67;26;2;24;.923;3900000;0
51469;1637;54;72;21;1;20;.952;3869000;0
51469;1897;125;0;0;0;0;.00nan;0;0
51469;2720;125;86;40;2;38;.950;3869000;0
51469;3188;54;0;0;0;0;.00nan;0;0
51471;102;53;98;39;3;36;.923;3600000;0
51471;1639;34;44;34;6;28;.824;3600000;0
51471;5430;53;0;0;0;0;.00nan;0;0
51471;6545;34;0;0;0;0;.00nan;0;0
51473;458;44;59;33;4;29;.879;3600000;0
51473;1815;44;0;0;0;0;.00nan;0;0
51473;3066;62;0;0;0;0;.00nan;0;0
51473;3343;62;100;44;1;43;.977;3600000;0
51475;1955;43;0;0;0;0;.00nan;0;0
51475;2771;37;0;0;0;0;.00nan;0;0
51475;3028;37;50;38;5;33;.868;3900000;0
51475;5949;43;47;29;5;24;.828;3900000;0
51477;167;48;0;0;0;0;.00nan;0;0
51477;1926;47;73;21;1;20;.952;3600000;0
51477;1959;48;72;29;2;27;.931;3600000;0
51477;5740;47;0;0;0;0;.00nan;0;0
51479;813;36;54;34;4;30;.882;3600000;0
51479;863;36;0;0;0;0;.00nan;0;0
51479;3240;55;71;28;3;25;.893;3600000;0
51479;3319;55;0;0;0;0;.00nan;0;0
51481;457;32;0;0;0;0;.00nan;0;0
51481;737;50;49;32;5;27;.844;3600000;0
51481;2746;32;74;23;2;21;.913;3600000;0
51481;3391;50;0;0;0;0;.00nan;0;0
51483;1371;60;0;0;0;0;.00nan;0;0
51483;2104;60;66;32;3;29;.906;3544000;0
51483;2499;40;0;0;0;0;.00nan;0;0
51483;5923;40;94;40;2;38;.950;3600000;0
51485;1531;153;0;0;0;0;.00nan;0;0
51485;1897;125;0;0;0;0;.00nan;0;0
51485;2720;125;74;22;1;21;.955;3600000;0
51485;2921;153;62;21;2;19;.905;3575000;0
51487;102;53;0;0;0;0;.00nan;0;0
51487;1784;56;0;0;0;0;.00nan;0;0
51487;5430;53;71;18;1;17;.944;3600000;0
51487;5820;56;93;43;2;41;.953;3600000;0
51489;526;59;0;0;0;0;.00nan;0;0
51489;1637;54;0;0;0;0;.00nan;0;0
51489;2115;59;50;24;4;20;.833;3556000;0
51489;3188;54;71;32;3;29;.906;3600000;0
51491;1130;33;0;0;0;0;.00nan;0;0
51491;2130;33;53;43;6;37;.860;3600000;0
51491;2845;57;100;29;0;29;1.000;3600000;0
51491;5701;57;0;0;0;0;.00nan;0;0
51493;458;44;0;0;0;0;.00nan;0;0
51493;1639;34;0;0;0;0;.00nan;0;0
51493;1815;44;50;25;3;22;.880;3900000;0
51493;6545;34;74;37;3;34;.919;3900000;0
51495;1331;123;100;22;0;22;1.000;3600000;0
51495;1614;58;0;0;0;0;.00nan;0;0
51495;3251;123;0;0;0;0;.00nan;0;0
51495;5948;58;77;34;3;31;.912;3600000;0
51497;1351;38;0;0;0;0;.00nan;0;0
51497;2116;41;0;0;0;0;.00nan;0;0
51497;2770;41;23;45;9;36;.800;3600000;0
51497;2976;38;43;19;4;15;.789;3600000;0
51499;666;45;0;0;0;0;.00nan;0;0
51499;1666;45;81;37;2;35;.946;3900000;0
51499;3066;62;98;37;2;35;.946;3900000;0
51499;3343;62;0;0;0;0;.00nan;0;0
51501;102;53;98;19;0;19;1.000;3600000;0
51501;737;50;0;0;0;0;.00nan;0;0
51501;3391;50;71;21;1;20;.952;3600000;0
51501;5430;53;0;0;0;0;.00nan;0;0
51503;457;32;33;20;4;16;.800;3598000;0
51503;1351;38;82;31;2;29;.935;3600000;0
51503;2746;32;0;0;0;0;.00nan;0;0
51503;2976;38;0;0;0;0;.00nan;0;0
51505;167;48;78;37;3;34;.919;3600000;0
51505;1614;58;45;27;4;23;.852;3578000;0
51505;1959;48;0;0;0;0;.00nan;0;0
51505;5948;58;0;0;0;0;.00nan;0;0
51507;1639;34;70;26;2;24;.923;3600000;0
51507;1897;125;66;34;4;30;.882;3582000;0
51507;2720;125;0;0;0;0;.00nan;0;0
51507;6545;34;0;0;0;0;.00nan;0;0
51509;526;59;50;19;3;16;.842;3600000;0
51509;1371;60;43;36;6;30;.833;3600000;0
51509;2104;60;0;0;0;0;.00nan;0;0
51509;2115;59;0;0;0;0;.00nan;0;0
51511;2116;41;68;25;2;23;.920;3600000;0
51511;2689;54;0;0;0;0;.00nan;0;0
51511;2770;41;0;0;0;0;.00nan;0;0
51511;3188;54;53;24;3;21;.875;3545000;0
51513;666;45;60;34;4;30;.882;3571000;0
51513;1666;45;0;0;0;0;.00nan;0;0
51513;3066;62;0;0;0;0;.00nan;0;0
51513;3343;62;67;26;3;23;.885;3600000;0
51515;2499;40;43;36;6;30;.833;3600000;0
51515;2771;37;60;24;3;21;.875;3600000;0
51515;3028;37;0;0;0;0;.00nan;0;0
51515;5923;40;0;0;0;0;.00nan;0;0
51517;1331;123;41;32;6;26;.813;3600000;0
51517;1955;43;88;35;1;34;.971;3600000;0
51517;3251;123;0;0;0;0;.00nan;0;0
51517;5949;43;0;0;0;0;.00nan;0;0
51519;1130;33;63;18;1;17;.944;3600000;0
51519;1531;153;64;39;4;35;.897;3600000;0
51519;2130;33;0;0;0;0;.00nan;0;0
51519;2921;153;0;0;0;0;.00nan;0;0
51521;813;36;0;0;0;0;.00nan;0;0
51521;863;36;91;30;1;29;.967;3600000;0
51521;1815;44;0;0;0;0;.00nan;0;0
51521;2653;44;47;20;3;17;.850;3546000;0
51523;2845;57;44;32;4;28;.875;3900000;0
51523;3240;55;0;0;0;0;.00nan;0;0
51523;3319;55;61;31;4;27;.871;3900000;0
51523;5701;57;0;0;0;0;.00nan;0;0
51525;1784;56;64;23;2;21;.913;3600000;0
51525;1926;47;0;0;0;0;.00nan;0;0
51525;5740;47;52;43;6;37;.860;3600000;0
51525;5820;56;0;0;0;0;.00nan;0;0
51527;666;45;0;0;0;0;.00nan;0;0
51527;1371;60;65;28;2;26;.929;3600000;0
51527;1666;45;83;34;3;31;.912;3564000;0
51527;2104;60;0;0;0;0;.00nan;0;0
51529;737;50;75;30;3;27;.900;3529000;0
51529;864;153;0;0;0;0;.00nan;0;0
51529;2921;153;77;23;2;21;.913;3600000;0
51529;3391;50;0;0;0;0;.00nan;0;0
51531;3066;62;100;31;0;31;1.000;3600000;0
51531;3240;55;0;0;0;0;.00nan;0;0
51531;3319;55;83;33;1;32;.970;3544000;0
51531;3343;62;0;0;0;0;.00nan;0;0
51533;1784;56;73;13;0;13;1.000;865000;0
51533;2689;54;35;17;4;13;.765;3600000;0
51533;3188;54;0;0;0;0;.00nan;0;0
51533;5820;56;40;35;6;29;.829;2692000;0
51535;1614;58;0;0;0;0;.00nan;0;0
51535;2845;57;0;0;0;0;.00nan;0;0
51535;3756;57;51;20;3;17;.850;3600000;0
51535;5948;58;51;37;5;32;.865;3522000;0
51537;1351;38;0;0;0;0;.00nan;0;0
51537;2116;41;0;0;0;0;.00nan;0;0
51537;2770;41;47;37;5;32;.865;3582000;0
51537;2976;38;53;23;3;20;.870;3600000;0
51539;813;36;85;26;1;25;.962;3551000;0
51539;863;36;0;0;0;0;.00nan;0;0
51539;1130;33;0;0;0;0;.00nan;0;0
51539;2130;33;100;34;0;34;1.000;3600000;0
51541;124;123;85;35;2;33;.943;3900000;0
51541;1835;123;0;0;0;0;.00nan;0;0
51541;2771;37;89;36;2;34;.944;3900000;0
51541;3028;37;0;0;0;0;.00nan;0;0
51543;1926;47;100;31;0;31;1.000;3600000;0
51543;2499;40;0;0;0;0;.00nan;0;0
51543;5740;47;0;0;0;0;.00nan;0;0
51543;5923;40;76;32;1;31;.969;3593000;0
51545;526;59;59;9;1;8;.889;3600000;0
51545;1897;125;59;50;6;44;.880;3311000;0
51545;2115;59;0;0;0;0;.00nan;0;0
51545;2720;125;51;2;0;2;1.000;289000;0
51547;102;53;99;41;2;39;.951;3600000;0
51547;1955;43;0;0;0;0;.00nan;0;0
51547;5430;53;0;0;0;0;.00nan;0;0
51547;5949;43;63;29;3;26;.897;3600000;0
51549;457;32;0;0;0;0;.00nan;0;0
51549;1639;34;0;0;0;0;.00nan;0;0
51549;2746;32;59;35;4;31;.886;3513000;0
51549;6545;34;66;25;2;23;.920;3600000;0
51551;8;44;45;27;5;22;.815;3600000;0
51551;167;48;0;0;0;0;.00nan;0;0
51551;1959;48;93;42;2;40;.952;3600000;0
51551;2653;44;0;0;0;0;.00nan;0;0
51553;457;32;0;0;0;0;.00nan;0;0
51553;666;45;0;0;0;0;.00nan;0;0
51553;1666;45;68;40;4;36;.900;3600000;0
51553;2746;32;63;24;2;22;.917;3600000;0
51555;1371;60;63;28;2;26;.929;3547000;0
51555;2104;60;0;0;0;0;.00nan;0;0
51555;2771;37;0;0;0;0;.00nan;0;0
51555;3028;37;74;27;1;26;.963;3600000;0
51557;124;123;0;0;0;0;.00nan;0;0
51557;1835;123;82;25;1;24;.960;3600000;0
51557;3240;55;0;0;0;0;.00nan;0;0
51557;3319;55;68;26;3;23;.885;3551000;0
51559;1130;33;48;9;1;8;.889;854000;0
51559;2130;33;34;33;6;27;.818;2746000;0
51559;2845;57;0;0;0;0;.00nan;0;0
51559;3756;57;74;33;3;30;.909;3600000;0
51561;102;53;0;0;0;0;.00nan;0;0
51561;167;48;0;0;0;0;.00nan;0;0
51561;1959;48;96;52;0;52;1.000;3900000;0
51561;5430;53;100;28;0;28;1.000;3900000;0
51563;526;59;0;0;0;0;.00nan;0;0
51563;2115;59;74;21;2;19;.905;3600000;0
51563;2499;40;0;0;0;0;.00nan;0;0
51563;5923;40;52;24;3;21;.875;3581000;0
51565;8;44;0;0;0;0;.00nan;0;0
51565;1897;125;0;0;0;0;.00nan;0;0
51565;2653;44;69;27;2;25;.926;3600000;0
51565;2720;125;74;52;5;47;.904;3600000;0
51567;1926;47;78;31;2;29;.935;3600000;0
51567;2116;41;41;34;6;28;.824;3600000;0
51567;2770;41;0;0;0;0;.00nan;0;0
51567;5740;47;0;0;0;0;.00nan;0;0
51569;813;36;59;34;4;30;.882;3594000;0
51569;863;36;0;0;0;0;.00nan;0;0
51569;1614;58;65;22;2;20;.909;3600000;0
51569;5948;58;0;0;0;0;.00nan;0;0
51571;2689;54;70;36;4;32;.889;3600000;0
51571;3066;62;69;45;5;40;.889;3594000;0
51571;3188;54;0;0;0;0;.00nan;0;0
51571;3343;62;0;0;0;0;.00nan;0;0
51573;737;50;61;29;3;26;.897;3600000;0
51573;1351;38;0;0;0;0;.00nan;0;0
51573;2976;38;59;21;2;19;.905;3600000;0
51573;3391;50;0;0;0;0;.00nan;0;0
51575;864;153;0;0;0;0;.00nan;0;0
51575;1955;43;0;0;0;0;.00nan;0;0
51575;2921;153;100;43;3;40;.930;3867000;0
51575;5949;43;61;35;3;32;.914;3900000;0
51577;1639;34;0;0;0;0;.00nan;0;0
51577;1784;56;82;32;2;30;.938;3600000;0
51577;5820;56;0;0;0;0;.00nan;0;0
51577;6545;34;50;20;3;17;.850;3544000;0
44415;6687;87;64;30;3;27;.900;3741000;0
44415;7717;87;0;0;0;0;.00nan;0;0
44415;8104;92;0;0;0;0;.00nan;0;0
44415;8107;92;86;47;2;45;.957;3741000;0
44416;7762;90;58;56;7;49;.875;3600000;0
44416;8103;93;66;21;2;19;.905;3600000;0
44416;8320;93;0;0;0;0;.00nan;0;0
44416;9227;90;0;0;0;0;.00nan;0;0
44417;7155;86;48;44;6;38;.864;3334000;0
44417;7218;99;0;0;0;0;.00nan;0;0
44417;7227;99;45;10;2;8;.800;3600000;0
44417;8322;86;52;4;0;4;1.000;266000;0
44418;6581;98;0;0;0;0;.00nan;0;0
44418;7115;88;77;21;1;20;.952;3600000;0
44418;7163;98;27;33;7;26;.788;3600000;0
44418;8165;88;0;0;0;0;.00nan;0;0
44419;7218;99;54;34;4;30;.882;3600000;0
44419;7227;99;0;0;0;0;.00nan;0;0
44419;7716;89;40;34;5;29;.853;3543000;0
44419;9226;89;0;0;0;0;.00nan;0;0
44420;7164;101;81;25;1;24;.960;3600000;0
44420;7654;97;0;0;0;0;.00nan;0;0
44420;7666;97;41;40;6;34;.850;3600000;0
44420;8236;101;0;0;0;0;.00nan;0;0
44421;6731;95;84;13;0;13;1.000;3600000;0
44421;7075;96;73;38;3;35;.921;3600000;0
44421;7735;96;0;0;0;0;.00nan;0;0
44421;8168;95;0;0;0;0;.00nan;0;0
44422;6663;85;0;0;0;0;.00nan;0;0
44422;6687;87;48;46;6;40;.870;3600000;0
44422;7142;85;75;13;0;13;1.000;3600000;0
44422;7717;87;0;0;0;0;.00nan;0;0
44423;7091;94;0;0;0;0;.00nan;0;0
44423;7211;103;33;9;3;6;.667;3600000;0
44423;8101;94;85;59;4;55;.932;3600000;0
44423;8220;103;0;0;0;0;.00nan;0;0
44424;6683;91;0;0;0;0;.00nan;0;0
44424;8104;92;65;40;4;36;.900;3600000;0
44424;8107;92;0;0;0;0;.00nan;0;0
44424;8154;91;54;12;1;11;.917;3600000;0
44425;6603;104;45;36;5;31;.861;3555000;0
44425;8103;93;66;29;4;25;.862;3600000;0
44425;8126;104;0;0;0;0;.00nan;0;0
44425;8320;93;0;0;0;0;.00nan;0;0
44426;6731;95;66;20;2;18;.900;3600000;0
44426;7654;97;69;38;4;34;.895;3531000;0
44426;7666;97;0;0;0;0;.00nan;0;0
44426;8168;95;0;0;0;0;.00nan;0;0
44427;7115;88;0;0;0;0;.00nan;0;0
44427;7155;86;0;0;0;0;.00nan;0;0
44427;8165;88;65;29;3;26;.897;3769000;0
44427;8322;86;89;35;2;33;.943;3769000;0
44428;6581;98;18;18;6;12;.667;2541000;0
44428;7163;98;64;18;1;17;.944;1059000;0
44428;8105;102;0;0;0;0;.00nan;0;0
44428;8745;102;44;28;4;24;.857;3600000;0
44429;7091;94;36;16;3;13;.813;660000;0
44429;7211;103;0;0;0;0;.00nan;0;0
44429;8101;94;53;55;8;47;.855;2940000;0
44429;8220;103;75;10;0;10;1.000;3600000;0
44430;6627;100;0;0;0;0;.00nan;0;0
44430;7078;100;65;46;5;41;.891;3600000;0
44430;7164;101;0;0;0;0;.00nan;0;0
44430;8236;101;36;33;6;27;.818;3533000;0
44431;6683;91;44;40;6;34;.850;3600000;0
44431;7762;90;48;23;3;20;.870;3600000;0
44431;8154;91;0;0;0;0;.00nan;0;0
44431;9227;90;0;0;0;0;.00nan;0;0
44432;6687;87;82;49;4;45;.918;3600000;0
44432;7716;89;0;0;0;0;.00nan;0;0
44432;7717;87;0;0;0;0;.00nan;0;0
44432;9226;89;43;24;5;19;.792;3600000;0
44433;6663;85;0;0;0;0;.00nan;0;0
44433;7142;85;50;31;4;27;.871;3600000;0
44433;7218;99;0;0;0;0;.00nan;0;0
44433;7227;99;72;35;3;32;.914;3600000;0
44434;8103;93;0;0;0;0;.00nan;0;0
44434;8105;102;100;48;1;47;.979;3600000;0
44434;8320;93;50;18;2;16;.889;3545000;0
44434;8745;102;0;0;0;0;.00nan;0;0
44435;6603;104;0;0;0;0;.00nan;0;0
44435;7211;103;0;0;0;0;.00nan;0;0
44435;8126;104;66;39;4;35;.897;3600000;0
44435;8220;103;53;10;1;9;.900;3600000;0
44436;6070;92;25;13;4;9;.692;473000;0
44436;8103;93;52;10;1;9;.900;3600000;0
44436;8107;92;70;49;5;44;.898;3127000;0
44436;8320;93;0;0;0;0;.00nan;0;0
44437;7091;94;0;0;0;0;.00nan;0;0
44437;7155;86;0;0;0;0;.00nan;0;0
44437;8101;94;60;31;3;28;.903;3600000;0
44437;8322;86;63;41;5;36;.878;3600000;0
44438;6627;100;30;27;6;21;.778;1561000;0
44438;6683;91;41;20;4;16;.800;3600000;0
44438;7078;100;43;28;4;24;.857;2039000;0
44438;8154;91;0;0;0;0;.00nan;0;0
44439;6581;98;0;0;0;0;.00nan;0;0
44439;6603;104;0;0;0;0;.00nan;0;0
44439;7163;98;52;43;5;38;.884;3600000;0
44439;8126;104;68;17;1;16;.941;3600000;0
44440;7091;94;0;0;0;0;.00nan;0;0
44440;7716;89;74;41;3;38;.927;3550000;0
44440;8101;94;80;38;2;36;.947;3600000;0
44440;9226;89;0;0;0;0;.00nan;0;0
44441;7075;96;52;51;6;45;.882;3173000;0
44441;7211;103;50;7;1;6;.857;3600000;0
44441;7735;96;43;7;2;5;.714;427000;0
44441;8220;103;0;0;0;0;.00nan;0;0
44442;7218;99;0;0;0;0;.00nan;0;0
44442;7227;99;64;24;2;22;.917;3600000;0
44442;7762;90;45;23;4;19;.826;3517000;0
44442;9227;90;0;0;0;0;.00nan;0;0
44443;6687;87;46;44;7;37;.841;2051000;0
44443;7717;87;78;21;0;21;1.000;1549000;0
44443;8103;93;0;0;0;0;.00nan;0;0
44443;8320;93;48;5;1;4;.800;3600000;0
44444;6663;85;0;0;0;0;.00nan;0;0
44444;7142;85;54;12;1;11;.917;3600000;0
44444;7654;97;0;0;0;0;.00nan;0;0
44444;7666;97;54;48;6;42;.875;3600000;0
44445;6731;95;67;28;2;26;.929;3600000;0
44445;7115;88;55;27;3;24;.889;3600000;0
44445;8165;88;0;0;0;0;.00nan;0;0
44445;8168;95;0;0;0;0;.00nan;0;0
44446;7164;101;79;28;2;26;.929;3600000;0
44446;8105;102;45;4;1;3;.750;442000;0
44446;8236;101;0;0;0;0;.00nan;0;0
44446;8745;102;34;33;6;27;.818;3158000;0
44447;6070;92;71;27;2;25;.926;3600000;0
44447;7155;86;20;35;8;27;.771;3600000;0
44447;8107;92;0;0;0;0;.00nan;0;0
44447;8322;86;0;0;0;0;.00nan;0;0
44448;7075;96;40;10;2;8;.800;938000;0
44448;7218;99;54;25;3;22;.880;3600000;0
44448;7227;99;0;0;0;0;.00nan;0;0
44448;7735;96;48;43;6;37;.860;2662000;0
44449;6603;104;62;30;3;27;.900;3589000;0
44449;6683;91;89;33;2;31;.939;3600000;0
44449;8126;104;0;0;0;0;.00nan;0;0
44449;8154;91;0;0;0;0;.00nan;0;0
44450;6687;87;72;33;3;30;.909;3585000;0
44450;7115;88;0;0;0;0;.00nan;0;0
44450;7717;87;0;0;0;0;.00nan;0;0
44450;8165;88;77;23;1;22;.957;3600000;0
44451;6581;98;29;8;3;5;.625;428000;0
44451;7163;98;63;56;7;49;.875;3172000;0
44451;8103;93;70;8;0;8;1.000;3600000;0
44451;8320;93;0;0;0;0;.00nan;0;0
44452;6663;85;49;28;4;24;.857;3600000;0
44452;7091;94;0;0;0;0;.00nan;0;0
44452;7142;85;0;0;0;0;.00nan;0;0
44452;8101;94;64;46;5;41;.891;3581000;0
44453;6731;95;0;0;0;0;.00nan;0;0
44453;7762;90;0;0;0;0;.00nan;0;0
44453;8168;95;73;43;4;39;.907;3568000;0
44453;9227;90;63;27;3;24;.889;3600000;0
44454;6627;100;0;0;0;0;.00nan;0;0
44454;7078;100;54;52;8;44;.846;3600000;0
44454;8105;102;40;20;4;16;.800;3600000;0
44454;8745;102;0;0;0;0;.00nan;0;0
44455;7654;97;37;39;6;33;.846;2844000;0
44455;7666;97;35;4;2;2;.500;756000;0
44455;7716;89;57;13;1;12;.923;3600000;0
44455;9226;89;0;0;0;0;.00nan;0;0
44456;6683;91;0;0;0;0;.00nan;0;0
44456;8105;102;0;0;0;0;.00nan;0;0
44456;8154;91;60;24;2;22;.917;3543000;0
44456;8745;102;85;25;1;24;.960;3600000;0
44457;7164;101;83;30;1;29;.967;3600000;0
44457;7211;103;0;0;0;0;.00nan;0;0
44457;8220;103;49;31;4;27;.871;3600000;0
44457;8236;101;0;0;0;0;.00nan;0;0
44458;6627;100;69;62;6;56;.903;3600000;0
44458;7078;100;0;0;0;0;.00nan;0;0
44458;7211;103;60;14;1;13;.929;3600000;0
44458;8220;103;0;0;0;0;.00nan;0;0
44459;6731;95;40;2;1;1;.500;624000;0
44459;7164;101;88;34;1;33;.971;3600000;0
44459;8168;95;18;21;6;15;.714;2976000;0
44459;8236;101;0;0;0;0;.00nan;0;0
44460;7091;94;68;23;2;21;.913;3600000;0
44460;7155;86;0;0;0;0;.00nan;0;0
44460;8101;94;0;0;0;0;.00nan;0;0
44460;8322;86;49;28;4;24;.857;3556000;0
44461;6603;104;0;0;0;0;.00nan;0;0
44461;7218;99;0;0;0;0;.00nan;0;0
44461;7227;99;58;28;3;25;.893;3568000;0
44461;8126;104;78;34;2;32;.941;3600000;0
44462;6581;98;0;0;0;0;.00nan;0;0
44462;7163;98;43;29;4;25;.862;3556000;0
44462;8105;102;59;29;3;26;.897;3600000;0
44462;8745;102;0;0;0;0;.00nan;0;0
44463;7115;88;73;34;3;31;.912;3559000;0
44463;7716;89;89;36;2;34;.944;3600000;0
44463;8165;88;0;0;0;0;.00nan;0;0
44463;9226;89;0;0;0;0;.00nan;0;0
44464;6731;95;0;0;0;0;.00nan;0;0
44464;7654;97;70;32;3;29;.906;3600000;0
44464;7666;97;0;0;0;0;.00nan;0;0
44464;8168;95;47;29;4;25;.862;3591000;0
44465;7075;96;90;61;5;56;.918;3742000;0
44465;7735;96;0;0;0;0;.00nan;0;0
44465;7762;90;0;0;0;0;.00nan;0;0
44465;9227;90;25;25;6;19;.760;3742000;0
44466;6663;85;0;0;0;0;.00nan;0;0
44466;6687;87;21;26;6;20;.769;3600000;0
44466;7142;85;56;16;2;14;.875;3600000;0
44466;7717;87;0;0;0;0;.00nan;0;0
44467;6627;100;0;0;0;0;.00nan;0;0
44467;7078;100;64;34;4;30;.882;3853000;0
44467;7164;101;51;25;3;22;.880;3853000;0
44467;8236;101;0;0;0;0;.00nan;0;0
44468;7155;86;82;45;2;43;.956;3600000;0
44468;7211;103;0;0;0;0;.00nan;0;0
44468;8220;103;39;16;4;12;.750;3560000;0
44468;8322;86;0;0;0;0;.00nan;0;0
44469;6070;92;55;32;5;27;.844;3600000;0
44469;6683;91;71;17;1;16;.941;3600000;0
44469;8107;92;0;0;0;0;.00nan;0;0
44469;8154;91;0;0;0;0;.00nan;0;0
44470;7218;99;62;20;2;18;.900;3900000;0
44470;7227;99;0;0;0;0;.00nan;0;0
44470;8105;102;0;0;0;0;.00nan;0;0
44470;8745;102;83;32;2;30;.938;3900000;0
44471;6581;98;67;38;3;35;.921;3600000;0
44471;7163;98;0;0;0;0;.00nan;0;0
44471;7716;89;0;0;0;0;.00nan;0;0
44471;9226;89;25;19;5;14;.737;3593000;0
44472;6687;87;59;50;6;44;.880;3600000;0
44472;7717;87;0;0;0;0;.00nan;0;0
44472;7762;90;86;40;3;37;.925;3600000;0
44472;9227;90;0;0;0;0;.00nan;0;0
44473;6603;104;71;39;3;36;.923;3600000;0
44473;8103;93;55;20;2;18;.900;3600000;0
44473;8126;104;0;0;0;0;.00nan;0;0
44473;8320;93;0;0;0;0;.00nan;0;0
44474;6627;100;51;39;6;33;.846;2700000;0
44474;6731;95;45;17;3;14;.824;3600000;0
44474;7078;100;51;8;1;7;.875;900000;0
44474;8168;95;0;0;0;0;.00nan;0;0
44475;6070;92;81;69;6;63;.913;3600000;0
44475;7211;103;64;11;1;10;.909;3600000;0
44475;8107;92;0;0;0;0;.00nan;0;0
44475;8220;103;0;0;0;0;.00nan;0;0
44476;7075;96;97;45;2;43;.956;3600000;0
44476;7115;88;65;10;1;9;.900;3600000;0
44476;7735;96;0;0;0;0;.00nan;0;0
44476;8165;88;0;0;0;0;.00nan;0;0
44477;6603;104;0;0;0;0;.00nan;0;0
44477;7654;97;58;5;0;5;1.000;859000;0
44477;7666;97;31;31;6;25;.806;2704000;0
44477;8126;104;45;28;5;23;.821;3600000;0
44478;7164;101;62;49;5;44;.898;3600000;0
44478;7762;90;0;0;0;0;.00nan;0;0
44478;8236;101;0;0;0;0;.00nan;0;0
44478;9227;90;56;23;3;20;.870;3600000;0
44479;6581;98;0;0;0;0;.00nan;0;0
44479;6663;85;63;15;1;14;.933;3600000;0
44479;7142;85;0;0;0;0;.00nan;0;0
44479;7163;98;56;38;5;33;.868;3600000;0
44480;6683;91;0;0;0;0;.00nan;0;0
44480;7155;86;93;44;3;41;.932;3600000;0
44480;8154;91;57;19;2;17;.895;3600000;0
44480;8322;86;0;0;0;0;.00nan;0;0
44481;6603;104;0;0;0;0;.00nan;0;0
44481;7164;101;52;36;5;31;.861;3541000;0
44481;8126;104;60;35;4;31;.886;3600000;0
44481;8236;101;0;0;0;0;.00nan;0;0
44482;6731;95;0;0;0;0;.00nan;0;0
44482;7075;96;68;43;4;39;.907;3600000;0
44482;7735;96;0;0;0;0;.00nan;0;0
44482;8168;95;61;15;1;14;.933;3600000;0
44483;7218;99;0;0;0;0;.00nan;0;0
44483;7227;99;32;26;5;21;.808;3596000;0
44483;8103;93;80;42;3;39;.929;3600000;0
44483;8320;93;0;0;0;0;.00nan;0;0
44484;7142;85;0;0;0;0;.00nan;0;0
44484;7630;94;0;0;0;0;.00nan;0;0
44484;8101;94;67;38;3;35;.921;3701000;0
44484;9245;85;49;28;4;24;.857;3701000;0
44485;7155;86;44;38;5;33;.868;3900000;0
44485;7716;89;53;35;5;30;.857;3868000;0
44485;8322;86;0;0;0;0;.00nan;0;0
44485;9226;89;0;0;0;0;.00nan;0;0
44486;6627;100;0;0;0;0;.00nan;0;0
44486;7078;100;80;33;2;31;.939;3600000;0
44486;8105;102;58;40;4;36;.900;3600000;0
44486;8745;102;0;0;0;0;.00nan;0;0
44487;6731;95;0;0;0;0;.00nan;0;0
44487;7218;99;0;0;0;0;.00nan;0;0
44487;7227;99;75;25;1;24;.960;3600000;0
44487;8168;95;70;29;2;27;.931;3600000;0
44488;6581;98;0;0;0;0;.00nan;0;0
44488;6687;87;43;29;5;24;.828;3565000;0
44488;7163;98;71;31;3;28;.903;3600000;0
44488;7717;87;0;0;0;0;.00nan;0;0
44489;7155;86;0;0;0;0;.00nan;0;0
44489;7716;89;0;0;0;0;.00nan;0;0
44489;8322;86;19;31;7;24;.774;3583000;0
44489;9226;89;60;33;4;29;.879;3600000;0
44490;6683;91;94;21;0;21;1.000;3600000;0
44490;7654;97;74;42;4;38;.905;3600000;0
44490;7666;97;0;0;0;0;.00nan;0;0
44490;8154;91;0;0;0;0;.00nan;0;0
44491;7075;96;58;35;3;32;.914;3590000;0
44491;7735;96;0;0;0;0;.00nan;0;0
44491;8105;102;0;0;0;0;.00nan;0;0
44491;8745;102;69;21;1;20;.952;3600000;0
44492;7115;88;61;19;2;17;.895;3600000;0
44492;7762;90;0;0;0;0;.00nan;0;0
44492;8165;88;0;0;0;0;.00nan;0;0
44492;9227;90;23;29;6;23;.793;3600000;0
44493;6603;104;70;30;3;27;.900;3884000;0
44493;7164;101;76;35;2;33;.943;3884000;0
44493;8126;104;0;0;0;0;.00nan;0;0
44493;8236;101;0;0;0;0;.00nan;0;0
44494;7142;85;55;50;6;44;.880;3325000;0
44494;7211;103;0;0;0;0;.00nan;0;0
44494;8220;103;59;8;1;7;.875;3600000;0
44494;9245;85;41;4;1;3;.750;275000;0
44495;6070;92;81;46;5;41;.891;3600000;0
44495;7762;90;60;14;1;13;.929;3600000;0
44495;8107;92;0;0;0;0;.00nan;0;0
44495;9227;90;0;0;0;0;.00nan;0;0
44496;6731;95;82;42;3;39;.929;3548000;0
44496;7218;99;63;21;2;19;.905;3600000;0
44496;7227;99;0;0;0;0;.00nan;0;0
44496;8168;95;0;0;0;0;.00nan;0;0
44497;6603;104;51;4;0;4;1.000;538000;0
44497;6627;100;63;37;4;33;.892;3600000;0
44497;7078;100;0;0;0;0;.00nan;0;0
44497;8126;104;18;29;7;22;.759;3062000;0
44498;6581;98;78;24;1;23;.958;3600000;0
44498;7163;98;0;0;0;0;.00nan;0;0
44498;7654;97;0;0;0;0;.00nan;0;0
44498;7666;97;66;39;4;35;.897;3600000;0
44499;7115;88;0;0;0;0;.00nan;0;0
44499;7155;86;24;47;8;39;.830;3082000;0
44499;8165;88;45;12;2;10;.833;3600000;0
44499;8322;86;46;6;1;5;.833;518000;0
44500;7075;96;0;0;0;0;.00nan;0;0
44500;7735;96;68;41;4;37;.902;3600000;0
44500;8105;102;47;23;3;20;.870;3600000;0
44500;8745;102;0;0;0;0;.00nan;0;0
44501;7164;101;52;32;4;28;.875;3120000;0
44501;8103;93;78;10;0;10;1.000;3600000;0
44501;8236;101;33;20;4;16;.800;480000;0
44501;8320;93;0;0;0;0;.00nan;0;0
44502;6070;92;43;41;7;34;.829;3600000;0
44502;7630;94;0;0;0;0;.00nan;0;0
44502;8101;94;98;25;0;25;1.000;3600000;0
44502;8107;92;0;0;0;0;.00nan;0;0
44503;6687;87;23;41;8;33;.805;2266000;0
44503;7716;89;4;20;7;13;.650;2695000;0
44503;7717;87;65;18;1;17;.944;1334000;0
44503;9226;89;22;10;4;6;.600;824000;0
44504;6663;85;88;30;1;29;.967;3600000;0
44504;6683;91;58;35;4;31;.886;3600000;0
44504;7142;85;0;0;0;0;.00nan;0;0
44504;8154;91;0;0;0;0;.00nan;0;0
44505;6627;100;10;45;9;36;.800;2550000;0
44505;7078;100;5;22;7;15;.682;1050000;0
44505;8103;93;52;7;1;6;.857;3600000;0
44505;8320;93;0;0;0;0;.00nan;0;0
44506;6581;98;0;0;0;0;.00nan;0;0
44506;7163;98;48;20;3;17;.850;3600000;0
44506;7654;97;22;34;8;26;.765;3307000;0
44506;7666;97;49;1;0;1;1.000;293000;0
44507;6603;104;0;0;0;0;.00nan;0;0
44507;8105;102;63;18;1;17;.944;1301000;0
44507;8126;104;52;25;3;22;.880;3600000;0
44507;8745;102;29;23;5;18;.783;2299000;0
44508;6070;92;97;36;1;35;.972;3600000;0
44508;6731;95;0;0;0;0;.00nan;0;0
44508;8107;92;0;0;0;0;.00nan;0;0
44508;8168;95;47;26;4;22;.846;3600000;0
44509;7075;96;52;64;8;56;.875;2906000;0
44509;7735;96;25;17;5;12;.706;694000;0
44509;8103;93;48;13;2;11;.846;3600000;0
44509;8320;93;0;0;0;0;.00nan;0;0
44510;7155;86;59;59;7;52;.881;3282000;0
44510;7211;103;72;16;1;15;.938;3600000;0
44510;8220;103;0;0;0;0;.00nan;0;0
44510;8322;86;47;7;1;6;.857;318000;0
44511;6627;100;34;28;5;23;.821;1119000;0
44511;7078;100;23;40;8;32;.800;2481000;0
44511;7630;94;0;0;0;0;.00nan;0;0
44511;8101;94;33;10;3;7;.700;3600000;0
44512;6581;98;59;27;3;24;.889;1408000;0
44512;7163;98;5;30;8;22;.733;2192000;0
44512;7762;90;0;0;0;0;.00nan;0;0
44512;9227;90;82;18;0;18;1.000;3600000;0
44513;7211;103;0;0;0;0;.00nan;0;0
44513;7716;89;97;53;2;51;.962;3600000;0
44513;8220;103;63;18;1;17;.944;3600000;0
44513;9226;89;0;0;0;0;.00nan;0;0
44514;7218;99;0;0;0;0;.00nan;0;0
44514;7227;99;71;10;0;10;1.000;3600000;0
44514;7654;97;0;0;0;0;.00nan;0;0
44514;7666;97;72;47;5;42;.894;3600000;0
44515;7075;96;82;48;4;44;.917;3536000;0
44515;7630;94;53;15;2;13;.867;3600000;0
44515;7735;96;0;0;0;0;.00nan;0;0
44515;8101;94;0;0;0;0;.00nan;0;0
44516;6627;100;37;61;10;51;.836;3600000;0
44516;7078;100;0;0;0;0;.00nan;0;0
44516;8103;93;0;0;0;0;.00nan;0;0
44516;8320;93;64;30;3;27;.900;3600000;0
44517;6687;87;95;41;2;39;.951;3600000;0
44517;7115;88;25;12;4;8;.667;3517000;0
44517;7717;87;0;0;0;0;.00nan;0;0
44517;8165;88;0;0;0;0;.00nan;0;0
44518;6663;85;0;0;0;0;.00nan;0;0
44518;7142;85;72;10;0;10;1.000;3600000;0
44518;7155;86;0;0;0;0;.00nan;0;0
44518;8322;86;58;41;5;36;.878;3600000;0
44519;6683;91;0;0;0;0;.00nan;0;0
44519;7164;101;75;34;2;32;.941;3600000;0
44519;8154;91;36;22;4;18;.818;3577000;0
44519;8236;101;0;0;0;0;.00nan;0;0
44520;6070;92;49;25;4;21;.840;3600000;0
44520;7716;89;0;0;0;0;.00nan;0;0
44520;8107;92;0;0;0;0;.00nan;0;0
44520;9226;89;42;36;5;31;.861;3549000;0
44521;6627;100;0;0;0;0;.00nan;0;0
44521;7078;100;88;52;4;48;.923;3600000;0
44521;7218;99;0;0;0;0;.00nan;0;0
44521;7227;99;66;15;1;14;.933;3600000;0
44522;6603;104;12;21;6;15;.714;3600000;0
44522;6687;87;76;42;3;39;.929;3600000;0
44522;7717;87;0;0;0;0;.00nan;0;0
44522;8126;104;0;0;0;0;.00nan;0;0
44523;7115;88;0;0;0;0;.00nan;0;0
44523;7164;101;26;27;6;21;.778;2079000;0
44523;8165;88;70;28;2;26;.929;3600000;0
44523;8236;101;31;10;3;7;.700;1521000;0
44524;6683;91;85;16;0;16;1.000;3600000;0
44524;7075;96;0;0;0;0;.00nan;0;0
44524;7735;96;42;43;6;37;.860;3600000;0
44524;8154;91;0;0;0;0;.00nan;0;0
44525;6581;98;0;0;0;0;.00nan;0;0
44525;6731;95;0;0;0;0;.00nan;0;0
44525;7163;98;61;30;3;27;.900;3576000;0
44525;8168;95;79;36;2;34;.944;3600000;0
44526;7762;90;0;0;0;0;.00nan;0;0
44526;8105;102;0;0;0;0;.00nan;0;0
44526;8745;102;90;44;4;40;.909;3900000;0
44526;9227;90;70;46;4;42;.913;3900000;0
44527;7218;99;70;18;1;17;.944;3600000;0
44527;7227;99;0;0;0;0;.00nan;0;0
44527;7654;97;69;48;5;43;.896;3600000;0
44527;7666;97;0;0;0;0;.00nan;0;0
44528;6603;104;0;0;0;0;.00nan;0;0
44528;7762;90;32;27;5;22;.815;3600000;0
44528;8126;104;96;37;2;35;.946;3600000;0
44528;9227;90;0;0;0;0;.00nan;0;0
44529;6581;98;40;38;6;32;.842;3600000;0
44529;7163;98;0;0;0;0;.00nan;0;0
44529;7630;94;0;0;0;0;.00nan;0;0
44529;8101;94;46;16;2;14;.875;3600000;0
44530;6663;85;46;7;1;6;.857;727000;0
44530;7142;85;40;39;6;33;.846;2873000;0
44530;7211;103;0;0;0;0;.00nan;0;0
44530;8220;103;47;18;3;15;.833;3600000;0
44531;6731;95;55;29;3;26;.897;3567000;0
44531;7716;89;69;26;2;24;.923;3600000;0
44531;8168;95;0;0;0;0;.00nan;0;0
44531;9226;89;0;0;0;0;.00nan;0;0
44532;6687;87;30;9;3;6;.667;593000;0
44532;7717;87;81;38;2;36;.947;3007000;0
44532;8105;102;70;26;2;24;.923;3600000;0
44532;8745;102;0;0;0;0;.00nan;0;0
44533;6581;98;0;0;0;0;.00nan;0;0
44533;7163;98;70;64;7;57;.891;3600000;0
44533;7164;101;56;11;1;10;.909;3600000;0
44533;8236;101;0;0;0;0;.00nan;0;0
44534;6683;91;37;64;10;54;.844;3600000;0
44534;7211;103;24;21;5;16;.762;3600000;0
44534;8154;91;0;0;0;0;.00nan;0;0
44534;8220;103;0;0;0;0;.00nan;0;0
44535;7630;94;74;44;4;40;.909;2548000;0
44535;8101;94;21;10;4;6;.600;1052000;0
44535;8103;93;83;29;1;28;.966;3600000;0
44535;8320;93;0;0;0;0;.00nan;0;0
44536;6070;92;61;26;3;23;.885;3600000;0
44536;7155;86;85;35;2;33;.943;3600000;0
44536;8107;92;0;0;0;0;.00nan;0;0
44536;8322;86;0;0;0;0;.00nan;0;0
44537;7716;89;29;35;6;29;.829;3600000;0
44537;8105;102;100;24;0;24;1.000;3600000;0
44537;8745;102;0;0;0;0;.00nan;0;0
44537;9226;89;0;0;0;0;.00nan;0;0
44538;6627;100;0;0;0;0;.00nan;0;0
44538;7078;100;87;39;2;37;.949;3614000;0
44538;7164;101;0;0;0;0;.00nan;0;0
44538;8236;101;60;28;3;25;.893;3614000;0
44539;6603;104;0;0;0;0;.00nan;0;0
44539;7716;89;0;0;0;0;.00nan;0;0
44539;8126;104;94;19;0;19;1.000;3600000;0
44539;9226;89;85;43;3;40;.930;3600000;0
44540;7115;88;52;21;3;18;.857;3600000;0
44540;7630;94;51;10;1;9;.900;508000;0
44540;8101;94;12;26;7;19;.731;3092000;0
44540;8165;88;0;0;0;0;.00nan;0;0
44541;7654;97;26;36;7;29;.806;2731000;0
44541;7666;97;53;11;1;10;.909;869000;0
44541;8105;102;42;17;3;14;.824;3600000;0
44541;8745;102;0;0;0;0;.00nan;0;0
44542;7075;96;59;47;6;41;.872;3600000;0
44542;7218;99;0;0;0;0;.00nan;0;0
44542;7227;99;58;12;1;11;.917;3600000;0
44542;7735;96;0;0;0;0;.00nan;0;0
44543;6687;87;54;35;5;30;.857;3600000;0
44543;7155;86;0;0;0;0;.00nan;0;0
44543;7717;87;0;0;0;0;.00nan;0;0
44543;8322;86;68;19;1;18;.947;3600000;0
44544;6070;92;33;30;6;24;.800;3600000;0
44544;6663;85;64;17;1;16;.941;3600000;0
44544;7142;85;0;0;0;0;.00nan;0;0
44544;8107;92;0;0;0;0;.00nan;0;0
44545;6581;98;85;25;1;24;.960;1571000;0
44545;7163;98;59;43;5;38;.884;2029000;0
44545;7211;103;0;0;0;0;.00nan;0;0
44545;8220;103;37;6;2;4;.667;3600000;0
44546;6683;91;93;35;2;33;.943;3465000;0
44546;8103;93;38;20;4;16;.800;3735000;0
44546;8154;91;21;3;3;0;.000;270000;0
44546;8320;93;0;0;0;0;.00nan;0;0
44547;7218;99;0;0;0;0;.00nan;0;0
44547;7227;99;83;25;1;24;.960;3600000;0
44547;7630;94;0;0;0;0;.00nan;0;0
44547;8101;94;72;31;3;28;.903;3530000;0
44548;6581;98;0;0;0;0;.00nan;0;0
44548;6603;104;0;0;0;0;.00nan;0;0
44548;7163;98;52;35;5;30;.857;3515000;0
44548;8126;104;47;20;3;17;.850;3600000;0
44549;6627;100;0;0;0;0;.00nan;0;0
44549;7078;100;77;52;5;47;.904;3600000;0
44549;7762;90;0;0;0;0;.00nan;0;0
44549;9227;90;47;10;2;8;.800;3600000;0
44550;6731;95;0;0;0;0;.00nan;0;0
44550;7075;96;0;0;0;0;.00nan;0;0
44550;7735;96;61;43;5;38;.884;3600000;0
44550;8168;95;78;28;2;26;.929;3600000;0
44551;7211;103;50;20;3;17;.850;3600000;0
44551;8103;93;0;0;0;0;.00nan;0;0
44551;8220;103;0;0;0;0;.00nan;0;0
44551;8320;93;69;42;4;38;.905;3545000;0
44552;6687;87;45;30;5;25;.833;3600000;0
44552;7717;87;0;0;0;0;.00nan;0;0
44552;8105;102;0;0;0;0;.00nan;0;0
44552;8745;102;63;15;1;14;.933;3600000;0
44553;6663;85;0;0;0;0;.00nan;0;0
44553;7142;85;59;15;1;14;.933;3600000;0
44553;7155;86;74;44;4;40;.909;3600000;0
44553;8322;86;0;0;0;0;.00nan;0;0
44554;6603;104;57;24;3;21;.875;3900000;0
44554;7164;101;60;34;3;31;.912;3900000;0
44554;8126;104;0;0;0;0;.00nan;0;0
44554;8236;101;0;0;0;0;.00nan;0;0
44555;6683;91;0;0;0;0;.00nan;0;0
44555;7762;90;67;33;3;30;.909;3525000;0
44555;8154;91;75;24;1;23;.958;3600000;0
44555;9227;90;0;0;0;0;.00nan;0;0
44556;6627;100;93;27;0;27;1.000;3600000;0
44556;7078;100;0;0;0;0;.00nan;0;0
44556;7716;89;55;34;4;30;.882;3600000;0
44556;9226;89;0;0;0;0;.00nan;0;0
44557;6731;95;0;0;0;0;.00nan;0;0
44557;7654;97;0;0;0;0;.00nan;0;0
44557;7666;97;62;45;5;40;.889;3600000;0
44557;8168;95;44;25;4;21;.840;3600000;0
44558;7115;88;47;15;3;12;.800;3600000;0
44558;7155;86;51;45;6;39;.867;3600000;0
44558;8165;88;0;0;0;0;.00nan;0;0
44558;8322;86;0;0;0;0;.00nan;0;0
44559;6663;85;77;23;1;22;.957;3900000;0
44559;7142;85;0;0;0;0;.00nan;0;0
44559;7716;89;64;27;1;26;.963;3862000;0
44559;9226;89;0;0;0;0;.00nan;0;0
44560;6731;95;71;42;4;38;.905;3576000;0
44560;7164;101;66;26;3;23;.885;3600000;0
44560;8168;95;0;0;0;0;.00nan;0;0
44560;8236;101;0;0;0;0;.00nan;0;0
44561;6070;92;67;27;3;24;.889;3600000;0
44561;7115;88;0;0;0;0;.00nan;0;0
44561;8107;92;0;0;0;0;.00nan;0;0
44561;8165;88;46;31;5;26;.839;3551000;0
44562;6581;98;36;6;2;4;.667;832000;0
44562;7163;98;36;35;6;29;.829;2768000;0
44562;7630;94;0;0;0;0;.00nan;0;0
44562;8101;94;81;28;1;27;.964;3600000;0
44563;6627;100;0;0;0;0;.00nan;0;0
44563;7078;100;56;36;5;31;.861;3600000;0
44563;7155;86;50;25;4;21;.840;3600000;0
44563;8322;86;0;0;0;0;.00nan;0;0
44564;6603;104;0;0;0;0;.00nan;0;0
44564;7211;103;0;0;0;0;.00nan;0;0
44564;8126;104;82;52;5;47;.904;3667000;0
44564;8220;103;34;17;4;13;.765;3667000;0
44565;7716;89;0;0;0;0;.00nan;0;0
44565;8103;93;64;15;1;14;.933;3600000;0
44565;8320;93;0;0;0;0;.00nan;0;0
44565;9226;89;69;55;5;50;.909;3600000;0
44566;7654;97;35;42;7;35;.833;3600000;0
44566;7666;97;0;0;0;0;.00nan;0;0
44566;7762;90;0;0;0;0;.00nan;0;0
44566;9227;90;100;27;0;27;1.000;3600000;0
44567;6070;92;20;27;6;21;.778;3094000;0
44567;7075;96;73;39;4;35;.897;3600000;0
44567;7735;96;0;0;0;0;.00nan;0;0
44567;8107;92;53;2;0;2;1.000;419000;0
44568;6663;85;0;0;0;0;.00nan;0;0
44568;6687;87;55;39;5;34;.872;3571000;0
44568;7142;85;57;23;3;20;.870;3600000;0
44568;7717;87;0;0;0;0;.00nan;0;0
44569;7164;101;89;34;1;33;.971;3600000;0
44569;8105;102;0;0;0;0;.00nan;0;0
44569;8236;101;0;0;0;0;.00nan;0;0
44569;8745;102;69;25;3;22;.880;3528000;0
44570;6581;98;31;24;5;19;.792;3600000;0
44570;6683;91;62;25;3;22;.880;3600000;0
44570;7163;98;0;0;0;0;.00nan;0;0
44570;8154;91;0;0;0;0;.00nan;0;0
44571;6070;92;0;0;0;0;.00nan;0;0
44571;7630;94;0;0;0;0;.00nan;0;0
44571;8101;94;74;24;1;23;.958;3600000;0
44571;8107;92;70;44;5;39;.886;3600000;0
44572;6603;104;47;14;2;12;.857;3600000;0
44572;7155;86;38;16;4;12;.750;897000;0
44572;8126;104;0;0;0;0;.00nan;0;0
44572;8322;86;51;34;4;30;.882;2703000;0
44573;7115;88;0;0;0;0;.00nan;0;0
44573;7762;90;51;25;4;21;.840;2697000;0
44573;8165;88;47;31;5;26;.839;3600000;0
44573;9227;90;26;11;4;7;.636;903000;0
44574;6731;95;49;51;8;43;.843;3216000;0
44574;7218;99;0;0;0;0;.00nan;0;0
44574;7227;99;41;23;4;19;.826;3600000;0
44574;8168;95;44;6;1;5;.833;384000;0
44575;7211;103;44;12;2;10;.833;3600000;0
44575;8105;102;57;45;5;40;.889;3600000;0
44575;8220;103;0;0;0;0;.00nan;0;0
44575;8745;102;0;0;0;0;.00nan;0;0
44576;7654;97;0;0;0;0;.00nan;0;0
44576;7666;97;44;39;5;34;.872;3600000;0
44576;8154;91;78;22;1;21;.955;3600000;0
44576;9245;91;0;0;0;0;.00nan;0;0
44577;6627;100;44;40;6;34;.850;2745000;0
44577;7075;96;0;0;0;0;.00nan;0;0
44577;7078;100;49;9;1;8;.889;855000;0
44577;7735;96;84;30;1;29;.967;3600000;0
44578;6581;98;45;11;2;9;.818;1228000;0
44578;7163;98;18;19;6;13;.684;2372000;0
44578;7164;101;47;33;5;28;.848;3600000;0
44578;8236;101;0;0;0;0;.00nan;0;0
44579;7075;96;98;80;5;75;.938;3600000;0
44579;7211;103;0;0;0;0;.00nan;0;0
44579;7735;96;0;0;0;0;.00nan;0;0
44579;8220;103;37;6;2;4;.667;3600000;0
44580;7716;89;52;39;5;34;.872;3600000;0
44580;7762;90;0;0;0;0;.00nan;0;0
44580;9226;89;0;0;0;0;.00nan;0;0
44580;9227;90;61;21;2;19;.905;3600000;0
44581;7630;94;0;0;0;0;.00nan;0;0
44581;7654;97;73;38;3;35;.921;3600000;0
44581;7666;97;0;0;0;0;.00nan;0;0
44581;8101;94;68;23;2;21;.913;3600000;0
44582;6687;87;41;35;6;29;.829;3600000;0
44582;7115;88;70;31;3;28;.903;3600000;0
44582;7717;87;0;0;0;0;.00nan;0;0
44582;8165;88;0;0;0;0;.00nan;0;0
44583;6663;85;0;0;0;0;.00nan;0;0
44583;7142;85;80;46;3;43;.935;3600000;0
44583;8103;93;87;17;0;17;1.000;3600000;0
44583;8320;93;0;0;0;0;.00nan;0;0
44584;6731;95;0;0;0;0;.00nan;0;0
44584;7218;99;69;25;3;22;.880;3900000;0
44584;7227;99;0;0;0;0;.00nan;0;0
44584;8168;95;77;38;3;35;.921;3900000;0
44585;7155;86;74;31;2;29;.935;3600000;0
44585;8105;102;0;0;0;0;.00nan;0;0
44585;8322;86;0;0;0;0;.00nan;0;0
44585;8745;102;43;30;5;25;.833;3600000;0
44586;6663;85;0;0;0;0;.00nan;0;0
44586;7142;85;41;18;3;15;.833;3900000;0
44586;7716;89;82;43;3;40;.930;3900000;0
44586;9226;89;0;0;0;0;.00nan;0;0
44587;6070;92;86;56;4;52;.929;3600000;0
44587;7115;88;100;29;0;29;1.000;3600000;0
44587;8107;92;0;0;0;0;.00nan;0;0
44587;8165;88;0;0;0;0;.00nan;0;0
44588;6603;104;68;12;0;12;1.000;673000;0
44588;7211;103;0;0;0;0;.00nan;0;0
44588;8126;104;35;37;6;31;.838;2927000;0
44588;8220;103;51;18;2;16;.889;3600000;0
44589;8103;93;68;17;1;16;.941;3600000;0
44589;8105;102;40;38;6;32;.842;1937000;0
44589;8320;93;0;0;0;0;.00nan;0;0
44589;8745;102;63;20;1;19;.950;1663000;0
44590;7630;94;0;0;0;0;.00nan;0;0
44590;7716;89;55;38;5;33;.868;3580000;0
44590;8101;94;50;20;3;17;.850;3600000;0
44590;9226;89;0;0;0;0;.00nan;0;0
44591;6687;87;86;27;2;25;.926;3600000;0
44591;7155;86;0;0;0;0;.00nan;0;0
44591;7717;87;0;0;0;0;.00nan;0;0
44591;8322;86;48;27;3;24;.889;3600000;0
44592;7218;99;0;0;0;0;.00nan;0;0
44592;7227;99;51;23;4;19;.826;3600000;0
44592;8105;102;48;43;6;37;.860;3600000;0
44592;8745;102;0;0;0;0;.00nan;0;0
44593;6581;98;44;39;6;33;.846;1891000;0
44593;7163;98;65;36;4;32;.889;1709000;0
44593;8103;93;74;9;0;9;1.000;3600000;0
44593;8320;93;0;0;0;0;.00nan;0;0
44594;6663;85;0;0;0;0;.00nan;0;0
44594;7115;88;50;30;4;26;.867;3600000;0
44594;7142;85;33;42;8;34;.810;3600000;0
44594;8165;88;0;0;0;0;.00nan;0;0
44595;7630;94;0;0;0;0;.00nan;0;0
44595;7654;97;58;39;5;34;.872;3723000;0
44595;7666;97;0;0;0;0;.00nan;0;0
44595;8101;94;42;22;4;18;.818;3723000;0
44596;6603;104;0;0;0;0;.00nan;0;0
44596;7075;96;32;30;6;24;.800;2075000;0
44596;7735;96;71;20;1;19;.950;1525000;0
44596;8126;104;52;10;1;9;.900;3600000;0
44597;7155;86;80;31;2;29;.935;3600000;0
44597;7762;90;0;0;0;0;.00nan;0;0
44597;8322;86;0;0;0;0;.00nan;0;0
44597;9227;90;62;27;3;24;.889;3575000;0
44598;6687;87;89;36;2;34;.944;3600000;0
44598;6731;95;73;42;4;38;.905;3578000;0
44598;7717;87;0;0;0;0;.00nan;0;0
44598;8168;95;0;0;0;0;.00nan;0;0
44599;6627;100;0;0;0;0;.00nan;0;0
44599;7078;100;63;34;4;30;.882;3532000;0
44599;7164;101;54;25;3;22;.880;3600000;0
44599;8236;101;0;0;0;0;.00nan;0;0
44600;7211;103;0;0;0;0;.00nan;0;0
44600;7716;89;0;0;0;0;.00nan;0;0
44600;8220;103;92;21;0;21;1.000;3600000;0
44600;9226;89;67;43;4;39;.907;3600000;0
44601;6070;92;39;28;5;23;.821;2073000;0
44601;6683;91;90;18;0;18;1.000;3600000;0
44601;8107;92;55;14;1;13;.929;1527000;0
44601;8154;91;0;0;0;0;.00nan;0;0
44602;6070;92;73;41;4;37;.902;3600000;0
44602;7164;101;0;0;0;0;.00nan;0;0
44602;8107;92;0;0;0;0;.00nan;0;0
44602;8236;101;35;23;5;18;.783;3563000;0
44603;6663;85;38;32;5;27;.844;3525000;0
44603;7142;85;0;0;0;0;.00nan;0;0
44603;7218;99;36;19;4;15;.789;3600000;0
44603;7227;99;0;0;0;0;.00nan;0;0
44604;6603;104;50;19;3;16;.842;3600000;0
44604;7075;96;19;17;5;12;.706;1572000;0
44604;7735;96;30;25;6;19;.760;2028000;0
44604;8126;104;0;0;0;0;.00nan;0;0
44605;6581;98;0;0;0;0;.00nan;0;0
44605;7163;98;82;26;1;25;.962;3600000;0
44605;7654;97;0;0;0;0;.00nan;0;0
44605;7666;97;73;37;4;33;.892;3600000;0
44606;7115;88;0;0;0;0;.00nan;0;0
44606;8105;102;0;0;0;0;.00nan;0;0
44606;8165;88;43;10;2;8;.800;3600000;0
44606;8745;102;60;45;6;39;.867;3600000;0
44607;6731;95;0;0;0;0;.00nan;0;0
44607;7630;94;0;0;0;0;.00nan;0;0
44607;8101;94;35;31;5;26;.839;3549000;0
44607;8168;95;59;30;4;26;.867;3600000;0
44608;6627;100;62;20;3;17;.850;3600000;0
44608;7078;100;0;0;0;0;.00nan;0;0
44608;7654;97;7;30;8;22;.733;2795000;0
44608;7666;97;51;10;1;9;.900;805000;0
44609;6663;85;0;0;0;0;.00nan;0;0
44609;7142;85;66;17;1;16;.941;3825000;0
44609;7762;90;0;0;0;0;.00nan;0;0
44609;9227;90;85;36;2;34;.944;3825000;0
44610;6687;87;35;17;4;13;.765;835000;0
44610;7164;101;72;26;1;25;.962;3600000;0
44610;7717;87;52;33;4;29;.879;2765000;0
44610;8236;101;0;0;0;0;.00nan;0;0
44611;7075;96;27;42;8;34;.810;2675000;0
44611;7211;103;0;0;0;0;.00nan;0;0
44611;7735;96;59;10;0;10;1.000;925000;0
44611;8220;103;41;9;2;7;.778;3600000;0
44612;6683;91;82;25;1;24;.960;3600000;0
44612;7716;89;64;37;4;33;.892;3600000;0
44612;8154;91;0;0;0;0;.00nan;0;0
44612;9226;89;0;0;0;0;.00nan;0;0
44613;6603;104;0;0;0;0;.00nan;0;0
44613;8105;102;0;0;0;0;.00nan;0;0
44613;8126;104;70;26;2;24;.923;3527000;0
44613;8745;102;100;28;0;28;1.000;3600000;0
44614;7164;101;30;18;5;13;.722;1814000;0
44614;7762;90;0;0;0;0;.00nan;0;0
44614;8236;101;59;10;0;10;1.000;1786000;0
44614;9227;90;74;28;2;26;.929;3600000;0
44615;6627;100;0;0;0;0;.00nan;0;0
44615;6731;95;78;24;1;23;.958;3600000;0
44615;7078;100;54;40;5;35;.875;3600000;0
44615;8168;95;0;0;0;0;.00nan;0;0
44616;7211;103;0;0;0;0;.00nan;0;0
44616;7218;99;0;0;0;0;.00nan;0;0
44616;7227;99;60;26;3;23;.885;3600000;0
44616;8220;103;45;24;4;20;.833;3574000;0
44617;6663;85;0;0;0;0;.00nan;0;0
44617;7142;85;51;30;4;26;.867;3600000;0
44617;7630;94;0;0;0;0;.00nan;0;0
44617;8101;94;53;46;6;40;.870;3574000;0
44618;6683;91;0;0;0;0;.00nan;0;0
44618;7155;86;37;13;3;10;.769;530000;0
44618;8154;91;51;36;5;31;.861;3600000;0
44618;8322;86;40;17;3;14;.824;3018000;0
44619;6581;98;0;0;0;0;.00nan;0;0
44619;6731;95;61;21;2;19;.905;3600000;0
44619;7163;98;93;45;3;42;.933;3600000;0
44619;8168;95;0;0;0;0;.00nan;0;0
44620;7115;88;65;22;2;20;.909;3600000;0
44620;7630;94;0;0;0;0;.00nan;0;0
44620;8101;94;45;20;3;17;.850;3577000;0
44620;8165;88;0;0;0;0;.00nan;0;0
44621;6683;91;42;22;4;18;.818;3600000;0
44621;7716;89;33;40;7;33;.825;3312000;0
44621;8154;91;0;0;0;0;.00nan;0;0
44621;9226;89;39;1;1;0;.000;288000;0
44622;7075;96;64;38;4;34;.895;3600000;0
44622;7654;97;37;34;6;28;.824;3183000;0
44622;7666;97;14;5;4;1;.200;417000;0
44622;7735;96;0;0;0;0;.00nan;0;0
44623;7211;103;79;17;1;16;.941;3600000;0
44623;7762;90;0;0;0;0;.00nan;0;0
44623;8220;103;0;0;0;0;.00nan;0;0
44623;9227;90;45;36;5;31;.861;3600000;0
44624;6070;92;82;47;3;44;.936;3600000;0
44624;8103;93;53;27;4;23;.852;3545000;0
44624;8107;92;0;0;0;0;.00nan;0;0
44624;8320;93;0;0;0;0;.00nan;0;0
44625;6687;87;62;30;3;27;.900;3582000;0
44625;7155;86;82;30;2;28;.933;3600000;0
44625;7717;87;0;0;0;0;.00nan;0;0
44625;8322;86;0;0;0;0;.00nan;0;0
44626;7164;101;68;34;2;32;.941;3600000;0
44626;8105;102;0;0;0;0;.00nan;0;0
44626;8236;101;0;0;0;0;.00nan;0;0
44626;8745;102;49;25;3;22;.880;3600000;0
44627;6603;104;0;0;0;0;.00nan;0;0
44627;6627;100;40;30;5;25;.833;3564000;0
44627;7078;100;0;0;0;0;.00nan;0;0
44627;8126;104;46;26;4;22;.846;3600000;0
44628;6070;92;55;42;6;36;.857;3085000;0
44628;7218;99;0;0;0;0;.00nan;0;0
44628;7227;99;43;20;3;17;.850;3600000;0
44628;8107;92;45;11;2;9;.818;515000;0
44629;6603;104;69;32;3;29;.906;3651000;0
44629;7164;101;0;0;0;0;.00nan;0;0
44629;8126;104;0;0;0;0;.00nan;0;0
44629;8236;101;70;31;2;29;.935;3651000;0
44630;7630;94;0;0;0;0;.00nan;0;0
44630;8101;94;78;55;4;51;.927;3562000;0
44630;8103;93;0;0;0;0;.00nan;0;0
44630;8320;93;49;14;2;12;.857;3600000;0
44631;6581;98;59;31;4;27;.871;3629000;0
44631;6731;95;0;0;0;0;.00nan;0;0
44631;7163;98;0;0;0;0;.00nan;0;0
44631;8168;95;52;23;3;20;.870;3629000;0
44632;6663;85;33;35;6;29;.829;3289000;0
44632;7142;85;41;2;1;1;.500;311000;0
44632;7155;86;0;0;0;0;.00nan;0;0
44632;8322;86;56;27;4;23;.852;3600000;0
44633;6627;100;0;0;0;0;.00nan;0;0
44633;7078;100;46;37;5;32;.865;3637000;0
44633;8105;102;64;51;6;45;.882;3637000;0
44633;8745;102;0;0;0;0;.00nan;0;0
44634;7115;88;57;26;4;22;.846;3600000;0
44634;7211;103;0;0;0;0;.00nan;0;0
44634;8165;88;0;0;0;0;.00nan;0;0
44634;8220;103;76;37;3;34;.919;3600000;0
44635;7218;99;45;13;2;11;.846;3600000;0
44635;7227;99;0;0;0;0;.00nan;0;0
44635;7654;97;0;0;0;0;.00nan;0;0
44635;7666;97;41;44;7;37;.841;3600000;0
44636;7716;89;38;22;4;18;.818;3579000;0
44636;7762;90;0;0;0;0;.00nan;0;0
44636;9226;89;0;0;0;0;.00nan;0;0
44636;9227;90;70;37;3;34;.919;3600000;0
44637;6687;87;78;20;1;19;.950;3600000;0
44637;7075;96;86;35;2;33;.943;3544000;0
44637;7717;87;0;0;0;0;.00nan;0;0
44637;7735;96;0;0;0;0;.00nan;0;0
44638;6663;85;0;0;0;0;.00nan;0;0
44638;6683;91;0;0;0;0;.00nan;0;0
44638;7142;85;64;31;3;28;.903;3578000;0
44638;8154;91;73;27;2;25;.926;3600000;0
44639;6581;98;0;0;0;0;.00nan;0;0
44639;7075;96;64;34;4;30;.882;3600000;0
44639;7163;98;60;22;3;19;.864;3600000;0
44639;7735;96;0;0;0;0;.00nan;0;0
44640;7075;96;27;40;8;32;.800;2575000;0
44640;7218;99;0;0;0;0;.00nan;0;0
44640;7227;99;52;8;1;7;.875;3600000;0
44640;7735;96;59;20;2;18;.900;1025000;0
44641;6683;91;66;28;3;25;.893;3600000;0
44641;7630;94;0;0;0;0;.00nan;0;0
44641;8101;94;64;33;4;29;.879;3600000;0
44641;8154;91;0;0;0;0;.00nan;0;0
44642;6070;92;20;39;9;30;.769;3600000;0
44642;6731;95;69;27;2;25;.926;3600000;0
44642;8107;92;0;0;0;0;.00nan;0;0
44642;8168;95;0;0;0;0;.00nan;0;0
44643;7115;88;97;36;2;34;.944;3900000;0
44643;8103;93;80;28;2;26;.929;3900000;0
44643;8165;88;0;0;0;0;.00nan;0;0
44643;8320;93;0;0;0;0;.00nan;0;0
44644;6603;104;0;0;0;0;.00nan;0;0
44644;7155;86;45;28;5;23;.821;3600000;0
44644;8126;104;89;36;2;34;.944;3600000;0
44644;8322;86;0;0;0;0;.00nan;0;0
44645;6627;100;0;0;0;0;.00nan;0;0
44645;6687;87;99;44;1;43;.977;3600000;0
44645;7078;100;52;27;3;24;.889;3531000;0
44645;7717;87;0;0;0;0;.00nan;0;0
44646;6581;98;0;0;0;0;.00nan;0;0
44646;7163;98;44;48;7;41;.854;3600000;0
44646;7218;99;0;0;0;0;.00nan;0;0
44646;7227;99;39;13;3;10;.769;3600000;0
44647;7630;94;0;0;0;0;.00nan;0;0
44647;7716;89;0;0;0;0;.00nan;0;0
44647;8101;94;64;29;3;26;.897;3600000;0
44647;9226;89;32;33;6;27;.818;3600000;0
44648;6627;100;65;40;5;35;.875;3803000;0
44648;7078;100;0;0;0;0;.00nan;0;0
44648;7654;97;38;25;5;20;.800;3318000;0
44648;7666;97;46;3;1;2;.667;485000;0
44649;7075;96;98;43;2;41;.953;2640000;0
44649;7735;96;28;16;4;12;.750;960000;0
44649;8103;93;0;0;0;0;.00nan;0;0
44649;8320;93;30;7;3;4;.571;3600000;0
44650;7115;88;0;0;0;0;.00nan;0;0
44650;7762;90;0;0;0;0;.00nan;0;0
44650;8165;88;69;34;3;31;.912;3600000;0
44650;9227;90;52;34;5;29;.853;3551000;0
44651;6603;104;52;31;4;27;.871;3595000;0
44651;6663;85;0;0;0;0;.00nan;0;0
44651;7142;85;66;25;2;23;.920;3600000;0
44651;8126;104;0;0;0;0;.00nan;0;0
44652;6687;87;70;41;4;37;.902;3752000;0
44652;7164;101;61;28;3;25;.893;3752000;0
44652;7717;87;0;0;0;0;.00nan;0;0
44652;8236;101;0;0;0;0;.00nan;0;0
44653;7211;103;0;0;0;0;.00nan;0;0
44653;8105;102;0;0;0;0;.00nan;0;0
44653;8220;103;39;21;4;17;.810;3546000;0
44653;8745;102;87;42;3;39;.929;3600000;0
44654;6683;91;0;0;0;0;.00nan;0;0
44654;6731;95;0;0;0;0;.00nan;0;0
44654;8154;91;53;18;2;16;.889;3600000;0
44654;8168;95;69;34;4;30;.882;3567000;0
44655;7218;99;79;21;1;20;.952;3600000;0
44655;7227;99;0;0;0;0;.00nan;0;0
44655;7762;90;83;34;2;32;.941;3547000;0
44655;9227;90;0;0;0;0;.00nan;0;0
44656;6581;98;29;25;5;20;.800;3900000;0
44656;7163;98;0;0;0;0;.00nan;0;0
44656;7654;97;0;0;0;0;.00nan;0;0
44656;7666;97;53;32;5;27;.844;3900000;0
44657;7155;86;55;40;5;35;.875;3596000;0
44657;7630;94;0;0;0;0;.00nan;0;0
44657;8101;94;63;32;4;28;.875;3600000;0
44657;8322;86;0;0;0;0;.00nan;0;0
44658;7164;101;84;38;2;36;.947;3600000;0
44658;8105;102;63;32;3;29;.906;3588000;0
44658;8236;101;0;0;0;0;.00nan;0;0
44658;8745;102;0;0;0;0;.00nan;0;0
44659;6070;92;19;21;6;15;.714;2489000;0
44659;6627;100;0;0;0;0;.00nan;0;0
44659;7078;100;86;41;3;38;.927;3600000;0
44659;8107;92;62;6;0;6;1.000;1111000;0
44660;6687;87;60;31;4;27;.871;2359000;0
44660;7115;88;50;20;3;17;.850;3600000;0
44660;7717;87;13;15;5;10;.667;1241000;0
44660;8165;88;0;0;0;0;.00nan;0;0
44661;6603;104;0;0;0;0;.00nan;0;0
44661;7716;89;78;25;1;24;.960;3600000;0
44661;8126;104;46;33;5;28;.848;3600000;0
44661;9226;89;0;0;0;0;.00nan;0;0
44662;7075;96;100;42;1;41;.976;3600000;0
44662;7735;96;0;0;0;0;.00nan;0;0
44662;7762;90;0;0;0;0;.00nan;0;0
44662;9227;90;45;18;3;15;.833;3589000;0
44663;6663;85;58;17;2;15;.882;3600000;0
44663;7142;85;0;0;0;0;.00nan;0;0
44663;7155;86;0;0;0;0;.00nan;0;0
44663;8322;86;55;40;4;36;.900;3522000;0
44664;6070;92;44;39;6;33;.846;3600000;0
44664;7164;101;0;0;0;0;.00nan;0;0
44664;8107;92;0;0;0;0;.00nan;0;0
44664;8236;101;74;23;1;22;.957;3600000;0
44665;6731;95;47;50;6;44;.880;3109000;0
44665;7211;103;0;0;0;0;.00nan;0;0
44665;8168;95;61;7;0;7;1.000;477000;0
44665;8220;103;29;16;4;12;.750;3600000;0
44666;6683;91;18;8;4;4;.500;855000;0
44666;8103;93;90;17;0;17;1.000;3600000;0
44666;8154;91;68;35;3;32;.914;2745000;0
44666;8320;93;0;0;0;0;.00nan;0;0
44667;6581;98;68;24;1;23;.958;3009000;0
44667;7163;98;28;8;3;5;.625;591000;0
44667;7654;97;76;23;1;22;.957;3600000;0
44667;7666;97;0;0;0;0;.00nan;0;0
44668;6687;87;46;23;4;19;.826;3735000;0
44668;7075;96;70;53;5;48;.906;3696000;0
44668;7717;87;0;0;0;0;.00nan;0;0
44668;7735;96;0;0;0;0;.00nan;0;0
44669;7115;88;69;19;2;17;.895;3600000;0
44669;7762;90;0;0;0;0;.00nan;0;0
44669;8165;88;0;0;0;0;.00nan;0;0
44669;9227;90;51;33;5;28;.848;3600000;0
44670;6070;92;53;30;4;26;.867;3825000;0
44670;8105;102;0;0;0;0;.00nan;0;0
44670;8107;92;0;0;0;0;.00nan;0;0
44670;8745;102;57;27;3;24;.889;3825000;0
44671;7716;89;49;48;7;41;.854;2394000;0
44671;8103;93;77;13;0;13;1.000;3600000;0
44671;8320;93;0;0;0;0;.00nan;0;0
44671;9226;89;47;29;4;25;.862;1206000;0
44672;7211;103;0;0;0;0;.00nan;0;0
44672;7630;94;0;0;0;0;.00nan;0;0
44672;8101;94;86;54;5;49;.907;3568000;0
44672;8220;103;39;15;3;12;.800;3600000;0
44673;7155;86;73;17;1;16;.941;3600000;0
44673;7654;97;0;0;0;0;.00nan;0;0
44673;7666;97;58;39;4;35;.897;3600000;0
44673;8322;86;0;0;0;0;.00nan;0;0
44674;6627;100;29;13;4;9;.692;999000;0
44674;6663;85;0;0;0;0;.00nan;0;0
44674;7078;100;86;32;1;31;.969;2601000;0
44674;7142;85;72;23;1;22;.957;3600000;0
44675;6627;100;37;48;8;40;.833;3600000;0
44675;7078;100;0;0;0;0;.00nan;0;0
44675;7218;99;0;0;0;0;.00nan;0;0
44675;7227;99;47;17;3;14;.824;3600000;0
44676;6581;98;42;3;1;2;.667;594000;0
44676;6731;95;0;0;0;0;.00nan;0;0
44676;7163;98;44;40;6;34;.850;3006000;0
44676;8168;95;54;27;4;23;.852;3600000;0
44677;7654;97;43;47;6;41;.872;3216000;0
44677;7666;97;49;9;1;8;.889;384000;0
44677;8103;93;84;11;0;11;1.000;3600000;0
44677;8320;93;0;0;0;0;.00nan;0;0
44678;6663;85;82;17;0;17;1.000;3600000;0
44678;7075;96;82;49;4;45;.918;3600000;0
44678;7142;85;0;0;0;0;.00nan;0;0
44678;7735;96;0;0;0;0;.00nan;0;0
44679;7630;94;0;0;0;0;.00nan;0;0
44679;7762;90;0;0;0;0;.00nan;0;0
44679;8101;94;62;26;2;24;.923;3600000;0
44679;9227;90;79;42;3;39;.929;3585000;0
44680;6687;87;59;43;6;37;.860;1881000;0
44680;7211;103;45;9;2;7;.778;3600000;0
44680;7717;87;55;22;3;19;.864;1719000;0
44680;8220;103;0;0;0;0;.00nan;0;0
44681;6603;104;0;0;0;0;.00nan;0;0
44681;7164;101;83;29;2;27;.931;3600000;0
44681;8126;104;54;26;3;23;.885;3568000;0
44681;8236;101;0;0;0;0;.00nan;0;0
44682;6683;91;66;41;5;36;.878;3544000;0
44682;8105;102;61;40;4;36;.900;3600000;0
44682;8154;91;0;0;0;0;.00nan;0;0
44682;8745;102;0;0;0;0;.00nan;0;0
44683;6070;92;82;23;1;22;.957;3600000;0
44683;6683;91;0;0;0;0;.00nan;0;0
44683;8107;92;0;0;0;0;.00nan;0;0
44683;8154;91;59;22;3;19;.864;3535000;0
44684;7218;99;46;16;3;13;.813;3600000;0
44684;7227;99;0;0;0;0;.00nan;0;0
44684;7716;89;50;6;1;5;.833;769000;0
44684;9226;89;60;44;6;38;.864;2831000;0
44685;6603;104;80;35;2;33;.943;3600000;0
44685;7164;101;45;28;4;24;.857;3600000;0
44685;8126;104;0;0;0;0;.00nan;0;0
44685;8236;101;0;0;0;0;.00nan;0;0
44686;6627;100;0;0;0;0;.00nan;0;0
44686;7078;100;67;49;5;44;.898;3530000;0
44686;7115;88;35;12;3;9;.750;3600000;0
44686;8165;88;0;0;0;0;.00nan;0;0
44687;7075;96;55;41;5;36;.878;3511000;0
44687;7155;86;18;32;8;24;.750;3900000;0
44687;7735;96;32;8;3;5;.625;389000;0
44687;8322;86;0;0;0;0;.00nan;0;0
44688;7762;90;9;35;9;26;.743;3600000;0
44688;8103;93;78;31;2;29;.935;3600000;0
44688;8320;93;0;0;0;0;.00nan;0;0
44688;9227;90;0;0;0;0;.00nan;0;0
44689;6581;98;59;41;5;36;.878;3600000;0
44689;6731;95;23;25;6;19;.760;3548000;0
44689;7163;98;0;0;0;0;.00nan;0;0
44689;8168;95;0;0;0;0;.00nan;0;0
44690;6581;98;0;0;0;0;.00nan;0;0
44690;6663;85;67;19;2;17;.895;3541000;0
44690;7142;85;0;0;0;0;.00nan;0;0
44690;7163;98;91;31;1;30;.968;3600000;0
44691;7115;88;0;0;0;0;.00nan;0;0
44691;7716;89;67;35;3;32;.914;3600000;0
44691;8165;88;36;20;4;16;.800;3600000;0
44691;9226;89;0;0;0;0;.00nan;0;0
44692;7630;94;0;0;0;0;.00nan;0;0
44692;8101;94;62;21;2;19;.905;3600000;0
44692;8105;102;0;0;0;0;.00nan;0;0
44692;8745;102;50;35;5;30;.857;3600000;0
44693;6070;92;58;40;5;35;.875;3900000;0
44693;6687;87;71;38;5;33;.868;3900000;0
44693;7717;87;0;0;0;0;.00nan;0;0
44693;8107;92;0;0;0;0;.00nan;0;0
44694;6731;95;65;47;5;42;.894;3539000;0
44694;7211;103;0;0;0;0;.00nan;0;0
44694;8168;95;0;0;0;0;.00nan;0;0
44694;8220;103;48;19;3;16;.842;3600000;0
44695;7155;86;0;0;0;0;.00nan;0;0
44695;7164;101;0;0;0;0;.00nan;0;0
44695;8236;101;60;34;3;31;.912;3900000;0
44695;8322;86;56;38;3;35;.921;3900000;0
44696;6070;92;52;36;5;31;.861;3600000;0
44696;6683;91;84;31;1;30;.968;3600000;0
44696;8107;92;0;0;0;0;.00nan;0;0
44696;8154;91;0;0;0;0;.00nan;0;0
44697;6603;104;0;0;0;0;.00nan;0;0
44697;8105;102;0;0;0;0;.00nan;0;0
44697;8126;104;47;28;5;23;.821;3600000;0
44697;8745;102;56;28;4;24;.857;3600000;0
44698;7164;101;48;33;5;28;.848;3600000;0
44698;7218;99;0;0;0;0;.00nan;0;0
44698;7227;99;69;23;1;22;.957;3600000;0
44698;8236;101;0;0;0;0;.00nan;0;0
44699;7630;94;0;0;0;0;.00nan;0;0
44699;7762;90;76;29;2;27;.931;1938000;0
44699;8101;94;55;38;5;33;.868;3600000;0
44699;9227;90;10;16;6;10;.625;1662000;0
44700;7115;88;66;18;1;17;.944;3600000;0
44700;7155;86;76;44;3;41;.932;3600000;0
44700;8165;88;0;0;0;0;.00nan;0;0
44700;8322;86;0;0;0;0;.00nan;0;0
44701;6627;100;0;0;0;0;.00nan;0;0
44701;7078;100;63;55;6;49;.891;3600000;0
44701;7218;99;0;0;0;0;.00nan;0;0
44701;7227;99;50;18;3;15;.833;3600000;0
44702;6603;104;46;26;4;22;.846;3600000;0
44702;7164;101;38;33;6;27;.818;3513000;0
44702;8126;104;0;0;0;0;.00nan;0;0
44702;8236;101;0;0;0;0;.00nan;0;0
44703;6070;92;80;34;2;32;.941;3600000;0
44703;6581;98;0;0;0;0;.00nan;0;0
44703;7163;98;59;26;3;23;.885;3551000;0
44703;8107;92;0;0;0;0;.00nan;0;0
44704;7115;88;0;0;0;0;.00nan;0;0
44704;7716;89;0;0;0;0;.00nan;0;0
44704;8165;88;62;13;1;12;.923;3600000;0
44704;9226;89;84;37;2;35;.946;3566000;0
44705;7211;103;0;0;0;0;.00nan;0;0
44705;7654;97;43;13;3;10;.769;1656000;0
44705;7666;97;31;36;7;29;.806;1944000;0
44705;8220;103;73;11;0;11;1.000;3600000;0
44706;6731;95;53;27;4;23;.852;3600000;0
44706;7075;96;78;49;5;44;.898;3600000;0
44706;7735;96;0;0;0;0;.00nan;0;0
44706;8168;95;0;0;0;0;.00nan;0;0
44707;6663;85;0;0;0;0;.00nan;0;0
44707;6687;87;89;42;2;40;.952;3600000;0
44707;7142;85;50;26;4;22;.846;3547000;0
44707;7717;87;0;0;0;0;.00nan;0;0
44708;6683;91;74;33;3;30;.909;3900000;0
44708;7762;90;0;0;0;0;.00nan;0;0
44708;8154;91;0;0;0;0;.00nan;0;0
44708;9227;90;74;39;3;36;.923;3900000;0
44709;6070;92;87;48;4;44;.917;3600000;0
44709;7630;94;0;0;0;0;.00nan;0;0
44709;8101;94;79;33;2;31;.939;3600000;0
44709;8107;92;0;0;0;0;.00nan;0;0
44710;6581;98;46;48;7;41;.854;3197000;0
44710;7163;98;22;4;3;1;.250;403000;0
44710;7211;103;0;0;0;0;.00nan;0;0
44710;8220;103;69;6;0;6;1.000;3600000;0
44711;6603;104;0;0;0;0;.00nan;0;0
44711;7075;96;96;32;1;31;.969;3600000;0
44711;7735;96;0;0;0;0;.00nan;0;0
44711;8126;104;56;19;2;17;.895;3543000;0
44712;6683;91;20;41;8;33;.805;2681000;0
44712;8103;93;81;11;0;11;1.000;3600000;0
44712;8154;91;56;19;2;17;.895;919000;0
44712;8320;93;0;0;0;0;.00nan;0;0
44713;6663;85;70;35;3;32;.914;3587000;0
44713;7115;88;88;30;1;29;.967;3600000;0
44713;7142;85;0;0;0;0;.00nan;0;0
44713;8165;88;0;0;0;0;.00nan;0;0
44714;6627;100;73;39;4;35;.897;3600000;0
44714;6731;95;81;40;3;37;.925;3600000;0
44714;7078;100;0;0;0;0;.00nan;0;0
44714;8168;95;0;0;0;0;.00nan;0;0
44715;7155;86;0;0;0;0;.00nan;0;0
44715;7716;89;91;24;0;24;1.000;3600000;0
44715;8322;86;37;37;6;31;.838;3600000;0
44715;9226;89;0;0;0;0;.00nan;0;0
44716;7218;99;0;0;0;0;.00nan;0;0
44716;7227;99;43;18;3;15;.833;3600000;0
44716;8105;102;58;26;3;23;.885;1703000;0
44716;8745;102;33;24;5;19;.792;1897000;0
44717;6663;85;0;0;0;0;.00nan;0;0
44717;7142;85;45;23;4;19;.826;3843000;0
44717;7716;89;73;38;3;35;.921;3843000;0
44717;9226;89;0;0;0;0;.00nan;0;0
44718;7654;97;0;0;0;0;.00nan;0;0
44718;7666;97;40;38;6;32;.842;3576000;0
44718;7762;90;51;1;0;1;1.000;246000;0
44718;9227;90;35;19;4;15;.789;3354000;0
44719;6070;92;51;41;6;35;.854;3524000;0
44719;7630;94;0;0;0;0;.00nan;0;0
44719;8101;94;63;32;4;28;.875;3600000;0
44719;8107;92;0;0;0;0;.00nan;0;0
44720;6683;91;0;0;0;0;.00nan;0;0
44720;6687;87;95;36;2;34;.944;3600000;0
44720;7717;87;0;0;0;0;.00nan;0;0
44720;8154;91;43;17;3;14;.824;3591000;0
44721;6603;104;62;40;5;35;.875;3545000;0
44721;7211;103;0;0;0;0;.00nan;0;0
44721;8126;104;0;0;0;0;.00nan;0;0
44721;8220;103;51;17;3;14;.824;3600000;0
44722;7115;88;94;43;3;40;.930;3761000;0
44722;8103;93;59;27;4;23;.852;3761000;0
44722;8165;88;0;0;0;0;.00nan;0;0
44722;8320;93;0;0;0;0;.00nan;0;0
44723;7075;96;69;42;4;38;.905;3600000;0
44723;7218;99;0;0;0;0;.00nan;0;0
44723;7227;99;89;15;0;15;1.000;3600000;0
44723;7735;96;0;0;0;0;.00nan;0;0
44724;6683;91;10;20;6;14;.700;1997000;0
44724;7630;94;0;0;0;0;.00nan;0;0
44724;8154;91;67;20;2;18;.900;1603000;0
44724;8314;94;67;32;3;29;.906;3600000;0
44725;6687;87;63;27;3;24;.889;3575000;0
44725;7716;89;72;29;2;27;.931;3600000;0
44725;7717;87;0;0;0;0;.00nan;0;0
44725;9226;89;0;0;0;0;.00nan;0;0
44726;6731;95;79;24;1;23;.958;3600000;0
44726;7654;97;77;46;5;41;.891;3600000;0
44726;7666;97;0;0;0;0;.00nan;0;0
44726;8168;95;0;0;0;0;.00nan;0;0
44727;6581;98;0;0;0;0;.00nan;0;0
44727;6627;100;0;0;0;0;.00nan;0;0
44727;7078;100;57;40;4;36;.900;3600000;0
44727;7163;98;43;32;5;27;.844;3563000;0
44728;7155;86;74;34;2;32;.941;3600000;0
44728;7762;90;0;0;0;0;.00nan;0;0
44728;8322;86;0;0;0;0;.00nan;0;0
44728;9227;90;53;29;3;26;.897;3552000;0
44729;7211;103;81;14;0;14;1.000;3600000;0
44729;8105;102;44;40;6;34;.850;2297000;0
44729;8220;103;0;0;0;0;.00nan;0;0
44729;8745;102;40;25;4;21;.840;1303000;0
44730;6603;104;69;22;1;21;.955;3600000;0
44730;8105;102;0;0;0;0;.00nan;0;0
44730;8126;104;0;0;0;0;.00nan;0;0
44730;8745;102;66;27;3;24;.889;3520000;0
44731;6581;98;65;42;4;38;.905;3600000;0
44731;6627;100;0;0;0;0;.00nan;0;0
44731;7078;100;62;22;2;20;.909;3600000;0
44731;7163;98;0;0;0;0;.00nan;0;0
44732;7115;88;42;19;4;15;.789;3600000;0
44732;7762;90;34;13;3;10;.769;816000;0
44732;8165;88;0;0;0;0;.00nan;0;0
44732;9227;90;18;35;7;28;.800;2784000;0
44733;7155;86;0;0;0;0;.00nan;0;0
44733;7654;97;48;27;4;23;.852;3545000;0
44733;7666;97;0;0;0;0;.00nan;0;0
44733;8322;86;80;24;1;23;.958;3600000;0
44734;7218;99;0;0;0;0;.00nan;0;0
44734;7227;99;22;25;6;19;.760;3565000;0
44734;8103;93;0;0;0;0;.00nan;0;0
44734;8320;93;51;27;4;23;.852;3600000;0
44735;6663;85;0;0;0;0;.00nan;0;0
44735;7142;85;56;20;3;17;.850;3831000;0
44735;7716;89;0;0;0;0;.00nan;0;0
44735;9226;89;72;45;4;41;.911;3831000;0
44736;6070;92;85;33;2;31;.939;3677000;0
44736;6731;95;76;36;3;33;.917;3677000;0
44736;8101;92;0;0;0;0;.00nan;0;0
44736;8168;95;0;0;0;0;.00nan;0;0
44737;7075;96;24;32;6;26;.813;2716000;0
44737;7164;101;66;21;1;20;.952;3600000;0
44737;7735;96;58;16;2;14;.875;884000;0
44737;8236;101;0;0;0;0;.00nan;0;0
44738;6683;91;38;13;3;10;.769;364000;0
44738;7630;94;0;0;0;0;.00nan;0;0
44738;8154;91;50;29;4;25;.862;3212000;0
44738;8314;94;39;35;5;30;.857;3600000;0
44739;6070;92;61;34;5;29;.853;3600000;0
44739;6581;98;52;3;0;3;1.000;627000;0
44739;7163;98;31;33;6;27;.818;2919000;0
44739;8101;92;0;0;0;0;.00nan;0;0
44740;7218;99;64;36;5;31;.861;3600000;0
44740;7227;99;0;0;0;0;.00nan;0;0
44740;8103;93;91;32;2;30;.938;3600000;0
44740;8320;93;0;0;0;0;.00nan;0;0
44741;7075;96;88;51;4;47;.922;3900000;0
44741;7164;101;0;0;0;0;.00nan;0;0
44741;7735;96;0;0;0;0;.00nan;0;0
44741;8236;101;40;21;4;17;.810;3900000;0
44742;7115;88;0;0;0;0;.00nan;0;0
44742;7762;90;0;0;0;0;.00nan;0;0
44742;8165;88;35;22;5;17;.773;3555000;0
44742;9227;90;75;44;4;40;.909;3600000;0
44743;6687;87;86;43;3;40;.930;3600000;0
44743;7630;94;44;30;4;26;.867;3543000;0
44743;7717;87;0;0;0;0;.00nan;0;0
44743;8314;94;0;0;0;0;.00nan;0;0
44744;6603;104;33;4;2;2;.500;733000;0
44744;8105;102;62;42;5;37;.881;3600000;0
44744;8126;104;28;31;6;25;.806;2867000;0
44744;8745;102;0;0;0;0;.00nan;0;0
44745;6683;91;50;57;8;49;.860;3600000;0
44745;7211;103;86;16;0;16;1.000;3600000;0
44745;8154;91;0;0;0;0;.00nan;0;0
44745;8220;103;0;0;0;0;.00nan;0;0
44746;6627;100;34;17;4;13;.765;3600000;0
44746;7078;100;0;0;0;0;.00nan;0;0
44746;7654;97;0;0;0;0;.00nan;0;0
44746;7666;97;47;37;5;32;.865;3600000;0
44747;6663;85;0;0;0;0;.00nan;0;0
44747;7142;85;16;15;5;10;.667;3538000;0
44747;7716;89;64;33;4;29;.879;3600000;0
44747;9226;89;0;0;0;0;.00nan;0;0
44748;6687;87;71;39;4;35;.897;3900000;0
44748;7155;86;63;34;4;30;.882;3900000;0
44748;7717;87;0;0;0;0;.00nan;0;0
44748;8322;86;0;0;0;0;.00nan;0;0
44749;7115;88;64;16;1;15;.938;3600000;0
44749;7155;86;80;39;2;37;.949;3564000;0
44749;8165;88;0;0;0;0;.00nan;0;0
44749;8322;86;0;0;0;0;.00nan;0;0
44750;6581;98;0;0;0;0;.00nan;0;0
44750;7075;96;36;32;6;26;.813;2711000;0
44750;7163;98;65;20;2;18;.900;3600000;0
44750;7735;96;39;8;2;6;.750;889000;0
44751;6687;87;97;50;3;47;.940;3593000;0
44751;7717;87;0;0;0;0;.00nan;0;0
44751;7762;90;0;0;0;0;.00nan;0;0
44751;9227;90;61;17;1;16;.941;3600000;0
44752;7211;103;59;10;1;9;.900;3600000;0
44752;7654;97;30;45;8;37;.822;2766000;0
44752;7666;97;40;12;2;10;.833;834000;0
44752;8220;103;0;0;0;0;.00nan;0;0
44753;6627;100;53;3;0;3;1.000;1213000;0
44753;7078;100;33;23;5;18;.783;2387000;0
44753;8105;102;0;0;0;0;.00nan;0;0
44753;8745;102;73;28;2;26;.929;3600000;0
44754;6070;92;98;58;3;55;.948;3590000;0
44754;6663;85;0;0;0;0;.00nan;0;0
44754;7142;85;64;21;2;19;.905;3600000;0
44754;8101;92;0;0;0;0;.00nan;0;0
44755;6687;87;70;43;4;39;.907;3792000;0
44755;7630;94;0;0;0;0;.00nan;0;0
44755;7717;87;0;0;0;0;.00nan;0;0
44755;8314;94;46;33;5;28;.848;3792000;0
44756;6731;95;47;31;5;26;.839;3600000;0
44756;7155;86;0;0;0;0;.00nan;0;0
44756;8168;95;0;0;0;0;.00nan;0;0
44756;8322;86;23;27;6;21;.778;3553000;0
44757;6603;104;39;26;5;21;.808;2224000;0
44757;7211;103;0;0;0;0;.00nan;0;0
44757;8126;104;61;23;2;21;.913;1376000;0
44757;8220;103;52;23;3;20;.870;3600000;0
44758;6581;98;87;51;3;48;.941;3527000;0
44758;7163;98;0;0;0;0;.00nan;0;0
44758;7218;99;0;0;0;0;.00nan;0;0
44758;7227;99;80;23;1;22;.957;3600000;0
44759;6731;95;77;34;2;32;.941;3553000;0
44759;7716;89;100;38;0;38;1.000;3600000;0
44759;8168;95;0;0;0;0;.00nan;0;0
44759;9226;89;0;0;0;0;.00nan;0;0
44760;7075;96;100;45;1;44;.978;3900000;0
44760;7115;88;64;12;1;11;.917;3900000;0
44760;7735;96;0;0;0;0;.00nan;0;0
44760;8165;88;0;0;0;0;.00nan;0;0
44761;6070;92;66;43;5;38;.884;3600000;0
44761;7762;90;53;18;2;16;.889;3600000;0
44761;8101;92;0;0;0;0;.00nan;0;0
44761;9227;90;0;0;0;0;.00nan;0;0
44762;6663;85;63;25;2;23;.920;3600000;0
44762;7142;85;0;0;0;0;.00nan;0;0
44762;8103;93;47;20;3;17;.850;3586000;0
44762;8320;93;0;0;0;0;.00nan;0;0
44763;7654;97;0;0;0;0;.00nan;0;0
44763;7666;97;48;27;4;23;.852;3570000;0
44763;8105;102;0;0;0;0;.00nan;0;0
44763;8745;102;62;20;2;18;.900;3600000;0
44764;6627;100;63;24;2;22;.917;1530000;0
44764;7078;100;10;24;7;17;.708;2070000;0
44764;7164;101;41;25;4;21;.840;3600000;0
44764;8236;101;0;0;0;0;.00nan;0;0
44765;6683;91;60;13;1;12;.923;3600000;0
44765;6687;87;41;33;6;27;.818;2378000;0
44765;7717;87;48;15;2;13;.867;1222000;0
44765;8154;91;0;0;0;0;.00nan;0;0
44766;6070;92;30;24;5;19;.792;2030000;0
44766;8101;92;43;24;4;20;.833;1570000;0
44766;8103;93;0;0;0;0;.00nan;0;0
44766;8320;93;52;9;1;8;.889;3600000;0
44767;6581;98;0;0;0;0;.00nan;0;0
44767;7163;98;79;43;3;40;.930;3533000;0
44767;7218;99;61;12;1;11;.917;3600000;0
44767;7227;99;0;0;0;0;.00nan;0;0
44768;6603;104;0;0;0;0;.00nan;0;0
44768;7654;97;51;26;3;23;.885;3554000;0
44768;7666;97;0;0;0;0;.00nan;0;0
44768;8126;104;55;17;2;15;.882;3600000;0
44769;6683;91;0;0;0;0;.00nan;0;0
44769;7115;88;0;0;0;0;.00nan;0;0
44769;8154;91;41;33;6;27;.818;3600000;0
44769;8165;88;58;19;2;17;.895;3600000;0
44770;7155;86;52;9;1;8;.889;1553000;0
44770;7716;89;50;33;5;28;.848;3600000;0
44770;8322;86;9;17;6;11;.647;1976000;0
44770;9226;89;0;0;0;0;.00nan;0;0
44771;7075;96;97;59;2;57;.966;3900000;0
44771;7735;96;0;0;0;0;.00nan;0;0
44771;8105;102;77;27;2;25;.926;3900000;0
44771;8745;102;0;0;0;0;.00nan;0;0
44772;7164;101;35;32;6;26;.813;3180000;0
44772;7218;99;0;0;0;0;.00nan;0;0
44772;7227;99;60;33;5;28;.848;3600000;0
44772;8236;101;40;3;1;2;.667;379000;0
44773;6687;87;78;44;4;40;.909;3600000;0
44773;7115;88;85;26;1;25;.962;3600000;0
44773;7717;87;0;0;0;0;.00nan;0;0
44773;8165;88;0;0;0;0;.00nan;0;0
44774;6683;91;66;29;3;26;.897;3894000;0
44774;7762;90;0;0;0;0;.00nan;0;0
44774;8154;91;0;0;0;0;.00nan;0;0
44774;9227;90;55;30;3;27;.900;3900000;0
44775;7630;94;0;0;0;0;.00nan;0;0
44775;8103;93;74;36;3;33;.917;3600000;0
44775;8314;94;46;40;5;35;.875;3600000;0
44775;8320;93;0;0;0;0;.00nan;0;0
44776;6663;85;0;0;0;0;.00nan;0;0
44776;6731;95;51;32;4;28;.875;3585000;0
44776;7142;85;50;22;3;19;.864;3600000;0
44776;8168;95;0;0;0;0;.00nan;0;0
44777;7075;96;77;66;7;59;.894;3600000;0
44777;7211;103;0;0;0;0;.00nan;0;0
44777;7735;96;0;0;0;0;.00nan;0;0
44777;8220;103;28;8;3;5;.625;3600000;0
44778;6603;104;33;26;5;21;.808;3769000;0
44778;6627;100;65;43;4;39;.907;3769000;0
44778;7078;100;0;0;0;0;.00nan;0;0
44778;8126;104;0;0;0;0;.00nan;0;0
44779;6581;98;48;12;2;10;.833;1833000;0
44779;7115;88;0;0;0;0;.00nan;0;0
44779;7163;98;15;24;6;18;.750;1767000;0
44779;8165;88;41;20;3;17;.850;3600000;0
44780;6731;95;43;36;5;31;.861;2229000;0
44780;8103;93;68;16;1;15;.938;3600000;0
44780;8168;95;17;18;6;12;.667;1371000;0
44780;8320;93;0;0;0;0;.00nan;0;0
44781;6663;85;44;35;5;30;.857;3891000;0
44781;7142;85;0;0;0;0;.00nan;0;0
44781;7716;89;0;0;0;0;.00nan;0;0
44781;9226;89;55;39;5;34;.872;3900000;0
44782;6683;91;89;40;3;37;.925;3600000;0
44782;7630;94;0;0;0;0;.00nan;0;0
44782;8154;91;0;0;0;0;.00nan;0;0
44782;8314;94;46;27;4;23;.852;3600000;0
44783;6070;92;88;50;4;46;.920;3600000;0
44783;6603;104;53;22;3;19;.864;2311000;0
44783;8101;92;0;0;0;0;.00nan;0;0
44783;8126;104;1;17;7;10;.588;1289000;0
44784;6731;95;40;40;6;34;.850;2599000;0
44784;7218;99;0;0;0;0;.00nan;0;0
44784;7227;99;39;28;5;23;.821;3600000;0
44784;8168;95;33;18;4;14;.778;1001000;0
44785;7211;103;34;26;5;21;.808;3600000;0
44785;7630;94;50;45;6;39;.867;2832000;0
44785;8220;103;0;0;0;0;.00nan;0;0
44785;8314;94;47;7;1;6;.857;723000;0
44786;7155;86;41;33;5;28;.848;3600000;0
44786;7164;101;66;19;2;17;.895;3600000;0
44786;8236;101;0;0;0;0;.00nan;0;0
44786;8322;86;0;0;0;0;.00nan;0;0
44787;6627;100;0;0;0;0;.00nan;0;0
44787;7078;100;42;34;5;29;.853;3600000;0
44787;8105;102;64;24;2;22;.917;3600000;0
44787;8745;102;0;0;0;0;.00nan;0;0
44788;7164;101;0;0;0;0;.00nan;0;0
44788;7716;89;80;38;2;36;.947;2812000;0
44788;8236;101;61;26;3;23;.885;3600000;0
44788;9226;89;22;11;4;7;.636;788000;0
44789;6687;87;81;24;1;23;.958;3600000;0
44789;7654;97;34;20;4;16;.800;2029000;0
44789;7666;97;54;11;1;10;.909;1571000;0
44789;7717;87;0;0;0;0;.00nan;0;0
44790;6581;98;0;0;0;0;.00nan;0;0
44790;7075;96;80;33;2;31;.939;3600000;0
44790;7163;98;81;43;4;39;.907;3520000;0
44790;7735;96;0;0;0;0;.00nan;0;0
44791;7762;90;0;0;0;0;.00nan;0;0
44791;8103;93;41;22;4;18;.818;3600000;0
44791;8320;93;0;0;0;0;.00nan;0;0
44791;9227;90;69;49;5;44;.898;3553000;0
44792;6663;85;0;0;0;0;.00nan;0;0
44792;7115;88;0;0;0;0;.00nan;0;0
44792;7142;85;66;31;2;29;.935;3550000;0
44792;8165;88;83;25;1;24;.960;3600000;0
44793;6603;104;0;0;0;0;.00nan;0;0
44793;6683;91;99;37;1;36;.973;3600000;0
44793;8126;104;24;32;6;26;.813;3600000;0
44793;8154;91;0;0;0;0;.00nan;0;0
44794;6070;92;64;60;7;53;.883;3600000;0
44794;7211;103;0;0;0;0;.00nan;0;0
44794;8101;92;0;0;0;0;.00nan;0;0
44794;8220;103;51;22;3;19;.864;3600000;0
44795;6687;87;68;53;6;47;.887;2832000;0
44795;7218;99;0;0;0;0;.00nan;0;0
44795;7227;99;63;24;2;22;.917;3600000;0
44795;7717;87;33;18;4;14;.778;768000;0
44796;7115;88;63;41;5;36;.878;3600000;0
44796;7716;89;71;28;2;26;.929;1640000;0
44796;8165;88;0;0;0;0;.00nan;0;0
44796;9226;89;17;32;7;25;.781;1960000;0
44797;6581;98;40;38;6;32;.842;3600000;0
44797;6731;95;0;0;0;0;.00nan;0;0
44797;7163;98;0;0;0;0;.00nan;0;0
44797;8168;95;72;27;2;25;.926;3600000;0
44798;7155;86;26;33;6;27;.818;1671000;0
44798;8103;93;0;0;0;0;.00nan;0;0
44798;8320;93;63;18;1;17;.944;3600000;0
44798;8322;86;37;37;6;31;.838;1929000;0
44799;6627;100;0;0;0;0;.00nan;0;0
44799;7078;100;83;33;2;31;.939;3600000;0
44799;8105;102;0;0;0;0;.00nan;0;0
44799;8745;102;79;26;1;25;.962;3600000;0
44800;6627;100;73;46;3;43;.935;3600000;0
44800;7075;96;61;32;4;28;.875;3585000;0
44800;7078;100;0;0;0;0;.00nan;0;0
44800;7735;96;0;0;0;0;.00nan;0;0
44801;6070;92;78;32;2;30;.938;3900000;0
44801;7762;90;0;0;0;0;.00nan;0;0
44801;8101;92;0;0;0;0;.00nan;0;0
44801;9227;90;55;25;2;23;.920;3900000;0
44802;6603;104;0;0;0;0;.00nan;0;0
44802;7630;94;0;0;0;0;.00nan;0;0
44802;8126;104;52;40;5;35;.875;3546000;0
44802;8314;94;38;24;4;20;.833;3600000;0
44803;6663;85;0;0;0;0;.00nan;0;0
44803;7142;85;71;27;2;25;.926;3600000;0
44803;7164;101;55;34;4;30;.882;3581000;0
44803;8236;101;0;0;0;0;.00nan;0;0
44804;7654;97;79;37;4;33;.892;3600000;0
44804;7666;97;0;0;0;0;.00nan;0;0
44804;8105;102;21;21;6;15;.714;2865000;0
44804;8745;102;31;4;2;2;.500;735000;0
44805;6683;91;68;51;6;45;.882;3528000;0
44805;7211;103;40;18;4;14;.778;3600000;0
44805;8154;91;0;0;0;0;.00nan;0;0
44805;8220;103;0;0;0;0;.00nan;0;0
44806;7218;99;0;0;0;0;.00nan;0;0
44806;7227;99;70;35;2;33;.943;3568000;0
44806;7762;90;0;0;0;0;.00nan;0;0
44806;9227;90;78;30;1;29;.967;3600000;0
44807;7075;96;63;17;2;15;.882;3600000;0
44807;7654;97;0;0;0;0;.00nan;0;0
44807;7666;97;66;37;4;33;.892;3582000;0
44807;7735;96;0;0;0;0;.00nan;0;0
44808;6070;92;78;55;5;50;.909;3600000;0
44808;6731;95;0;0;0;0;.00nan;0;0
44808;8101;92;0;0;0;0;.00nan;0;0
44808;8168;95;43;22;4;18;.818;3600000;0
44809;7211;103;0;0;0;0;.00nan;0;0
44809;8105;102;28;12;4;8;.667;1589000;0
44809;8220;103;88;16;0;16;1.000;3600000;0
44809;8745;102;24;29;6;23;.793;2011000;0
44810;6070;92;82;23;1;22;.957;3653000;0
44810;6663;85;0;0;0;0;.00nan;0;0
44810;7142;85;84;15;0;15;1.000;3653000;0
44810;8101;92;0;0;0;0;.00nan;0;0
44811;7762;90;65;28;2;26;.929;2606000;0
44811;8103;93;53;10;1;9;.900;3600000;0
44811;8320;93;0;0;0;0;.00nan;0;0
44811;9227;90;33;16;4;12;.750;994000;0
44812;7115;88;74;26;2;24;.923;3600000;0
44812;7630;94;16;14;5;9;.643;1339000;0
44812;8165;88;0;0;0;0;.00nan;0;0
44812;8314;94;19;16;5;11;.688;2261000;0
44813;6687;87;81;52;5;47;.904;3600000;0
44813;7155;86;63;18;2;16;.889;3600000;0
44813;7717;87;0;0;0;0;.00nan;0;0
44813;8322;86;0;0;0;0;.00nan;0;0
44814;6627;100;58;6;0;6;1.000;299000;0
44814;7078;99;60;24;3;21;.875;3600000;0
44814;7218;99;0;0;0;0;.00nan;0;0
44814;7749;100;27;25;5;20;.800;3301000;0
44815;6581;98;60;21;1;20;.952;1751000;0
44815;7155;86;0;0;0;0;.00nan;0;0
44815;7163;98;39;23;4;19;.826;1795000;0
44815;7164;86;45;17;3;14;.824;3600000;0
44816;6687;87;50;40;5;35;.875;3568000;0
44816;7716;89;0;0;0;0;.00nan;0;0
44816;7717;87;0;0;0;0;.00nan;0;0
44816;9226;89;51;24;3;21;.875;3600000;0
44817;6663;85;0;0;0;0;.00nan;0;0
44817;7142;85;44;25;4;21;.840;3600000;0
44817;7654;97;44;38;6;32;.842;3579000;0
44817;7666;97;0;0;0;0;.00nan;0;0
44818;6731;95;0;0;0;0;.00nan;0;0
44818;7075;96;66;49;5;44;.898;3900000;0
44818;7735;96;0;0;0;0;.00nan;0;0
44818;8168;95;29;23;5;18;.783;3900000;0
44819;7630;94;0;0;0;0;.00nan;0;0
44819;8314;94;39;24;4;20;.833;3579000;0
44819;9227;90;0;0;0;0;.00nan;0;0
44819;9274;90;53;26;3;23;.885;3600000;0
44820;7078;99;0;0;0;0;.00nan;0;0
44820;8104;99;55;30;4;26;.867;3900000;0
44820;8236;101;73;49;4;45;.918;3900000;0
44820;9275;101;0;0;0;0;.00nan;0;0
44821;6603;104;0;0;0;0;.00nan;0;0
44821;7211;103;0;0;0;0;.00nan;0;0
44821;8126;104;62;36;4;32;.889;3600000;0
44821;8154;103;79;13;0;13;1.000;3600000;0
44822;6683;91;72;32;3;29;.906;3600000;0
44822;8165;88;25;17;5;12;.706;2316000;0
44822;9245;91;0;0;0;0;.00nan;0;0
44822;9279;88;47;6;1;5;.833;1284000;0
44823;6070;92;100;46;2;44;.957;3600000;0
44823;6627;100;62;28;3;25;.893;3600000;0
44823;7749;100;0;0;0;0;.00nan;0;0
44823;8103;92;0;0;0;0;.00nan;0;0
44824;6603;104;56;39;5;34;.872;3592000;0
44824;8105;102;0;0;0;0;.00nan;0;0
44824;8126;104;0;0;0;0;.00nan;0;0
44824;8745;102;52;25;3;22;.880;3600000;0
44825;7716;89;27;31;6;25;.806;2116000;0
44825;8320;93;0;0;0;0;.00nan;0;0
44825;9226;89;54;17;2;15;.882;1484000;0
44825;9273;93;60;16;2;14;.875;3600000;0
44826;6731;95;48;28;4;24;.857;3600000;0
44826;7155;86;0;0;0;0;.00nan;0;0
44826;7164;86;82;27;1;26;.963;3600000;0
44826;8168;95;0;0;0;0;.00nan;0;0
44827;7654;97;0;0;0;0;.00nan;0;0
44827;7666;97;44;51;8;43;.843;3600000;0
44827;8236;101;0;0;0;0;.00nan;0;0
44827;9275;101;70;20;1;19;.950;3600000;0
44828;7211;103;0;0;0;0;.00nan;0;0
44828;8154;103;49;24;3;21;.875;3600000;0
44828;8165;88;23;44;8;36;.818;2792000;0
44828;9279;88;52;8;1;7;.875;808000;0
44829;6603;104;0;0;0;0;.00nan;0;0
44829;7078;99;80;24;1;23;.958;3600000;0
44829;8104;99;0;0;0;0;.00nan;0;0
44829;8126;104;72;36;3;33;.917;3588000;0
44830;6581;98;78;15;0;15;1.000;2459000;0
44830;7163;98;20;19;5;14;.737;1175000;0
44830;7716;89;32;31;6;25;.806;3634000;0
44830;9226;89;0;0;0;0;.00nan;0;0
44831;7075;96;68;35;3;32;.914;3600000;0
44831;7654;97;56;34;4;30;.882;3555000;0
44831;7666;97;0;0;0;0;.00nan;0;0
44831;7735;96;0;0;0;0;.00nan;0;0
44832;8320;93;34;17;4;13;.765;3728000;0
44832;9227;90;86;60;5;55;.917;3728000;0
44832;9273;93;0;0;0;0;.00nan;0;0
44832;9274;90;0;0;0;0;.00nan;0;0
44833;6683;91;85;36;2;34;.944;3679000;0
44833;7630;94;0;0;0;0;.00nan;0;0
44833;8314;94;53;28;3;25;.893;3679000;0
44833;9245;91;0;0;0;0;.00nan;0;0
44834;6627;100;0;0;0;0;.00nan;0;0
44834;6687;87;35;34;6;28;.824;3033000;0
44834;7717;87;43;4;1;3;.750;567000;0
44834;7749;100;51;24;3;21;.875;3600000;0
44835;6663;85;62;26;4;22;.846;3546000;0
44835;6731;95;0;0;0;0;.00nan;0;0
44835;7142;85;0;0;0;0;.00nan;0;0
44835;8168;95;87;45;3;42;.933;3600000;0
44836;6603;104;0;0;0;0;.00nan;0;0
44836;8126;104;43;40;7;33;.825;3600000;0
44836;8165;88;0;0;0;0;.00nan;0;0
44836;9279;88;58;21;2;19;.905;3600000;0
44837;7078;99;0;0;0;0;.00nan;0;0
44837;8104;99;55;45;6;39;.867;3590000;0
44837;8320;93;0;0;0;0;.00nan;0;0
44837;9273;93;38;25;5;20;.800;3600000;0
44838;6627;100;48;47;6;41;.872;3600000;0
44838;7630;94;0;0;0;0;.00nan;0;0
44838;7749;100;0;0;0;0;.00nan;0;0
44838;8314;94;69;28;2;26;.929;3600000;0
44839;7075;96;90;28;1;27;.964;3600000;0
44839;7155;86;0;0;0;0;.00nan;0;0
44839;7164;86;64;23;2;21;.913;3561000;0
44839;7735;96;0;0;0;0;.00nan;0;0
44840;6581;98;0;0;0;0;.00nan;0;0
44840;6731;95;0;0;0;0;.00nan;0;0
44840;7163;98;52;38;5;33;.868;3600000;0
44840;8168;95;77;18;1;17;.944;3600000;0
44841;6687;87;40;48;7;41;.854;3269000;0
44841;7716;89;54;25;3;22;.880;3600000;0
44841;7717;87;54;4;0;4;1.000;331000;0
44841;9226;89;0;0;0;0;.00nan;0;0
44842;6070;92;34;21;4;17;.810;3564000;0
44842;7654;97;71;33;3;30;.909;3600000;0
44842;7666;97;0;0;0;0;.00nan;0;0
44842;8103;92;0;0;0;0;.00nan;0;0
44843;6603;104;0;0;0;0;.00nan;0;0
44843;8126;104;57;43;5;38;.884;3600000;0
44843;9227;90;0;0;0;0;.00nan;0;0
44843;9274;90;54;19;3;16;.842;3600000;0
44844;6663;85;0;0;0;0;.00nan;0;0
44844;7075;96;32;32;6;26;.813;2784000;0
44844;7142;85;70;19;1;18;.947;3600000;0
44844;7735;96;68;15;0;15;1.000;816000;0
44845;7211;103;0;0;0;0;.00nan;0;0
44845;8154;103;48;11;2;9;.818;3600000;0
44845;8236;101;26;48;8;40;.833;2695000;0
44845;9275;101;14;12;5;7;.583;905000;0
44846;6627;100;0;0;0;0;.00nan;0;0
44846;6683;91;30;25;6;19;.760;3202000;0
44846;7749;100;42;35;6;29;.829;3600000;0
44846;9245;91;39;1;1;0;.000;340000;0
44847;7078;99;50;7;1;6;.857;3600000;0
44847;7654;97;0;0;0;0;.00nan;0;0
44847;7666;97;59;51;6;45;.882;3600000;0
44847;8104;99;0;0;0;0;.00nan;0;0
44848;6070;92;54;24;3;21;.875;3600000;0
44848;6603;104;95;38;1;37;.974;3600000;0
44848;8103;92;0;0;0;0;.00nan;0;0
44848;8126;104;0;0;0;0;.00nan;0;0
44849;6663;85;57;26;3;23;.885;3554000;0
44849;7142;85;0;0;0;0;.00nan;0;0
44849;8165;88;89;38;2;36;.947;3600000;0
44849;9279;88;0;0;0;0;.00nan;0;0
44850;7075;96;0;0;0;0;.00nan;0;0
44850;7716;89;0;0;0;0;.00nan;0;0
44850;7735;96;100;54;0;54;1.000;3600000;0
44850;9226;89;38;27;5;22;.815;3600000;0
44851;7630;94;24;39;7;32;.821;3600000;0
44851;8314;94;0;0;0;0;.00nan;0;0
44851;8320;93;0;0;0;0;.00nan;0;0
44851;9273;93;95;31;1;30;.968;3600000;0
44852;6683;91;0;0;0;0;.00nan;0;0
44852;6731;95;53;31;4;27;.871;3690000;0
44852;8168;95;0;0;0;0;.00nan;0;0
44852;9245;91;69;32;3;29;.906;3690000;0
44853;8105;102;36;25;5;20;.800;3600000;0
44853;8236;101;59;39;4;35;.897;3600000;0
44853;8745;102;0;0;0;0;.00nan;0;0
44853;9275;101;0;0;0;0;.00nan;0;0
44854;7078;99;0;0;0;0;.00nan;0;0
44854;8104;99;44;28;4;24;.857;3600000;0
44854;8320;93;76;27;1;26;.963;3600000;0
44854;9273;93;0;0;0;0;.00nan;0;0
44855;6581;98;63;33;4;29;.879;3570000;0
44855;6683;91;73;30;2;28;.933;3600000;0
44855;7163;98;0;0;0;0;.00nan;0;0
44855;9245;91;0;0;0;0;.00nan;0;0
44856;6663;85;0;0;0;0;.00nan;0;0
44856;7142;85;51;27;4;23;.852;3600000;0
44856;9227;90;16;10;4;6;.600;996000;0
44856;9274;90;36;23;4;19;.826;2604000;0
44857;6687;87;60;43;6;37;.860;3600000;0
44857;7630;94;0;0;0;0;.00nan;0;0
44857;7717;87;0;0;0;0;.00nan;0;0
44857;8314;94;50;24;3;21;.875;3600000;0
44858;7155;86;0;0;0;0;.00nan;0;0
44858;7164;86;48;28;4;24;.857;3600000;0
44858;8165;88;0;0;0;0;.00nan;0;0
44858;9279;88;32;25;5;20;.800;3568000;0
44859;6070;92;0;0;0;0;.00nan;0;0
44859;8103;92;79;41;3;38;.927;3600000;0
44859;8105;102;0;0;0;0;.00nan;0;0
44859;8745;102;50;31;4;27;.871;3554000;0
44860;6627;100;46;39;6;33;.846;2747000;0
44860;7211;103;47;18;4;14;.778;3600000;0
44860;7749;100;45;19;3;16;.842;853000;0
44860;8154;103;0;0;0;0;.00nan;0;0
44861;7654;97;56;5;0;5;1.000;314000;0
44861;7666;97;84;39;3;36;.923;3405000;0
44861;8236;101;36;19;4;15;.789;3719000;0
44861;9275;101;0;0;0;0;.00nan;0;0
44862;6603;104;0;0;0;0;.00nan;0;0
44862;8105;102;0;0;0;0;.00nan;0;0
44862;8126;104;91;46;3;43;.935;3900000;0
44862;8745;102;58;26;3;23;.885;3900000;0
44863;6683;91;53;43;5;38;.884;3600000;0
44863;7630;94;49;14;2;12;.857;1540000;0
44863;8314;94;19;12;4;8;.667;2060000;0
44863;9245;91;0;0;0;0;.00nan;0;0
44864;6581;98;0;0;0;0;.00nan;0;0
44864;7078;99;44;11;2;9;.818;3600000;0
44864;7163;98;72;52;5;47;.904;3600000;0
44864;8104;99;0;0;0;0;.00nan;0;0
44865;7630;94;0;0;0;0;.00nan;0;0
44865;8314;94;31;27;5;22;.815;3585000;0
44865;9227;90;75;37;3;34;.919;3600000;0
44865;9274;90;0;0;0;0;.00nan;0;0
44866;7155;86;0;0;0;0;.00nan;0;0
44866;7164;86;64;47;5;42;.894;3600000;0
44866;8320;93;0;0;0;0;.00nan;0;0
44866;9273;93;58;14;1;13;.929;3600000;0
44867;6627;100;70;66;6;60;.909;3600000;0
44867;7211;103;0;0;0;0;.00nan;0;0
44867;7749;100;0;0;0;0;.00nan;0;0
44867;8154;103;50;14;2;12;.857;3600000;0
44868;6603;104;0;0;0;0;.00nan;0;0
44868;6663;85;0;0;0;0;.00nan;0;0
44868;7142;85;59;20;2;18;.900;3600000;0
44868;8126;104;76;41;3;38;.927;3561000;0
44869;8165;88;63;33;3;30;.909;3600000;0
44869;8320;93;2;30;8;22;.733;2829000;0
44869;9273;93;47;6;1;5;.833;771000;0
44869;9279;88;0;0;0;0;.00nan;0;0
44870;7155;86;80;49;4;45;.918;3600000;0
44870;7164;86;0;0;0;0;.00nan;0;0
44870;7716;89;83;24;1;23;.958;3600000;0
44870;9226;89;0;0;0;0;.00nan;0;0
44871;6581;98;17;21;6;15;.714;3600000;0
44871;7163;98;0;0;0;0;.00nan;0;0
44871;7666;97;0;0;0;0;.00nan;0;0
44871;9287;97;89;37;1;36;.973;3600000;0
44872;7075;96;100;33;0;33;1.000;3423000;0
44872;7735;96;35;11;3;8;.727;477000;0
44872;8105;102;0;0;0;0;.00nan;0;0
44872;8745;102;58;23;3;20;.870;3900000;0
44873;6070;92;59;23;3;20;.870;3600000;0
44873;6687;87;78;39;4;35;.897;3600000;0
44873;7717;87;0;0;0;0;.00nan;0;0
44873;8103;92;0;0;0;0;.00nan;0;0
44874;7211;103;56;13;1;12;.923;3600000;0
44874;8154;103;0;0;0;0;.00nan;0;0
44874;8236;101;60;58;6;52;.897;2776000;0
44874;9275;101;63;12;0;12;1.000;824000;0
44875;6683;91;56;27;3;24;.889;3600000;0
44875;9227;90;25;7;3;4;.571;696000;0
44875;9245;91;0;0;0;0;.00nan;0;0
44875;9274;90;29;31;6;25;.806;2904000;0
44876;6070;92;0;0;0;0;.00nan;0;0
44876;7716;89;0;0;0;0;.00nan;0;0
44876;8103;92;80;40;3;37;.925;3590000;0
44876;9226;89;72;31;2;29;.935;3600000;0
44877;7075;96;0;0;0;0;.00nan;0;0
44877;7078;99;65;17;1;16;.941;3600000;0
44877;7735;96;50;46;5;41;.891;3600000;0
44877;8104;99;0;0;0;0;.00nan;0;0
44878;6603;104;59;42;5;37;.881;3730000;0
44878;6731;95;0;0;0;0;.00nan;0;0
44878;8126;104;0;0;0;0;.00nan;0;0
44878;8168;95;25;23;6;17;.739;3730000;0
44879;7666;97;0;0;0;0;.00nan;0;0
44879;8320;93;0;0;0;0;.00nan;0;0
44879;9273;93;54;13;2;11;.846;3600000;0
44879;9287;97;94;51;3;48;.941;3600000;0
44880;6687;87;46;35;6;29;.829;3600000;0
44880;7155;86;0;0;0;0;.00nan;0;0
44880;7164;86;46;31;5;26;.839;3600000;0
44880;7717;87;0;0;0;0;.00nan;0;0
44881;6663;85;67;25;2;23;.920;3600000;0
44881;7142;85;0;0;0;0;.00nan;0;0
44881;8105;102;48;25;3;22;.880;3574000;0
44881;8745;102;0;0;0;0;.00nan;0;0
44882;6627;100;62;38;5;33;.868;3600000;0
44882;7749;100;0;0;0;0;.00nan;0;0
44882;8165;88;0;0;0;0;.00nan;0;0
44882;9279;88;95;39;2;37;.949;3600000;0
44883;6581;98;0;0;0;0;.00nan;0;0
44883;7163;98;62;27;3;24;.889;3528000;0
44883;7666;97;100;42;1;41;.976;3600000;0
44883;9287;97;0;0;0;0;.00nan;0;0
44884;7630;94;0;0;0;0;.00nan;0;0
44884;7716;89;30;28;6;22;.786;2783000;0
44884;8314;94;46;27;4;23;.852;3600000;0
44884;9226;89;60;5;0;5;1.000;784000;0
44885;6687;87;56;36;4;32;.889;3106000;0
44885;7078;99;0;0;0;0;.00nan;0;0
44885;7717;87;33;10;3;7;.700;494000;0
44885;8104;99;31;17;4;13;.765;3600000;0
44886;6663;85;0;0;0;0;.00nan;0;0
44886;7142;85;94;32;1;31;.969;3600000;0
44886;8236;101;63;29;3;26;.897;3538000;0
44886;9275;101;0;0;0;0;.00nan;0;0
44887;7211;103;0;0;0;0;.00nan;0;0
44887;8154;103;43;18;3;15;.833;3600000;0
44887;9227;90;59;49;6;43;.878;3600000;0
44887;9274;90;0;0;0;0;.00nan;0;0
44888;6070;92;98;51;3;48;.941;3900000;0
44888;6683;91;32;15;3;12;.800;3900000;0
44888;8103;92;0;0;0;0;.00nan;0;0
44888;9245;91;0;0;0;0;.00nan;0;0
44889;6627;100;0;0;0;0;.00nan;0;0
44889;6731;95;53;31;4;27;.871;3562000;0
44889;7749;100;68;26;2;24;.923;3600000;0
44889;8168;95;0;0;0;0;.00nan;0;0
44890;6663;85;37;22;4;18;.818;3600000;0
44890;7142;85;0;0;0;0;.00nan;0;0
44890;9227;90;51;2;0;2;1.000;384000;0
44890;9274;90;25;35;6;29;.829;3152000;0
44891;8165;88;16;23;6;17;.739;2369000;0
44891;8320;93;0;0;0;0;.00nan;0;0
44891;9273;93;35;20;4;16;.800;3600000;0
44891;9279;88;48;13;2;11;.846;1231000;0
44892;6603;104;0;0;0;0;.00nan;0;0
44892;6627;100;73;29;2;27;.931;3600000;0
44892;7749;100;0;0;0;0;.00nan;0;0
44892;8126;104;68;34;3;31;.912;3600000;0
44893;7075;96;70;30;3;27;.900;3600000;0
44893;7666;97;0;0;0;0;.00nan;0;0
44893;7735;96;0;0;0;0;.00nan;0;0
44893;9287;97;28;24;6;18;.750;3600000;0
44894;6731;95;59;6;0;6;1.000;260000;0
44894;8168;95;49;48;6;42;.875;3340000;0
44894;8320;93;38;20;4;16;.800;3600000;0
44894;9273;93;0;0;0;0;.00nan;0;0
44895;6070;92;68;26;3;23;.885;3600000;0
44895;8103;92;0;0;0;0;.00nan;0;0
44895;9227;90;68;23;2;21;.913;3600000;0
44895;9274;90;0;0;0;0;.00nan;0;0
44896;7630;94;0;0;0;0;.00nan;0;0
44896;8236;101;17;34;7;27;.794;3543000;0
44896;8314;94;38;38;6;32;.842;3600000;0
44896;9275;101;0;0;0;0;.00nan;0;0
44897;6687;87;93;52;1;51;.981;3600000;0
44897;7155;86;0;0;0;0;.00nan;0;0
44897;7164;86;69;32;3;29;.906;3534000;0
44897;7717;87;0;0;0;0;.00nan;0;0
44898;6627;100;46;6;1;5;.833;475000;0
44898;7211;103;65;15;1;14;.933;3600000;0
44898;7749;100;31;50;9;41;.820;3125000;0
44898;8154;103;0;0;0;0;.00nan;0;0
44899;6581;98;0;0;0;0;.00nan;0;0
44899;6603;104;62;6;0;6;1.000;565000;0
44899;7163;98;57;37;5;32;.865;3900000;0
44899;8126;104;59;42;5;37;.881;3335000;0
44900;6687;87;70;47;6;41;.872;3109000;0
44900;7716;89;54;23;3;20;.870;3600000;0
44900;7717;87;43;5;1;4;.800;491000;0
44900;9226;89;0;0;0;0;.00nan;0;0
44901;7666;97;38;43;7;36;.837;3600000;0
44901;8165;88;67;18;1;17;.944;3600000;0
44901;9279;88;0;0;0;0;.00nan;0;0
44901;9287;97;0;0;0;0;.00nan;0;0
44902;7075;96;65;44;6;38;.864;2398000;0
44902;7078;99;42;15;3;12;.800;3600000;0
44902;7735;96;72;28;2;26;.929;1202000;0
44902;8104;99;0;0;0;0;.00nan;0;0
44903;6731;95;0;0;0;0;.00nan;0;0
44903;8168;95;77;27;2;25;.926;3600000;0
44903;9227;90;80;34;3;31;.912;3554000;0
44903;9274;90;0;0;0;0;.00nan;0;0
44904;6663;85;67;13;0;13;1.000;1356000;0
44904;7142;85;20;23;6;17;.739;2244000;0
44904;8320;93;0;0;0;0;.00nan;0;0
44904;9273;93;50;18;2;16;.889;3600000;0
44905;7211;103;0;0;0;0;.00nan;0;0
44905;8105;102;0;0;0;0;.00nan;0;0
44905;8154;103;61;24;3;21;.875;3600000;0
44905;8745;102;68;51;6;45;.882;3600000;0
44906;6683;91;48;25;4;21;.840;3817000;0
44906;8236;101;0;0;0;0;.00nan;0;0
44906;9245;91;0;0;0;0;.00nan;0;0
44906;9275;101;62;23;3;20;.870;3817000;0
44907;6070;92;73;30;2;28;.933;3600000;0
44907;7666;97;0;0;0;0;.00nan;0;0
44907;8103;92;0;0;0;0;.00nan;0;0
44907;9287;97;43;23;4;19;.826;3534000;0
44908;6581;98;58;33;4;29;.879;3600000;0
44908;7075;96;55;38;6;32;.842;3585000;0
44908;7163;98;0;0;0;0;.00nan;0;0
44908;7735;96;0;0;0;0;.00nan;0;0
44909;7155;86;0;0;0;0;.00nan;0;0
44909;7164;86;43;30;5;25;.833;3545000;0
44909;8165;88;0;0;0;0;.00nan;0;0
44909;9279;88;48;29;4;25;.862;3600000;0
44910;6683;91;0;0;0;0;.00nan;0;0
44910;9227;90;0;0;0;0;.00nan;0;0
44910;9245;91;31;31;6;25;.806;3521000;0
44910;9274;90;80;44;4;40;.909;3600000;0
44911;6603;104;99;27;0;27;1.000;3600000;0
44911;6731;95;72;40;3;37;.925;3600000;0
44911;8126;104;0;0;0;0;.00nan;0;0
44911;8168;95;0;0;0;0;.00nan;0;0
44912;6627;100;68;46;5;41;.891;3555000;0
44912;7749;100;0;0;0;0;.00nan;0;0
44912;8105;102;0;0;0;0;.00nan;0;0
44912;8745;102;64;39;4;35;.897;3600000;0
44913;7716;89;0;0;0;0;.00nan;0;0
44913;8320;93;49;21;3;18;.857;3600000;0
44913;9226;89;77;61;5;56;.918;3568000;0
44913;9273;93;0;0;0;0;.00nan;0;0
44914;6070;92;78;61;7;54;.885;3600000;0
44914;7630;94;0;0;0;0;.00nan;0;0
44914;8103;92;0;0;0;0;.00nan;0;0
44914;8314;94;60;14;1;13;.929;3600000;0
44915;6683;91;49;22;3;19;.864;3600000;0
44915;6687;87;54;36;6;30;.833;3600000;0
44915;7717;87;0;0;0;0;.00nan;0;0
44915;9245;91;0;0;0;0;.00nan;0;0
44916;6581;98;0;0;0;0;.00nan;0;0
44916;7155;86;63;17;1;16;.941;3600000;0
44916;7163;98;41;47;7;40;.851;3600000;0
44916;7164;86;0;0;0;0;.00nan;0;0
44917;7211;103;57;13;1;12;.923;3600000;0
44917;8154;103;0;0;0;0;.00nan;0;0
44917;8236;101;0;0;0;0;.00nan;0;0
44917;9275;101;88;45;2;43;.956;3600000;0
44918;6663;85;0;0;0;0;.00nan;0;0
44918;7142;85;24;23;5;18;.783;3600000;0
44918;7155;86;0;0;0;0;.00nan;0;0
44918;7164;86;79;37;2;35;.946;3600000;0
44919;7075;96;39;28;5;23;.821;3557000;0
44919;7666;97;51;22;3;19;.864;3600000;0
44919;7735;96;0;0;0;0;.00nan;0;0
44919;9287;97;0;0;0;0;.00nan;0;0
44920;6070;92;86;70;7;63;.900;3600000;0
44920;8103;92;0;0;0;0;.00nan;0;0
44920;8320;93;0;0;0;0;.00nan;0;0
44920;9273;93;54;10;1;9;.900;3600000;0
44921;6687;87;52;37;5;32;.865;3600000;0
44921;7717;87;0;0;0;0;.00nan;0;0
44921;8165;88;76;33;2;31;.939;3600000;0
44921;9279;88;0;0;0;0;.00nan;0;0
44922;6581;98;0;0;0;0;.00nan;0;0
44922;7163;98;78;51;5;46;.902;3600000;0
44922;8236;101;0;0;0;0;.00nan;0;0
44922;9275;101;39;15;3;12;.800;3600000;0
44923;7211;103;90;20;0;20;1.000;3600000;0
44923;8105;102;47;29;4;25;.862;1864000;0
44923;8154;103;0;0;0;0;.00nan;0;0
44923;8745;102;18;24;6;18;.750;1736000;0
44924;7078;99;0;0;0;0;.00nan;0;0
44924;7630;94;0;0;0;0;.00nan;0;0
44924;8104;99;40;23;4;19;.826;3559000;0
44924;8314;94;94;52;2;50;.962;3600000;0
44925;6663;85;60;8;0;8;1.000;1256000;0
44925;7142;85;25;20;5;15;.750;2344000;0
44925;7155;86;42;20;4;16;.800;1495000;0
44925;7164;86;23;24;6;18;.750;2105000;0
44926;6603;104;92;34;1;33;.971;3600000;0
44926;6627;100;66;26;2;24;.923;3554000;0
44926;7749;100;0;0;0;0;.00nan;0;0
44926;8126;104;0;0;0;0;.00nan;0;0
44927;6581;98;0;0;0;0;.00nan;0;0
44927;7163;98;46;44;6;38;.864;3600000;0
44927;8105;102;0;0;0;0;.00nan;0;0
44927;8745;102;58;21;2;19;.905;3600000;0
44928;6070;92;98;82;5;77;.939;3900000;0
44928;8103;92;0;0;0;0;.00nan;0;0
44928;8165;88;0;0;0;0;.00nan;0;0
44928;9279;88;25;21;5;16;.762;3900000;0
44929;7155;86;0;0;0;0;.00nan;0;0
44929;7164;86;60;51;6;45;.882;3600000;0
44929;7716;89;53;22;3;19;.864;3600000;0
44929;9226;89;0;0;0;0;.00nan;0;0
44930;7075;96;37;36;6;30;.833;2444000;0
44930;7735;96;24;28;6;22;.786;1156000;0
44930;8236;101;53;10;1;9;.900;3600000;0
44930;9275;101;0;0;0;0;.00nan;0;0
44931;8320;93;0;0;0;0;.00nan;0;0
44931;9227;90;92;51;3;48;.941;3582000;0
44931;9273;93;64;13;1;12;.923;3600000;0
44931;9274;90;0;0;0;0;.00nan;0;0
44932;6663;85;0;0;0;0;.00nan;0;0
44932;6687;87;58;47;7;40;.851;3600000;0
44932;7142;85;94;39;2;37;.949;3600000;0
44932;7717;87;0;0;0;0;.00nan;0;0
44933;7211;103;63;12;1;11;.917;3600000;0
44933;7666;97;69;49;5;44;.898;3600000;0
44933;8154;103;0;0;0;0;.00nan;0;0
44933;9287;97;0;0;0;0;.00nan;0;0
44934;6683;91;74;38;3;35;.921;3600000;0
44934;7078;99;30;34;6;28;.824;2876000;0
44934;8104;99;50;8;1;7;.875;724000;0
44934;9245;91;0;0;0;0;.00nan;0;0
44935;6070;92;56;39;5;34;.872;2136000;0
44935;7630;94;0;0;0;0;.00nan;0;0
44935;8103;92;50;22;3;19;.864;1464000;0
44935;8314;94;57;16;2;14;.875;3600000;0
44936;6603;104;0;0;0;0;.00nan;0;0
44936;7666;97;85;37;3;34;.919;3092000;0
44936;8126;104;34;16;4;12;.750;3600000;0
44936;9287;97;16;6;4;2;.333;508000;0
44937;6581;98;60;39;4;35;.897;3600000;0
44937;6687;87;45;19;3;16;.842;3600000;0
44937;7163;98;0;0;0;0;.00nan;0;0
44937;7717;87;0;0;0;0;.00nan;0;0
44938;6731;95;88;39;2;37;.949;3600000;0
44938;8105;102;0;0;0;0;.00nan;0;0
44938;8168;95;0;0;0;0;.00nan;0;0
44938;8745;102;7;22;7;15;.682;3600000;0
44939;7075;96;65;43;5;38;.884;3673000;0
44939;7735;96;0;0;0;0;.00nan;0;0
44939;8236;101;0;0;0;0;.00nan;0;0
44939;9275;101;49;31;4;27;.871;3673000;0
44940;7078;99;41;38;5;33;.868;3575000;0
44940;7211;103;0;0;0;0;.00nan;0;0
44940;8104;99;0;0;0;0;.00nan;0;0
44940;8154;103;58;32;4;28;.875;3600000;0
44941;6627;100;0;0;0;0;.00nan;0;0
44941;7749;100;79;32;2;30;.938;3600000;0
44941;9227;90;40;39;6;33;.846;3600000;0
44941;9274;90;0;0;0;0;.00nan;0;0
44942;7716;89;42;18;3;15;.833;819000;0
44942;8165;88;34;21;5;16;.762;3600000;0
44942;9226;89;43;35;6;29;.829;2781000;0
44942;9279;88;0;0;0;0;.00nan;0;0
44943;6683;91;46;48;7;41;.854;2804000;0
44943;8320;93;30;20;5;15;.750;3600000;0
44943;9245;91;56;8;0;8;1.000;759000;0
44943;9273;93;0;0;0;0;.00nan;0;0
44944;6581;98;0;0;0;0;.00nan;0;0
44944;6731;95;58;23;3;20;.870;3600000;0
44944;7163;98;73;49;5;44;.898;3600000;0
44944;8168;95;0;0;0;0;.00nan;0;0
44945;7666;97;0;0;0;0;.00nan;0;0
44945;8165;88;0;0;0;0;.00nan;0;0
44945;9279;88;48;22;3;19;.864;3600000;0
44945;9287;97;32;50;8;42;.840;3600000;0
44946;6070;92;85;52;4;48;.923;3600000;0
44946;7716;89;49;20;3;17;.850;3600000;0
44946;8103;92;0;0;0;0;.00nan;0;0
44946;9226;89;0;0;0;0;.00nan;0;0
44947;6627;100;53;22;3;19;.864;3600000;0
44947;7075;96;55;49;6;43;.878;2944000;0
44947;7735;96;51;9;1;8;.889;656000;0
44947;7749;100;0;0;0;0;.00nan;0;0
44948;8105;102;0;0;0;0;.00nan;0;0
44948;8745;102;56;32;4;28;.875;3600000;0
44948;9227;90;0;0;0;0;.00nan;0;0
44948;9274;90;89;29;1;28;.966;3600000;0
44949;6687;87;66;55;6;49;.891;3600000;0
44949;7717;87;0;0;0;0;.00nan;0;0
44949;8320;93;0;0;0;0;.00nan;0;0
44949;9273;93;48;12;2;10;.833;3600000;0
44950;6663;85;0;0;0;0;.00nan;0;0
44950;7142;85;56;29;4;25;.862;3600000;0
44950;7630;94;0;0;0;0;.00nan;0;0
44950;8314;94;22;28;6;22;.786;3518000;0
44951;6683;91;0;0;0;0;.00nan;0;0
44951;7155;86;0;0;0;0;.00nan;0;0
44951;7164;86;63;34;3;31;.912;3546000;0
44951;9245;91;63;23;2;21;.913;3600000;0
44952;6603;104;0;0;0;0;.00nan;0;0
44952;8126;104;61;26;3;23;.885;3600000;0
44952;8236;101;0;0;0;0;.00nan;0;0
44952;9275;101;52;31;4;27;.871;3554000;0
44953;6731;95;48;34;5;29;.853;3600000;0
44953;7078;99;51;2;0;2;1.000;900000;0
44953;8104;99;26;29;6;23;.793;2647000;0
44953;8168;95;0;0;0;0;.00nan;0;0
44954;6070;92;46;54;8;46;.852;3600000;0
44954;7078;99;21;16;5;11;.688;3600000;0
44954;8103;92;0;0;0;0;.00nan;0;0
44954;8104;99;0;0;0;0;.00nan;0;0
44955;7211;103;36;30;6;24;.800;3900000;0
44955;8154;103;0;0;0;0;.00nan;0;0
44955;8320;93;19;27;6;21;.778;3900000;0
44955;9273;93;0;0;0;0;.00nan;0;0
44956;6627;100;0;0;0;0;.00nan;0;0
44956;7155;86;0;0;0;0;.00nan;0;0
44956;7164;86;73;36;3;33;.917;3600000;0
44956;7749;100;47;33;4;29;.879;3600000;0
44957;6581;98;53;19;2;17;.895;1597000;0
44957;7163;98;1;29;9;20;.690;2003000;0
44957;7211;103;0;0;0;0;.00nan;0;0
44957;8154;103;56;13;2;11;.846;3600000;0
44958;7716;89;49;33;5;28;.848;3600000;0
44958;9226;89;0;0;0;0;.00nan;0;0
44958;9227;90;60;21;2;19;.905;3600000;0
44958;9274;90;0;0;0;0;.00nan;0;0
44959;6731;95;68;24;2;22;.917;3600000;0
44959;7666;97;48;37;6;31;.838;3170000;0
44959;8168;95;0;0;0;0;.00nan;0;0
44959;9287;97;45;5;1;4;.800;430000;0
44960;7075;96;0;0;0;0;.00nan;0;0
44960;7735;96;95;34;1;33;.971;3600000;0
44960;8236;101;0;0;0;0;.00nan;0;0
44960;9275;101;58;21;2;19;.905;3544000;0
44961;6683;91;25;32;7;25;.781;2105000;0
44961;8320;93;0;0;0;0;.00nan;0;0
44961;9245;91;35;14;3;11;.786;1495000;0
44961;9273;93;24;11;4;7;.636;3600000;0
44962;6687;87;82;34;2;32;.941;3600000;0
44962;7155;86;52;25;4;21;.840;3549000;0
44962;7164;86;0;0;0;0;.00nan;0;0
44962;7717;87;0;0;0;0;.00nan;0;0
44963;6627;100;61;39;4;35;.897;3900000;0
44963;6663;85;28;10;3;7;.700;568000;0
44963;7142;85;65;16;1;15;.938;3332000;0
44963;7749;100;0;0;0;0;.00nan;0;0
44964;7630;94;63;25;2;23;.920;3600000;0
44964;8105;102;30;11;3;8;.727;451000;0
44964;8314;94;0;0;0;0;.00nan;0;0
44964;8745;102;74;37;3;34;.919;3149000;0
44965;6070;92;74;27;2;25;.926;3600000;0
44965;6687;87;80;28;3;25;.893;3551000;0
44965;7717;87;0;0;0;0;.00nan;0;0
44965;8103;92;0;0;0;0;.00nan;0;0
44966;6683;91;22;29;7;22;.759;2920000;0
44966;7078;99;0;0;0;0;.00nan;0;0
44966;8104;99;88;26;1;25;.962;3600000;0
44966;9245;91;36;15;3;12;.800;680000;0
44967;6603;104;0;0;0;0;.00nan;0;0
44967;7630;94;0;0;0;0;.00nan;0;0
44967;8126;104;10;47;10;37;.787;3600000;0
44967;8314;94;54;25;3;22;.880;3600000;0
44968;7716;89;0;0;0;0;.00nan;0;0
44968;8165;88;59;35;4;31;.886;3900000;0
44968;9226;89;91;44;4;40;.909;3900000;0
44968;9279;88;0;0;0;0;.00nan;0;0
44969;6663;85;71;31;3;28;.903;3673000;0
44969;7142;85;0;0;0;0;.00nan;0;0
44969;9227;90;0;0;0;0;.00nan;0;0
44969;9274;90;78;30;2;28;.933;3673000;0
44970;6731;95;47;22;3;19;.864;3600000;0
44970;7075;96;78;44;4;40;.909;3575000;0
44970;7735;96;0;0;0;0;.00nan;0;0
44970;8168;95;0;0;0;0;.00nan;0;0
44971;8105;102;0;0;0;0;.00nan;0;0
44971;8236;101;49;34;4;30;.882;3577000;0
44971;8745;102;99;48;2;46;.958;3600000;0
44971;9275;101;0;0;0;0;.00nan;0;0
44972;6603;104;76;31;2;29;.935;3600000;0
44972;8105;102;0;0;0;0;.00nan;0;0
44972;8126;104;0;0;0;0;.00nan;0;0
44972;8745;102;42;38;6;32;.842;3600000;0
44973;6581;98;0;0;0;0;.00nan;0;0
44973;7075;96;63;46;5;41;.891;3600000;0
44973;7163;98;60;12;1;11;.917;3600000;0
44973;7735;96;0;0;0;0;.00nan;0;0
44974;6683;91;42;3;1;2;.667;355000;0
44974;8165;88;0;0;0;0;.00nan;0;0
44974;9245;91;35;39;6;33;.846;3245000;0
44974;9279;88;63;24;2;22;.917;3600000;0
44975;6627;100;77;31;2;29;.935;3600000;0
44975;7716;89;55;36;4;32;.889;3553000;0
44975;7749;100;0;0;0;0;.00nan;0;0
44975;9226;89;0;0;0;0;.00nan;0;0
44976;7211;103;73;18;1;17;.944;3600000;0
44976;7666;97;0;0;0;0;.00nan;0;0
44976;8154;103;0;0;0;0;.00nan;0;0
44976;9287;97;54;36;5;31;.861;3600000;0
44977;6070;92;50;56;9;47;.839;3184000;0
44977;8103;92;33;11;3;8;.727;416000;0
44977;8320;93;49;6;1;5;.833;3600000;0
44977;9273;93;0;0;0;0;.00nan;0;0
44978;6663;85;0;0;0;0;.00nan;0;0
44978;6687;87;68;50;6;44;.880;3600000;0
44978;7142;85;56;29;3;26;.897;3600000;0
44978;7717;87;0;0;0;0;.00nan;0;0
44979;7630;94;82;30;2;28;.933;3600000;0
44979;8236;101;52;4;0;4;1.000;660000;0
44979;8314;94;0;0;0;0;.00nan;0;0
44979;9275;101;28;30;6;24;.800;2940000;0
44980;7078;99;59;32;3;29;.906;3900000;0
44980;8104;99;0;0;0;0;.00nan;0;0
44980;8165;88;40;20;3;17;.850;3900000;0
44980;9279;88;0;0;0;0;.00nan;0;0
44981;6581;98;0;0;0;0;.00nan;0;0
44981;7163;98;43;30;5;25;.833;3581000;0
44981;9227;90;43;24;4;20;.833;3600000;0
44981;9274;90;0;0;0;0;.00nan;0;0
44982;6687;87;36;12;3;9;.750;605000;0
44982;7666;97;55;9;1;8;.889;1447000;0
44982;7717;87;67;20;1;19;.950;2995000;0
44982;9287;97;14;13;5;8;.615;2080000;0
44983;6663;85;0;0;0;0;.00nan;0;0
44983;7142;85;62;28;3;25;.893;3600000;0
44983;7716;89;60;41;5;36;.878;3586000;0
44983;9226;89;0;0;0;0;.00nan;0;0
44984;7211;103;37;14;3;11;.786;3600000;0
44984;8154;103;0;0;0;0;.00nan;0;0
44984;8236;101;63;17;1;16;.941;1374000;0
44984;9275;101;19;32;7;25;.781;2226000;0
44985;6070;92;57;42;6;36;.857;2592000;0
44985;8103;92;50;14;2;12;.857;1008000;0
44985;8165;88;0;0;0;0;.00nan;0;0
44985;9279;88;52;14;2;12;.857;3600000;0
44986;6683;91;66;42;5;37;.881;3600000;0
44986;7630;94;0;0;0;0;.00nan;0;0
44986;8314;94;83;29;1;28;.966;3600000;0
44986;9245;91;0;0;0;0;.00nan;0;0
44987;7155;86;0;0;0;0;.00nan;0;0
44987;7164;86;52;39;5;34;.872;3600000;0
44987;8105;102;0;0;0;0;.00nan;0;0
44987;8745;102;60;29;4;25;.862;3600000;0
44988;6627;100;0;0;0;0;.00nan;0;0
44988;7075;96;70;34;3;31;.912;3600000;0
44988;7735;96;0;0;0;0;.00nan;0;0
44988;7749;100;39;28;4;24;.857;3554000;0
45096;6663;85;52;12;1;11;.917;3600000;0
45096;6687;87;56;42;5;37;.881;2295000;0
45096;7142;85;0;0;0;0;.00nan;0;0
45096;7717;87;50;13;2;11;.846;1305000;0
45098;6603;104;38;26;5;21;.808;2051000;0
45098;7211;103;63;18;2;16;.889;3600000;0
45098;8126;104;55;22;2;20;.909;1549000;0
45098;8220;103;0;0;0;0;.00nan;0;0
45100;7164;101;0;0;0;0;.00nan;0;0
45100;8104;92;0;0;0;0;.00nan;0;0
45100;8107;92;35;36;6;30;.833;3600000;0
45100;8236;101;72;33;2;31;.939;3600000;0
45102;7115;88;37;31;6;25;.806;3600000;0
45102;8105;102;0;0;0;0;.00nan;0;0
45102;8165;88;0;0;0;0;.00nan;0;0
45102;8745;102;62;32;3;29;.906;3600000;0
45104;6731;95;21;28;7;21;.750;1637000;0
45104;8103;93;49;27;4;23;.852;3600000;0
45104;8168;95;56;28;3;25;.893;1963000;0
45104;8320;93;0;0;0;0;.00nan;0;0
45106;6683;91;57;30;4;26;.867;3516000;0
45106;7716;89;74;25;2;23;.920;3600000;0
45106;8154;91;0;0;0;0;.00nan;0;0
45106;9226;89;0;0;0;0;.00nan;0;0
45108;7091;94;0;0;0;0;.00nan;0;0
45108;7654;97;92;41;1;40;.976;3900000;0
45108;7666;97;0;0;0;0;.00nan;0;0
45108;8101;94;81;26;1;25;.962;3900000;0
45110;7075;96;51;37;5;32;.865;3600000;0
45110;7155;86;79;25;2;23;.920;3600000;0
45110;7735;96;0;0;0;0;.00nan;0;0
45110;8322;86;0;0;0;0;.00nan;0;0
45112;6581;98;0;0;0;0;.00nan;0;0
45112;7163;98;55;50;6;44;.880;3600000;0
45112;7218;99;46;19;3;16;.842;3600000;0
45112;7227;99;0;0;0;0;.00nan;0;0
45114;6627;100;0;0;0;0;.00nan;0;0
45114;7078;100;85;33;1;32;.970;3600000;0
45114;7762;90;0;0;0;0;.00nan;0;0
45114;9227;90;38;23;4;19;.826;3600000;0
45116;6627;100;51;49;6;43;.878;3872000;0
45116;7078;100;0;0;0;0;.00nan;0;0
45116;7211;103;0;0;0;0;.00nan;0;0
45116;8220;103;37;25;5;20;.800;3872000;0
45118;6683;91;46;17;3;14;.824;3600000;0
45118;7716;89;39;36;6;30;.833;3050000;0
45118;8154;91;0;0;0;0;.00nan;0;0
45118;9226;89;56;4;0;4;1.000;550000;0
45120;6581;98;43;22;4;18;.818;877000;0
45120;7163;98;83;35;2;33;.943;2723000;0
45120;7164;101;47;13;2;11;.846;3600000;0
45120;8236;101;0;0;0;0;.00nan;0;0
45122;6603;104;0;0;0;0;.00nan;0;0
45122;7115;88;0;0;0;0;.00nan;0;0
45122;8126;104;37;30;5;25;.833;3600000;0
45122;8165;88;74;28;2;26;.929;3600000;0
45124;6663;85;0;0;0;0;.00nan;0;0
45124;7142;85;39;16;3;13;.813;3600000;0
45124;7654;97;20;17;5;12;.706;1546000;0
45124;7666;97;43;29;4;25;.862;2054000;0
45126;6687;87;56;37;5;32;.865;3575000;0
45126;7218;99;0;0;0;0;.00nan;0;0
45126;7227;99;53;27;3;24;.889;3600000;0
45126;7717;87;0;0;0;0;.00nan;0;0
45128;7075;96;0;0;0;0;.00nan;0;0
45128;7735;96;34;36;6;30;.833;3569000;0
45128;8105;102;39;27;5;22;.815;3600000;0
45128;8745;102;0;0;0;0;.00nan;0;0
45130;6731;95;95;37;2;35;.946;3900000;0
45130;7155;86;0;0;0;0;.00nan;0;0
45130;8168;95;0;0;0;0;.00nan;0;0
45130;8322;86;76;36;2;34;.944;3900000;0
45132;7091;94;0;0;0;0;.00nan;0;0
45132;8101;94;66;36;3;33;.917;3848000;0
45132;8103;93;0;0;0;0;.00nan;0;0
45132;8320;93;49;28;4;24;.857;3864000;0
45134;7762;90;43;16;3;13;.813;3600000;0
45134;8104;92;35;24;5;19;.792;3567000;0
45134;8107;92;0;0;0;0;.00nan;0;0
45134;9227;90;0;0;0;0;.00nan;0;0
45136;6603;104;71;36;3;33;.917;3600000;0
45136;6627;100;0;0;0;0;.00nan;0;0
45136;7078;100;10;27;7;20;.741;3600000;0
45136;8126;104;0;0;0;0;.00nan;0;0
45138;6731;95;0;0;0;0;.00nan;0;0
45138;7164;101;0;0;0;0;.00nan;0;0
45138;8168;95;41;26;4;22;.846;3600000;0
45138;8236;101;75;39;2;37;.949;3600000;0
45140;6581;98;38;27;4;23;.852;3900000;0
45140;7075;96;72;36;4;32;.889;3900000;0
45140;7163;98;0;0;0;0;.00nan;0;0
45140;7735;96;0;0;0;0;.00nan;0;0
45142;6687;87;96;39;2;37;.949;3600000;0
45142;7091;94;75;23;1;22;.957;3600000;0
45142;7717;87;0;0;0;0;.00nan;0;0
45142;8101;94;0;0;0;0;.00nan;0;0
45144;6663;85;24;12;4;8;.667;3600000;0
45144;7142;85;0;0;0;0;.00nan;0;0
45144;7654;97;0;0;0;0;.00nan;0;0
45144;7666;97;38;56;8;48;.857;3600000;0
45146;6683;91;0;0;0;0;.00nan;0;0
45146;7211;103;54;25;3;22;.880;3600000;0
45146;8154;91;59;46;6;40;.870;3600000;0
45146;8220;103;0;0;0;0;.00nan;0;0
45148;7115;88;73;49;6;43;.878;3232000;0
45148;8103;93;55;19;2;17;.895;3600000;0
45148;8165;88;54;3;0;3;1.000;368000;0
45148;8320;93;0;0;0;0;.00nan;0;0
45150;7155;86;27;32;6;26;.813;3553000;0
45150;8105;102;0;0;0;0;.00nan;0;0
45150;8322;86;0;0;0;0;.00nan;0;0
45150;8745;102;55;30;4;26;.867;3600000;0
45152;7218;99;71;26;2;24;.923;3600000;0
45152;7227;99;0;0;0;0;.00nan;0;0
45152;7716;89;0;0;0;0;.00nan;0;0
45152;9226;89;68;45;5;40;.889;3600000;0
45154;7762;90;0;0;0;0;.00nan;0;0
45154;8104;92;0;0;0;0;.00nan;0;0
45154;8107;92;47;34;5;29;.853;3729000;0
45154;9227;90;65;36;4;32;.889;3729000;0
45156;7091;94;0;0;0;0;.00nan;0;0
45156;7716;89;0;0;0;0;.00nan;0;0
45156;8101;94;100;27;0;27;1.000;3600000;0
45156;9226;89;76;33;2;31;.939;3578000;0
45158;6581;98;67;15;0;15;1.000;678000;0
45158;7163;98;32;33;6;27;.818;2922000;0
45158;8103;93;41;13;3;10;.769;3600000;0
45158;8320;93;0;0;0;0;.00nan;0;0
45160;6731;95;63;32;4;28;.875;3560000;0
45160;7115;88;0;0;0;0;.00nan;0;0
45160;8165;88;58;25;3;22;.880;3600000;0
45160;8168;95;0;0;0;0;.00nan;0;0
45162;6687;87;62;35;4;31;.886;3578000;0
45162;7717;87;0;0;0;0;.00nan;0;0
45162;7762;90;47;20;3;17;.850;3600000;0
45162;9227;90;0;0;0;0;.00nan;0;0
45164;6683;91;26;20;5;15;.750;3552000;0
45164;7654;97;57;33;3;30;.909;3600000;0
45164;7666;97;0;0;0;0;.00nan;0;0
45164;8154;91;0;0;0;0;.00nan;0;0
45166;6663;85;0;0;0;0;.00nan;0;0
45166;7075;96;76;68;7;61;.897;3600000;0
45166;7142;85;75;10;0;10;1.000;3600000;0
45166;7735;96;0;0;0;0;.00nan;0;0
45168;7155;86;0;0;0;0;.00nan;0;0
45168;7218;99;0;0;0;0;.00nan;0;0
45168;7227;99;75;22;1;21;.955;3600000;0
45168;8322;86;59;43;6;37;.860;3600000;0
45170;7211;103;0;0;0;0;.00nan;0;0
45170;8104;92;29;47;8;39;.830;3289000;0
45170;8107;92;35;7;2;5;.714;311000;0
45170;8220;103;57;14;1;13;.929;3600000;0
45172;6603;104;0;0;0;0;.00nan;0;0
45172;7164;101;55;16;2;14;.875;3900000;0
45172;8126;104;84;35;2;33;.943;3900000;0
45172;8236;101;0;0;0;0;.00nan;0;0
45174;6627;100;34;24;5;19;.792;3574000;0
45174;7078;100;0;0;0;0;.00nan;0;0
45174;8105;102;0;0;0;0;.00nan;0;0
45174;8745;102;55;36;4;32;.889;3600000;0
45176;6731;95;0;0;0;0;.00nan;0;0
45176;8103;93;0;0;0;0;.00nan;0;0
45176;8168;95;90;35;1;34;.971;3600000;0
45176;8320;93;53;29;3;26;.897;3600000;0
45178;6663;85;0;0;0;0;.00nan;0;0
45178;7142;85;53;9;1;8;.889;3600000;0
45178;7155;86;89;49;3;46;.939;3547000;0
45178;8322;86;0;0;0;0;.00nan;0;0
45180;6683;91;0;0;0;0;.00nan;0;0
45180;7164;101;41;29;5;24;.828;3600000;0
45180;8154;91;57;16;2;14;.875;3600000;0
45180;8236;101;0;0;0;0;.00nan;0;0
45182;6627;100;0;0;0;0;.00nan;0;0
45182;7075;96;26;17;5;12;.706;1562000;0
45182;7078;100;66;19;1;18;.947;3600000;0
45182;7735;96;12;29;7;22;.759;2038000;0
45184;6603;104;62;53;7;46;.868;3600000;0
45184;7211;103;73;23;1;22;.957;3600000;0
45184;8126;104;0;0;0;0;.00nan;0;0
45184;8220;103;0;0;0;0;.00nan;0;0
45186;7716;89;56;28;3;25;.893;3600000;0
45186;8105;102;56;34;5;29;.853;3545000;0
45186;8745;102;0;0;0;0;.00nan;0;0
45186;9226;89;0;0;0;0;.00nan;0;0
45188;7762;90;85;23;1;22;.957;3235000;0
45188;8104;92;0;0;0;0;.00nan;0;0
45188;8107;92;100;44;3;41;.932;3600000;0
45188;9227;90;29;8;3;5;.625;365000;0
45190;6581;98;58;22;2;20;.909;3562000;0
45190;7163;98;0;0;0;0;.00nan;0;0
45190;7654;97;0;0;0;0;.00nan;0;0
45190;7666;97;100;35;0;35;1.000;3600000;0
45192;6687;87;25;25;6;19;.760;2206000;0
45192;7218;99;73;21;1;20;.952;3600000;0
45192;7227;99;0;0;0;0;.00nan;0;0
45192;7717;87;54;25;2;23;.920;1394000;0
45194;7091;94;0;0;0;0;.00nan;0;0
45194;7115;88;63;48;5;43;.896;3550000;0
45194;8101;94;43;23;4;19;.826;3600000;0
45194;8165;88;0;0;0;0;.00nan;0;0
45196;7211;103;0;0;0;0;.00nan;0;0
45196;8103;93;75;40;4;36;.900;3657000;0
45196;8220;103;42;31;5;26;.839;3673000;0
45196;8320;93;0;0;0;0;.00nan;0;0
45198;6581;98;0;0;0;0;.00nan;0;0
45198;7155;86;0;0;0;0;.00nan;0;0
45198;7163;98;1;35;10;25;.714;3600000;0
45198;8322;86;37;22;4;18;.818;3600000;0
45200;6683;91;83;24;1;23;.958;3600000;0
45200;7075;96;41;40;7;33;.825;2774000;0
45200;7735;96;55;13;1;12;.923;826000;0
45200;8154;91;0;0;0;0;.00nan;0;0
45202;7115;88;0;0;0;0;.00nan;0;0
45202;7716;89;0;0;0;0;.00nan;0;0
45202;8165;88;76;33;3;30;.909;3600000;0
45202;9226;89;86;20;0;20;1.000;3600000;0
45204;6603;104;49;17;2;15;.882;1409000;0
45204;7218;99;0;0;0;0;.00nan;0;0
45204;7227;99;61;22;2;20;.909;3600000;0
45204;8126;104;23;26;6;20;.769;2191000;0
45206;7654;97;0;0;0;0;.00nan;0;0
45206;7666;97;22;25;6;19;.760;3600000;0
45206;8105;102;0;0;0;0;.00nan;0;0
45206;8745;102;53;19;2;17;.895;3600000;0
45208;6627;100;38;33;6;27;.818;3082000;0
45208;6663;85;73;26;2;24;.923;3600000;0
45208;7078;100;55;6;0;6;1.000;518000;0
45208;7142;85;0;0;0;0;.00nan;0;0
45210;6731;95;94;35;1;34;.971;3600000;0
45210;7164;101;49;35;5;30;.857;3600000;0
45210;8168;95;0;0;0;0;.00nan;0;0
45210;8236;101;0;0;0;0;.00nan;0;0
45212;6687;87;39;32;6;26;.813;2937000;0
45212;7717;87;53;3;0;3;1.000;663000;0
45212;7762;90;0;0;0;0;.00nan;0;0
45212;9227;90;52;25;3;22;.880;3600000;0
45214;7091;94;0;0;0;0;.00nan;0;0
45214;8101;94;66;40;4;36;.900;3544000;0
45214;8104;92;0;0;0;0;.00nan;0;0
45214;8107;92;80;43;3;40;.930;3600000;0
45216;7164;101;41;3;1;2;.667;403000;0
45216;8103;93;68;28;3;25;.893;3600000;0
45216;8236;101;32;35;6;29;.829;3197000;0
45216;8320;93;0;0;0;0;.00nan;0;0
45218;7115;88;82;60;4;56;.933;3532000;0
45218;7211;103;0;0;0;0;.00nan;0;0
45218;8165;88;0;0;0;0;.00nan;0;0
45218;8220;103;48;13;2;11;.846;3600000;0
45220;6627;100;0;0;0;0;.00nan;0;0
45220;7075;96;87;47;3;44;.936;3574000;0
45220;7078;100;47;13;2;11;.846;3600000;0
45220;7735;96;0;0;0;0;.00nan;0;0
45222;7654;97;91;39;1;38;.974;3600000;0
45222;7666;97;0;0;0;0;.00nan;0;0
45222;7716;89;43;4;1;3;.750;1924000;0
45222;9226;89;11;18;6;12;.667;1676000;0
45224;6581;98;65;43;6;37;.860;3543000;0
45224;6687;87;36;23;5;18;.783;3600000;0
45224;7163;98;0;0;0;0;.00nan;0;0
45224;7717;87;0;0;0;0;.00nan;0;0
45226;7155;86;0;0;0;0;.00nan;0;0
45226;7762;90;0;0;0;0;.00nan;0;0
45226;8322;86;46;43;7;36;.837;3600000;0
45226;9227;90;60;24;2;22;.917;3600000;0
45228;6663;85;0;0;0;0;.00nan;0;0
45228;7091;94;79;42;3;39;.929;2850000;0
45228;7142;85;74;9;0;9;1.000;3600000;0
45228;8101;94;25;15;4;11;.733;750000;0
45230;6731;95;84;37;3;34;.919;3600000;0
45230;7218;99;0;0;0;0;.00nan;0;0
45230;7227;99;72;23;2;21;.913;3600000;0
45230;8168;95;0;0;0;0;.00nan;0;0
45232;6683;91;31;23;5;18;.783;3546000;0
45232;8105;102;59;37;4;33;.892;3600000;0
45232;8154;91;0;0;0;0;.00nan;0;0
45232;8745;102;0;0;0;0;.00nan;0;0
45234;6603;104;0;0;0;0;.00nan;0;0
45234;8104;92;0;0;0;0;.00nan;0;0
45234;8107;92;85;35;2;33;.943;3900000;0
45234;8126;104;94;40;2;38;.950;3900000;0
45260;6837;73;82;52;4;48;.923;3600000;0
45260;7389;74;0;0;0;0;.00nan;0;0
45260;8429;73;0;0;0;0;.00nan;0;0
45260;8442;74;60;25;3;22;.880;3600000;0
45915;7409;70;83;33;2;31;.939;3600000;0
45915;8367;70;0;0;0;0;.00nan;0;0
45915;8474;63;51;27;3;24;.889;3553000;0
45915;8476;63;0;0;0;0;.00nan;0;0
45252;7899;81;0;0;0;0;.00nan;0;0
45252;8450;81;61;30;3;27;.900;3600000;0
45252;8493;80;0;0;0;0;.00nan;0;0
45252;8685;80;40;31;5;26;.839;3529000;0
45954;7901;79;0;0;0;0;.00nan;0;0
45954;7904;79;47;23;3;20;.870;3600000;0
45954;8113;77;97;54;2;52;.963;3089000;0
45954;8132;77;31;9;3;6;.667;511000;0
45344;6804;72;86;15;0;15;1.000;3600000;0
45344;6879;72;0;0;0;0;.00nan;0;0
45344;6905;68;0;0;0;0;.00nan;0;0
45344;7816;68;94;49;3;46;.939;3600000;0
45464;7237;75;50;8;1;7;.875;716000;0
45464;7271;82;75;28;2;26;.929;3600000;0
45464;7298;75;31;28;6;22;.786;2884000;0
45464;7302;82;0;0;0;0;.00nan;0;0
45331;7598;65;51;18;2;16;.889;3600000;0
45331;7840;66;34;21;4;17;.810;949000;0
45331;7864;66;38;31;5;26;.839;2651000;0
45331;7911;65;0;0;0;0;.00nan;0;0
45293;6824;67;73;65;7;58;.892;3600000;0
45293;7269;67;0;0;0;0;.00nan;0;0
45293;7908;64;0;0;0;0;.00nan;0;0
45293;8404;64;61;16;1;15;.938;3600000;0
45247;6837;73;53;45;6;39;.867;3600000;0
45247;7409;70;0;0;0;0;.00nan;0;0
45247;8367;70;93;20;0;20;1.000;3600000;0
45247;8429;73;0;0;0;0;.00nan;0;0
45254;7840;66;77;49;4;45;.918;3600000;0
45254;7864;66;0;0;0;0;.00nan;0;0
45254;8493;80;49;9;1;8;.889;3600000;0
45254;8685;80;0;0;0;0;.00nan;0;0
45338;6821;71;51;28;4;24;.857;3600000;0
45338;7598;65;0;0;0;0;.00nan;0;0
45338;7911;65;89;37;2;35;.946;3600000;0
45338;8130;71;0;0;0;0;.00nan;0;0
45238;6905;68;62;25;3;22;.880;3600000;0
45238;7816;68;0;0;0;0;.00nan;0;0
45238;7899;81;35;32;6;26;.813;3600000;0
45238;8450;81;0;0;0;0;.00nan;0;0
45239;7271;82;51;22;4;18;.818;3600000;0
45239;7302;82;0;0;0;0;.00nan;0;0
45239;8499;78;74;50;5;45;.900;3600000;0
45239;8711;78;0;0;0;0;.00nan;0;0
45237;7237;75;0;0;0;0;.00nan;0;0
45237;7298;75;73;25;2;23;.920;3600000;0
45237;8133;76;61;5;0;5;1.000;902000;0
45237;8420;76;41;45;7;38;.844;2698000;0
45264;6813;83;0;0;0;0;.00nan;0;0
45264;7325;83;53;11;1;10;.909;3600000;0
45264;7385;84;29;14;4;10;.714;703000;0
45264;7855;84;62;42;4;38;.905;2897000;0
45922;6939;69;99;25;0;25;1.000;3600000;0
45922;7389;74;47;28;4;24;.857;3600000;0
45922;7596;69;0;0;0;0;.00nan;0;0
45922;8442;74;0;0;0;0;.00nan;0;0
45267;7908;64;100;43;1;42;.977;3600000;0
45267;8404;64;0;0;0;0;.00nan;0;0
45267;8474;63;0;0;0;0;.00nan;0;0
45267;8476;63;58;19;2;17;.895;3600000;0
45241;8113;77;48;9;1;8;.889;821000;0
45241;8132;77;65;54;6;48;.889;2779000;0
45241;8499;78;0;0;0;0;.00nan;0;0
45241;8711;78;67;14;1;13;.929;3600000;0
45925;6804;72;49;24;3;21;.875;3900000;0
45925;6813;83;59;33;3;30;.909;3900000;0
45925;6879;72;0;0;0;0;.00nan;0;0
45925;7325;83;0;0;0;0;.00nan;0;0
45250;6939;69;72;28;2;26;.929;3600000;0
45250;7596;69;0;0;0;0;.00nan;0;0
45250;7901;79;74;25;1;24;.960;3600000;0
45250;7904;79;0;0;0;0;.00nan;0;0
45256;7409;70;0;0;0;0;.00nan;0;0
45256;7901;79;0;0;0;0;.00nan;0;0
45256;7904;79;51;31;5;26;.839;3600000;0
45256;8367;70;64;17;1;16;.941;3600000;0
45399;6824;67;67;34;3;31;.912;3515000;0
45399;7269;67;0;0;0;0;.00nan;0;0
45399;7840;66;0;0;0;0;.00nan;0;0
45399;7864;66;78;26;1;25;.962;3600000;0
45240;7271;82;64;13;1;12;.923;3600000;0
45240;7302;82;0;0;0;0;.00nan;0;0
45240;7385;84;40;43;6;37;.860;2472000;0
45240;7855;84;73;26;1;25;.962;1128000;0
45975;6837;73;66;35;4;31;.886;3600000;0
45975;6905;68;0;0;0;0;.00nan;0;0
45975;7816;68;100;24;0;24;1.000;3600000;0
45975;8429;73;0;0;0;0;.00nan;0;0
45244;7389;74;0;0;0;0;.00nan;0;0
45244;8113;77;47;13;2;11;.846;438000;0
45244;8132;77;69;57;6;51;.895;3162000;0
45244;8442;74;39;14;3;11;.786;3600000;0
45357;7598;65;0;0;0;0;.00nan;0;0
45357;7911;65;60;45;5;40;.889;3600000;0
45357;8474;63;68;26;3;23;.885;3600000;0
45357;8476;63;0;0;0;0;.00nan;0;0
45236;7237;75;0;0;0;0;.00nan;0;0
45236;7298;75;50;13;2;11;.846;3600000;0
45236;8133;76;43;4;1;3;.750;477000;0
45236;8420;76;34;43;8;35;.814;3123000;0
45273;6813;83;0;0;0;0;.00nan;0;0
45273;7271;82;89;38;2;36;.947;3545000;0
45273;7302;82;0;0;0;0;.00nan;0;0
45273;7325;83;70;22;1;21;.955;3600000;0
45243;6821;71;54;21;3;18;.857;3600000;0
45243;7385;84;67;45;5;40;.889;3576000;0
45243;7855;84;0;0;0;0;.00nan;0;0
45243;8130;71;0;0;0;0;.00nan;0;0
45968;8493;80;0;0;0;0;.00nan;0;0
45968;8499;78;53;32;4;28;.875;3583000;0
45968;8685;80;49;19;3;16;.842;3600000;0
45968;8711;78;0;0;0;0;.00nan;0;0
45326;6905;68;0;0;0;0;.00nan;0;0
45326;7389;74;67;17;1;16;.941;3600000;0
45326;7816;68;70;24;2;22;.917;3600000;0
45326;8442;74;0;0;0;0;.00nan;0;0
45246;6939;69;24;29;7;22;.759;3600000;0
45246;7596;69;0;0;0;0;.00nan;0;0
45246;7899;81;0;0;0;0;.00nan;0;0
45246;8450;81;94;20;0;20;1.000;3600000;0
45919;7840;66;18;19;5;14;.737;1989000;0
45919;7864;66;49;15;2;13;.867;1611000;0
45919;7908;64;0;0;0;0;.00nan;0;0
45919;8404;64;52;24;3;21;.875;3600000;0
45368;6824;67;39;28;5;23;.821;2354000;0
45368;7269;67;37;14;3;11;.786;1246000;0
45368;8474;63;0;0;0;0;.00nan;0;0
45368;8476;63;26;20;5;15;.750;3600000;0
45279;6804;72;0;0;0;0;.00nan;0;0
45279;6879;72;63;12;1;11;.917;3600000;0
45279;7409;70;25;44;8;36;.818;3318000;0
45279;8367;70;50;7;1;6;.857;282000;0
45301;6821;71;61;39;4;35;.897;3600000;0
45301;7908;64;82;27;1;26;.963;3600000;0
45301;8130;71;0;0;0;0;.00nan;0;0
45301;8404;64;0;0;0;0;.00nan;0;0
45235;6813;83;74;16;1;15;.938;3600000;0
45235;7325;83;0;0;0;0;.00nan;0;0
45235;8133;76;33;33;6;27;.818;1888000;0
45235;8420;76;43;22;3;19;.864;1712000;0
45245;8113;77;65;12;0;12;1.000;928000;0
45245;8132;77;41;36;6;30;.833;2672000;0
45245;8493;80;73;16;1;15;.938;3600000;0
45245;8685;80;0;0;0;0;.00nan;0;0
45251;6837;73;64;36;4;32;.889;3600000;0
45251;6939;69;0;0;0;0;.00nan;0;0
45251;7596;69;26;34;6;28;.824;3539000;0
45251;8429;73;0;0;0;0;.00nan;0;0
45249;7237;75;0;0;0;0;.00nan;0;0
45249;7298;75;56;32;4;28;.875;3761000;0
45249;7901;79;0;0;0;0;.00nan;0;0
45249;7904;79;73;52;5;47;.904;3761000;0
45270;6804;72;38;17;4;13;.765;3600000;0
45270;6879;72;0;0;0;0;.00nan;0;0
45270;8499;78;31;14;4;10;.714;1174000;0
45270;8711;78;61;24;2;22;.917;2358000;0
45931;7385;84;58;41;5;36;.878;3600000;0
45931;7855;84;0;0;0;0;.00nan;0;0
45931;7899;81;0;0;0;0;.00nan;0;0
45931;8450;81;32;13;3;10;.769;3600000;0
45935;7389;74;57;7;0;7;1.000;785000;0
45935;8442;74;18;19;6;13;.684;2737000;0
45935;8474;63;63;34;4;30;.882;3600000;0
45935;8476;63;0;0;0;0;.00nan;0;0
45358;6905;68;74;28;2;26;.929;3600000;0
45358;7816;68;0;0;0;0;.00nan;0;0
45358;7901;79;9;19;6;13;.684;2649000;0
45358;7904;79;59;7;0;7;1.000;951000;0
45248;7271;82;70;6;0;6;1.000;3600000;0
45248;7302;82;0;0;0;0;.00nan;0;0
45248;7385;84;53;15;2;13;.867;584000;0
45248;7855;84;71;58;6;52;.897;3016000;0
45262;7409;70;50;14;2;12;.857;3600000;0
45262;8113;77;41;2;1;1;.500;435000;0
45262;8132;77;56;52;6;46;.885;3165000;0
45262;8367;70;0;0;0;0;.00nan;0;0
45261;6837;73;38;30;5;25;.833;3600000;0
45261;7864;66;0;0;0;0;.00nan;0;0
45261;8429;73;0;0;0;0;.00nan;0;0
45261;8726;66;75;29;2;27;.931;3600000;0
45258;7237;75;0;0;0;0;.00nan;0;0
45258;7298;75;72;40;3;37;.925;3600000;0
45258;8499;78;45;30;4;26;.867;3549000;0
45258;8711;78;0;0;0;0;.00nan;0;0
45257;6824;67;92;53;4;49;.925;3586000;0
45257;7269;67;0;0;0;0;.00nan;0;0
45257;8493;80;0;0;0;0;.00nan;0;0
45257;8685;80;42;9;2;7;.778;3600000;0
45255;6939;69;35;34;7;27;.794;2356000;0
45255;7271;82;62;16;2;14;.875;3600000;0
45255;7302;82;0;0;0;0;.00nan;0;0
45255;7596;69;39;23;4;19;.826;1244000;0
45341;6804;72;48;7;1;6;.857;3600000;0
45341;6879;72;0;0;0;0;.00nan;0;0
45341;6905;68;63;18;1;17;.944;1040000;0
45341;7816;68;59;51;6;45;.882;2560000;0
45253;7409;70;43;23;4;19;.826;3600000;0
45253;8133;76;49;18;3;15;.833;2542000;0
45253;8367;70;0;0;0;0;.00nan;0;0
45253;8420;76;30;13;4;9;.692;1058000;0
45271;6821;71;79;34;3;31;.912;3600000;0
45271;7899;81;0;0;0;0;.00nan;0;0
45271;8130;71;0;0;0;0;.00nan;0;0
45271;8450;81;49;30;4;26;.867;3588000;0
45242;8133;76;6;11;6;5;.455;1101000;0
45242;8420;76;41;34;6;28;.824;2499000;0
45242;8499;78;0;0;0;0;.00nan;0;0
45242;8711;78;41;26;4;22;.846;3600000;0
45307;6824;67;0;0;0;0;.00nan;0;0
45307;7269;67;83;41;3;38;.927;3600000;0
45307;8113;77;0;0;0;0;.00nan;0;0
45307;8132;77;64;27;2;25;.926;3600000;0
45380;7901;79;31;40;7;33;.825;3600000;0
45380;7904;79;0;0;0;0;.00nan;0;0
45380;8474;63;66;28;2;26;.929;3600000;0
45380;8476;63;0;0;0;0;.00nan;0;0
45304;7864;66;100;37;0;37;1.000;3600000;0
45304;7908;64;0;0;0;0;.00nan;0;0
45304;8404;64;54;12;1;11;.917;3547000;0
45304;8726;66;0;0;0;0;.00nan;0;0
45269;6813;83;0;0;0;0;.00nan;0;0
45269;7325;83;69;3;0;3;1.000;3600000;0
45269;7385;84;77;55;6;49;.891;3600000;0
45269;7855;84;0;0;0;0;.00nan;0;0
45266;7598;65;0;0;0;0;.00nan;0;0
45266;7899;81;0;0;0;0;.00nan;0;0
45266;7911;65;83;30;1;29;.967;3600000;0
45266;8450;81;24;29;6;23;.793;3600000;0
45268;6939;69;89;51;3;48;.941;3600000;0
45268;7389;74;0;0;0;0;.00nan;0;0
45268;7596;69;0;0;0;0;.00nan;0;0
45268;8442;74;68;19;1;18;.947;3600000;0
45306;6905;68;0;0;0;0;.00nan;0;0
45306;7816;68;68;50;5;45;.900;3527000;0
45306;7908;64;60;29;3;26;.897;3600000;0
45306;8404;64;0;0;0;0;.00nan;0;0
45974;7237;75;0;0;0;0;.00nan;0;0
45974;7298;75;50;25;4;21;.840;3566000;0
45974;7409;70;80;43;3;40;.930;3600000;0
45974;8367;70;0;0;0;0;.00nan;0;0
45281;6837;73;20;23;6;17;.739;1690000;0
45281;7271;82;47;6;1;5;.833;3600000;0
45281;7302;82;0;0;0;0;.00nan;0;0
45281;8429;73;66;38;4;34;.895;1910000;0
45316;6824;67;87;53;4;49;.925;3600000;0
45316;7269;67;0;0;0;0;.00nan;0;0
45316;7901;79;0;0;0;0;.00nan;0;0
45316;7904;79;67;7;0;7;1.000;3600000;0
45541;7237;75;39;27;4;23;.852;3547000;0
45541;7298;75;0;0;0;0;.00nan;0;0
45541;7389;74;90;40;2;38;.950;3600000;0
45541;8442;74;0;0;0;0;.00nan;0;0
45259;6939;69;0;0;0;0;.00nan;0;0
45259;7596;69;73;31;2;29;.935;3600000;0
45259;7598;65;24;5;3;2;.400;600000;0
45259;7911;65;82;25;1;24;.960;2973000;0
45265;6804;72;50;6;1;5;.833;3600000;0
45265;6837;73;84;82;7;75;.915;3600000;0
45265;6879;72;0;0;0;0;.00nan;0;0
45265;8429;73;0;0;0;0;.00nan;0;0
45277;7409;70;0;0;0;0;.00nan;0;0
45277;8367;70;35;38;6;32;.842;3600000;0
45277;8493;80;75;20;1;19;.950;3600000;0
45277;8685;80;0;0;0;0;.00nan;0;0
45274;6813;83;46;11;2;9;.818;3600000;0
45274;6821;71;79;51;5;46;.902;3600000;0
45274;7325;83;0;0;0;0;.00nan;0;0
45274;8130;71;0;0;0;0;.00nan;0;0
45276;8113;77;0;0;0;0;.00nan;0;0
45276;8132;77;70;45;4;41;.911;3900000;0
45276;8133;76;0;0;0;0;.00nan;0;0
45276;8420;76;30;16;4;12;.750;3900000;0
45939;7385;84;24;14;4;10;.714;1193000;0
45939;7855;84;75;30;2;28;.933;2407000;0
45939;8499;78;51;8;1;7;.875;3600000;0
45939;8711;78;0;0;0;0;.00nan;0;0
45272;7899;81;42;25;5;20;.800;3522000;0
45272;8450;81;0;0;0;0;.00nan;0;0
45272;8474;63;0;0;0;0;.00nan;0;0
45272;8476;63;66;30;3;27;.900;3600000;0
45378;7864;66;61;33;4;29;.879;3600000;0
45378;8474;63;49;36;5;31;.861;3570000;0
45378;8476;63;0;0;0;0;.00nan;0;0
45378;8726;66;0;0;0;0;.00nan;0;0
45297;6804;72;0;0;0;0;.00nan;0;0
45297;6879;72;58;27;3;24;.889;3681000;0
45297;8493;80;0;0;0;0;.00nan;0;0
45297;8685;80;62;33;4;29;.879;3681000;0
45940;6824;67;59;56;7;49;.875;3186000;0
45940;6905;68;81;11;0;11;1.000;3600000;0
45940;7269;67;47;7;1;6;.857;414000;0
45940;7816;68;0;0;0;0;.00nan;0;0
45263;7385;84;88;85;6;79;.929;3600000;0
45263;7855;84;0;0;0;0;.00nan;0;0
45263;8499;78;41;1;1;0;.000;3600000;0
45263;8711;78;0;0;0;0;.00nan;0;0
45275;6813;83;0;0;0;0;.00nan;0;0
45275;7237;75;0;0;0;0;.00nan;0;0
45275;7298;75;68;46;4;42;.913;3570000;0
45275;7325;83;38;13;3;10;.769;3600000;0
45805;6821;71;50;27;4;23;.852;3600000;0
45805;7389;74;0;0;0;0;.00nan;0;0
45805;8130;71;0;0;0;0;.00nan;0;0
45805;8442;74;67;22;1;21;.955;3600000;0
45340;7598;65;87;40;3;37;.925;3600000;0
45340;7908;64;0;0;0;0;.00nan;0;0
45340;7911;65;0;0;0;0;.00nan;0;0
45340;8404;64;100;26;0;26;1.000;3600000;0
45933;7237;75;28;8;3;5;.625;3600000;0
45933;7298;75;0;0;0;0;.00nan;0;0
45933;7864;66;0;0;0;0;.00nan;0;0
45933;8726;66;62;54;6;48;.889;3600000;0
45375;6905;68;83;41;3;38;.927;3900000;0
45375;7409;70;49;20;3;17;.850;3900000;0
45375;7816;68;0;0;0;0;.00nan;0;0
45375;8367;70;0;0;0;0;.00nan;0;0
45294;7899;81;0;0;0;0;.00nan;0;0
45294;8450;81;45;33;5;28;.848;3600000;0
45294;8493;80;47;12;2;10;.833;3600000;0
45294;8685;80;0;0;0;0;.00nan;0;0
45282;6939;69;71;19;1;18;.947;3600000;0
45282;7596;69;0;0;0;0;.00nan;0;0
45282;8113;77;0;0;0;0;.00nan;0;0
45282;8132;77;55;33;4;29;.879;3600000;0
45283;6804;72;47;5;1;4;.800;3600000;0
45283;6837;73;86;78;8;70;.897;3600000;0
45283;6879;72;0;0;0;0;.00nan;0;0
45283;8429;73;0;0;0;0;.00nan;0;0
45295;6813;83;0;0;0;0;.00nan;0;0
45295;7325;83;51;6;1;5;.833;3600000;0
45295;7864;66;43;39;6;33;.846;1895000;0
45295;8726;66;31;32;6;26;.813;1705000;0
45284;7385;84;93;68;5;63;.926;3600000;0
45284;7855;84;0;0;0;0;.00nan;0;0
45284;7901;79;0;0;0;0;.00nan;0;0
45284;7904;79;88;18;0;18;1.000;3600000;0
45388;7598;65;0;0;0;0;.00nan;0;0
45388;7911;65;65;38;4;34;.895;3513000;0
45388;8474;63;75;32;2;30;.938;3600000;0
45388;8476;63;0;0;0;0;.00nan;0;0
45412;6821;71;80;41;3;38;.927;3600000;0
45412;8130;71;0;0;0;0;.00nan;0;0
45412;8493;80;0;0;0;0;.00nan;0;0
45412;8685;80;23;12;4;8;.667;3600000;0
45286;7899;81;57;40;5;35;.875;2337000;0
45286;8450;81;51;18;2;16;.889;1263000;0
45286;8499;78;58;15;1;14;.933;3600000;0
45286;8711;78;0;0;0;0;.00nan;0;0
45278;6939;69;0;0;0;0;.00nan;0;0
45278;7409;70;44;19;3;16;.842;3600000;0
45278;7596;69;58;34;4;30;.882;3600000;0
45278;8367;70;0;0;0;0;.00nan;0;0
45305;7271;82;51;9;1;8;.889;3600000;0
45305;7302;82;0;0;0;0;.00nan;0;0
45305;8133;76;55;25;3;22;.880;1516000;0
45305;8420;76;35;40;6;34;.850;2084000;0
45367;6824;67;79;56;5;51;.911;3600000;0
45367;7269;67;0;0;0;0;.00nan;0;0
45367;7908;64;0;0;0;0;.00nan;0;0
45367;8404;64;40;9;2;7;.778;3600000;0
45296;6813;83;67;2;0;2;1.000;3600000;0
45296;6824;67;20;12;4;8;.667;1005000;0
45296;7269;67;76;66;6;60;.909;2595000;0
45296;7325;83;0;0;0;0;.00nan;0;0
45953;7901;79;0;0;0;0;.00nan;0;0
45953;7904;79;91;40;3;37;.925;3600000;0
45953;8499;78;0;0;0;0;.00nan;0;0
45953;8711;78;100;28;0;28;1.000;3600000;0
45339;6837;73;18;26;6;20;.769;2328000;0
45339;7598;65;35;28;5;23;.821;3600000;0
45339;7911;65;0;0;0;0;.00nan;0;0
45339;8429;73;55;11;1;10;.909;1200000;0
45554;6821;71;58;45;5;40;.889;3900000;0
45554;7237;75;0;0;0;0;.00nan;0;0
45554;7298;75;49;36;5;31;.861;3900000;0
45554;8130;71;0;0;0;0;.00nan;0;0
45290;7385;84;15;7;4;3;.429;577000;0
45290;7855;84;69;24;2;22;.917;3023000;0
45290;8474;63;0;0;0;0;.00nan;0;0
45290;8476;63;54;17;2;15;.882;3600000;0
45722;6905;68;0;0;0;0;.00nan;0;0
45722;7409;70;89;39;2;37;.949;3640000;0
45722;7816;68;37;12;3;9;.750;3640000;0
45722;8367;70;0;0;0;0;.00nan;0;0
45298;6804;72;100;21;0;21;1.000;3600000;0
45298;6879;72;0;0;0;0;.00nan;0;0
45298;7271;82;33;36;7;29;.806;3324000;0
45298;7302;82;52;2;0;2;1.000;276000;0
45324;7389;74;0;0;0;0;.00nan;0;0
45324;8113;77;97;61;3;58;.951;3600000;0
45324;8132;77;0;0;0;0;.00nan;0;0
45324;8442;74;49;13;2;11;.846;3600000;0
45288;7901;79;58;5;0;5;1.000;397000;0
45288;7904;79;30;25;5;20;.800;3144000;0
45288;8133;76;0;0;0;0;.00nan;0;0
45288;8420;76;69;34;3;31;.912;3600000;0
45423;6837;73;55;24;3;21;.875;3600000;0
45423;7598;65;0;0;0;0;.00nan;0;0
45423;7911;65;33;30;6;24;.800;3600000;0
45423;8429;73;0;0;0;0;.00nan;0;0
45779;6821;71;67;24;2;22;.917;3600000;0
45779;7237;75;0;0;0;0;.00nan;0;0
45779;7298;75;66;38;4;34;.895;3529000;0
45779;8130;71;0;0;0;0;.00nan;0;0
45292;6824;67;59;37;4;33;.892;3562000;0
45292;7269;67;0;0;0;0;.00nan;0;0
45292;7385;84;53;23;3;20;.870;3600000;0
45292;7855;84;0;0;0;0;.00nan;0;0
45377;6905;68;0;0;0;0;.00nan;0;0
45377;7816;68;40;31;5;26;.839;3562000;0
45377;7908;64;0;0;0;0;.00nan;0;0
45377;8404;64;43;25;4;21;.840;3600000;0
45280;6813;83;49;33;5;28;.848;3600000;0
45280;7325;83;0;0;0;0;.00nan;0;0
45280;8499;78;0;0;0;0;.00nan;0;0
45280;8711;78;69;34;4;30;.882;3600000;0
45285;6939;69;72;45;4;41;.911;3600000;0
45285;7596;69;0;0;0;0;.00nan;0;0
45285;8499;78;72;21;1;20;.952;3600000;0
45285;8711;78;0;0;0;0;.00nan;0;0
45958;7237;75;26;15;4;11;.733;3600000;0
45958;7298;75;0;0;0;0;.00nan;0;0
45958;7598;65;33;39;7;32;.821;2252000;0
45958;7911;65;58;30;4;26;.867;1348000;0
45313;6804;72;100;20;0;20;1.000;3600000;0
45313;6879;72;0;0;0;0;.00nan;0;0
45313;7899;81;77;22;1;21;.955;2505000;0
45313;8450;81;31;15;4;11;.733;1095000;0
45390;7389;74;0;0;0;0;.00nan;0;0
45390;7908;64;79;42;3;39;.929;3600000;0
45390;8404;64;0;0;0;0;.00nan;0;0
45390;8442;74;78;44;4;40;.909;3550000;0
45308;8113;77;0;0;0;0;.00nan;0;0
45308;8132;77;71;44;4;40;.909;3600000;0
45308;8133;76;54;17;2;15;.882;3600000;0
45308;8420;76;0;0;0;0;.00nan;0;0
45291;7271;82;46;13;2;11;.846;3600000;0
45291;7302;82;0;0;0;0;.00nan;0;0
45291;7840;66;20;11;4;7;.636;720000;0
45291;7864;66;78;59;5;54;.915;2880000;0
45961;6821;71;29;27;5;22;.815;3568000;0
45961;8130;71;0;0;0;0;.00nan;0;0
45961;8474;63;0;0;0;0;.00nan;0;0
45961;9247;63;45;23;4;19;.826;3600000;0
45450;6905;68;30;26;6;20;.769;3600000;0
45450;7816;68;0;0;0;0;.00nan;0;0
45450;8493;80;53;14;2;12;.857;3600000;0
45450;8685;80;0;0;0;0;.00nan;0;0
45379;7840;66;77;35;3;32;.914;3600000;0
45379;7864;66;0;0;0;0;.00nan;0;0
45379;8474;63;21;28;6;22;.786;3600000;0
45379;9247;63;0;0;0;0;.00nan;0;0
45394;7389;74;43;24;4;20;.833;3560000;0
45394;7409;70;91;35;2;33;.943;3600000;0
45394;8367;70;0;0;0;0;.00nan;0;0
45394;8442;74;0;0;0;0;.00nan;0;0
45322;7901;79;0;0;0;0;.00nan;0;0
45322;7904;79;28;22;5;17;.773;3600000;0
45322;8113;77;37;46;7;39;.848;3572000;0
45322;8132;77;0;0;0;0;.00nan;0;0
45976;6804;72;44;5;1;4;.800;3600000;0
45976;6837;73;81;59;5;54;.915;3600000;0
45976;6879;72;0;0;0;0;.00nan;0;0
45976;8429;73;0;0;0;0;.00nan;0;0
45334;7271;82;44;9;2;7;.778;3600000;0
45334;7302;82;0;0;0;0;.00nan;0;0
45334;7598;65;60;14;1;13;.929;724000;0
45334;7911;65;66;55;6;49;.891;2876000;0
45309;6837;73;73;20;1;19;.950;3600000;0
45309;7385;84;66;43;5;38;.884;3600000;0
45309;7855;84;0;0;0;0;.00nan;0;0
45309;8429;73;0;0;0;0;.00nan;0;0
45314;7901;79;34;28;5;23;.821;3210000;0
45314;7904;79;52;3;0;3;1.000;690000;0
45314;8133;76;0;0;0;0;.00nan;0;0
45314;8420;76;35;22;5;17;.773;3900000;0
45302;6821;71;0;0;0;0;.00nan;0;0
45302;8130;71;85;50;4;46;.920;3593000;0
45302;8499;78;52;19;2;17;.895;3600000;0
45302;8711;78;0;0;0;0;.00nan;0;0
45376;7899;81;0;0;0;0;.00nan;0;0
45376;8450;81;65;16;1;15;.938;3600000;0
45376;8474;63;0;0;0;0;.00nan;0;0
45376;9247;63;59;45;5;40;.889;3600000;0
45317;7908;64;0;0;0;0;.00nan;0;0
45317;8133;76;52;39;5;34;.872;3600000;0
45317;8404;64;77;28;1;27;.964;3600000;0
45317;8420;76;0;0;0;0;.00nan;0;0
45303;6813;83;0;0;0;0;.00nan;0;0
45303;7325;83;64;3;0;3;1.000;3600000;0
45303;8113;77;27;43;7;36;.837;2650000;0
45303;8132;77;21;23;6;17;.739;950000;0
45445;6905;68;0;0;0;0;.00nan;0;0
45445;7816;68;59;25;3;22;.880;3866000;0
45445;7840;66;0;0;0;0;.00nan;0;0
45445;7864;66;99;45;2;43;.956;3866000;0
45299;6821;71;86;15;0;15;1.000;3600000;0
45299;7385;84;56;20;2;18;.900;1631000;0
45299;7855;84;35;39;6;33;.846;1969000;0
45299;8130;71;0;0;0;0;.00nan;0;0
45287;6939;69;33;35;7;28;.800;3600000;0
45287;7389;74;0;0;0;0;.00nan;0;0
45287;7596;69;0;0;0;0;.00nan;0;0
45287;8442;74;40;12;3;9;.750;3600000;0
45944;6824;67;82;70;6;64;.914;3600000;0
45944;7269;67;0;0;0;0;.00nan;0;0
45944;7271;82;65;4;0;4;1.000;3600000;0
45944;7302;82;0;0;0;0;.00nan;0;0
45336;6804;72;58;17;2;15;.882;3671000;0
45336;6879;72;0;0;0;0;.00nan;0;0
45336;7409;70;92;53;3;50;.943;3671000;0
45336;8367;70;0;0;0;0;.00nan;0;0
45641;7237;75;0;0;0;0;.00nan;0;0
45641;7298;75;26;22;5;17;.773;3543000;0
45641;8493;80;0;0;0;0;.00nan;0;0
45641;8685;80;80;39;3;36;.923;3600000;0
45978;6837;73;62;37;4;33;.892;3708000;0
45978;7899;81;55;28;3;25;.893;3708000;0
45978;8429;73;0;0;0;0;.00nan;0;0
45978;8450;81;0;0;0;0;.00nan;0;0
45289;7389;74;60;42;5;37;.881;3580000;0
45289;8442;74;0;0;0;0;.00nan;0;0
45289;8499;78;52;28;4;24;.857;3600000;0
45289;8711;78;0;0;0;0;.00nan;0;0
45310;6804;72;0;0;0;0;.00nan;0;0
45310;6879;72;58;12;1;11;.917;3600000;0
45310;8113;77;83;27;1;26;.963;1241000;0
45310;8132;77;58;58;7;51;.879;2359000;0
45328;7271;82;43;9;2;7;.778;3600000;0
45328;7302;82;0;0;0;0;.00nan;0;0
45328;7598;65;0;0;0;0;.00nan;0;0
45328;7911;65;98;67;4;63;.940;3600000;0
45410;7237;75;0;0;0;0;.00nan;0;0
45410;7298;75;38;6;2;4;.667;3600000;0
45410;8474;63;0;0;0;0;.00nan;0;0
45410;9247;63;52;58;7;51;.879;3600000;0
45300;6813;83;0;0;0;0;.00nan;0;0
45300;7325;83;66;6;0;6;1.000;3600000;0
45300;7385;84;81;80;9;71;.888;2988000;0
45300;7855;84;59;16;1;15;.938;612000;0
45327;6939;69;66;36;3;33;.917;3573000;0
45327;7596;69;0;0;0;0;.00nan;0;0
45327;7901;79;0;0;0;0;.00nan;0;0
45327;7904;79;72;26;2;24;.923;3600000;0
45400;6837;73;83;57;5;52;.912;3531000;0
45400;7908;64;0;0;0;0;.00nan;0;0
45400;8404;64;40;17;3;14;.824;3600000;0
45400;8429;73;0;0;0;0;.00nan;0;0
45361;6905;68;46;22;4;18;.818;3600000;0
45361;7816;68;0;0;0;0;.00nan;0;0
45361;8133;76;89;36;1;35;.972;3600000;0
45361;8420;76;0;0;0;0;.00nan;0;0
45490;6824;67;47;54;7;47;.870;2826000;0
45490;7269;67;55;12;1;11;.917;774000;0
45490;7840;66;0;0;0;0;.00nan;0;0
45490;7864;66;67;19;1;18;.947;3600000;0
45337;6804;72;52;9;1;8;.889;3600000;0
45337;6879;72;0;0;0;0;.00nan;0;0
45337;7409;70;86;57;4;53;.930;3600000;0
45337;8367;70;0;0;0;0;.00nan;0;0
45342;7899;81;50;7;1;6;.857;1127000;0
45342;7901;79;60;24;2;22;.917;3600000;0
45342;7904;79;0;0;0;0;.00nan;0;0
45342;8450;81;27;26;6;20;.769;2473000;0
45323;7271;82;0;0;0;0;.00nan;0;0
45323;7302;82;58;9;1;8;.889;3600000;0
45323;8113;77;0;0;0;0;.00nan;0;0
45323;8132;77;97;72;4;68;.944;3600000;0
45386;7389;74;0;0;0;0;.00nan;0;0
45386;7840;66;43;41;6;35;.854;2043000;0
45386;7864;66;61;28;3;25;.893;1557000;0
45386;8442;74;49;11;2;9;.818;3600000;0
45320;8474;63;22;14;4;10;.714;1194000;0
45320;8499;78;64;15;1;14;.933;3600000;0
45320;8711;78;0;0;0;0;.00nan;0;0
45320;9247;63;79;49;4;45;.918;2406000;0
45745;7237;75;95;44;2;42;.955;3600000;0
45745;7298;75;0;0;0;0;.00nan;0;0
45745;8493;80;0;0;0;0;.00nan;0;0
45745;8685;80;42;17;3;14;.824;3542000;0
45312;6813;83;40;13;3;10;.769;3524000;0
45312;6821;71;99;47;1;46;.979;3600000;0
45312;7325;83;0;0;0;0;.00nan;0;0
45312;8130;71;0;0;0;0;.00nan;0;0
45373;6824;67;97;60;5;55;.917;3600000;0
45373;7269;67;0;0;0;0;.00nan;0;0
45373;7409;70;0;0;0;0;.00nan;0;0
45373;8367;70;47;11;2;9;.818;3600000;0
45398;7598;65;85;60;6;54;.900;3600000;0
45398;7908;64;0;0;0;0;.00nan;0;0
45398;7911;65;0;0;0;0;.00nan;0;0
45398;8404;64;85;19;0;19;1.000;3600000;0
45397;8113;77;50;35;5;30;.857;1437000;0
45397;8132;77;55;42;6;36;.857;2163000;0
45397;8499;78;0;0;0;0;.00nan;0;0
45397;8711;78;72;6;0;6;1.000;3600000;0
45329;6939;69;38;49;7;42;.857;2434000;0
45329;7596;69;26;7;3;4;.571;1166000;0
45329;8493;80;37;23;5;18;.783;3600000;0
45329;8685;80;0;0;0;0;.00nan;0;0
45319;6837;73;88;31;1;30;.968;3600000;0
45319;7899;81;59;24;2;22;.917;3595000;0
45319;8429;73;0;0;0;0;.00nan;0;0
45319;8450;81;0;0;0;0;.00nan;0;0
45537;6804;72;73;8;0;8;1.000;3600000;0
45537;6879;72;0;0;0;0;.00nan;0;0
45537;7389;74;64;56;6;50;.893;3600000;0
45537;8442;74;0;0;0;0;.00nan;0;0
45952;7840;66;0;0;0;0;.00nan;0;0
45952;7864;66;52;44;6;38;.864;3600000;0
45952;8133;76;0;0;0;0;.00nan;0;0
45952;8420;76;45;19;3;16;.842;3600000;0
45556;6824;67;51;43;6;37;.860;2409000;0
45556;6905;68;0;0;0;0;.00nan;0;0
45556;7269;67;62;25;2;23;.920;1191000;0
45556;7816;68;75;9;0;9;1.000;3600000;0
45501;6905;68;50;8;1;7;.875;419000;0
45501;7237;75;0;0;0;0;.00nan;0;0
45501;7298;75;70;26;2;24;.923;3600000;0
45501;7816;68;46;42;6;36;.857;3181000;0
45934;7389;74;60;21;2;19;.905;3578000;0
45934;7899;81;0;0;0;0;.00nan;0;0
45934;8442;74;0;0;0;0;.00nan;0;0
45934;8450;81;71;23;1;22;.957;3600000;0
45982;6804;72;72;14;1;13;.929;3600000;0
45982;6879;72;0;0;0;0;.00nan;0;0
45982;8476;63;81;49;4;45;.918;3600000;0
45982;9247;63;0;0;0;0;.00nan;0;0
45321;6813;83;0;0;0;0;.00nan;0;0
45321;7325;83;67;25;2;23;.920;3600000;0
45321;8133;76;57;40;5;35;.875;3600000;0
45321;8420;76;0;0;0;0;.00nan;0;0
45335;7385;84;95;62;3;59;.952;3600000;0
45335;7855;84;0;0;0;0;.00nan;0;0
45335;8493;80;0;0;0;0;.00nan;0;0
45335;8685;80;71;8;0;8;1.000;3600000;0
45370;6837;73;39;34;6;28;.824;2867000;0
45370;6939;69;50;29;4;25;.862;3600000;0
45370;7596;69;0;0;0;0;.00nan;0;0
45370;8429;73;49;9;1;8;.889;733000;0
45346;7908;64;0;0;0;0;.00nan;0;0
45346;8404;64;51;27;3;24;.889;3600000;0
45346;8499;78;0;0;0;0;.00nan;0;0
45346;8711;78;67;24;2;22;.917;3600000;0
45372;6939;69;66;58;7;51;.879;3568000;0
45372;7271;82;20;18;5;13;.722;3600000;0
45372;7302;82;0;0;0;0;.00nan;0;0
45372;7596;69;0;0;0;0;.00nan;0;0
45332;6804;72;0;0;0;0;.00nan;0;0
45332;6821;71;97;61;4;57;.934;3553000;0
45332;6879;72;43;17;3;14;.824;3600000;0
45332;8130;71;0;0;0;0;.00nan;0;0
45960;7840;66;25;22;5;17;.773;1690000;0
45960;7864;66;27;17;4;13;.765;1910000;0
45960;7908;64;69;24;2;22;.917;3600000;0
45960;8404;64;0;0;0;0;.00nan;0;0
45311;7385;84;63;24;2;22;.917;3600000;0
45311;7855;84;0;0;0;0;.00nan;0;0
45311;8113;77;0;0;0;0;.00nan;0;0
45311;8132;77;56;36;5;31;.861;3600000;0
45457;6824;67;93;60;4;56;.933;3600000;0
45457;7269;67;0;0;0;0;.00nan;0;0
45457;7389;74;0;0;0;0;.00nan;0;0
45457;8442;74;50;10;1;9;.900;3600000;0
45315;6813;83;48;13;3;10;.769;3721000;0
45315;7325;83;0;0;0;0;.00nan;0;0
45315;7901;79;0;0;0;0;.00nan;0;0
45315;7904;79;86;54;4;50;.926;3721000;0
45355;7409;70;50;22;3;19;.864;3600000;0
45355;7899;81;35;28;5;23;.821;2587000;0
45355;8367;70;0;0;0;0;.00nan;0;0
45355;8450;81;26;13;4;9;.692;1013000;0
45343;8476;63;78;31;2;29;.935;3600000;0
45343;8499;78;57;14;1;13;.929;3045000;0
45343;8711;78;23;6;3;3;.500;472000;0
45343;9247;63;0;0;0;0;.00nan;0;0
45359;6821;71;84;28;2;26;.929;3600000;0
45359;6837;73;88;45;3;42;.933;3555000;0
45359;8130;71;0;0;0;0;.00nan;0;0
45359;8429;73;0;0;0;0;.00nan;0;0
45318;8113;77;93;58;2;56;.966;3600000;0
45318;8132;77;0;0;0;0;.00nan;0;0
45318;8133;76;0;0;0;0;.00nan;0;0
45318;8420;76;57;14;1;13;.929;3600000;0
45463;7237;75;0;0;0;0;.00nan;0;0
45463;7271;82;91;29;1;28;.966;3600000;0
45463;7298;75;72;29;2;27;.931;3559000;0
45463;7302;82;0;0;0;0;.00nan;0;0
45415;7237;75;37;22;4;18;.818;3600000;0
45415;7298;75;0;0;0;0;.00nan;0;0
45415;7901;79;0;0;0;0;.00nan;0;0
45415;7904;79;48;36;5;31;.861;3573000;0
45417;7840;66;0;0;0;0;.00nan;0;0
45417;7864;66;99;33;1;32;.970;3600000;0
45417;7899;81;52;2;0;2;1.000;1186000;0
45417;8450;81;14;18;6;12;.667;2414000;0
45325;7385;84;25;19;5;14;.737;1094000;0
45325;7855;84;67;37;3;34;.919;2506000;0
45325;7908;64;0;0;0;0;.00nan;0;0
45325;8404;64;60;13;1;12;.923;3600000;0
45345;6804;72;75;9;0;9;1.000;3600000;0
45345;6824;67;52;44;6;38;.864;1762000;0
45345;6879;72;0;0;0;0;.00nan;0;0
45345;7269;67;43;32;5;27;.844;1838000;0
45374;6939;69;45;25;4;21;.840;3600000;0
45374;7596;69;0;0;0;0;.00nan;0;0
45374;7598;65;40;31;5;26;.839;3561000;0
45374;7911;65;0;0;0;0;.00nan;0;0
45347;8133;76;73;57;6;51;.895;3600000;0
45347;8420;76;0;0;0;0;.00nan;0;0
45347;8499;78;0;0;0;0;.00nan;0;0
45347;8711;78;77;27;1;26;.963;3600000;0
45391;7901;79;56;50;6;44;.880;3052000;0
45391;7904;79;24;5;3;2;.400;548000;0
45391;8493;80;0;0;0;0;.00nan;0;0
45391;8685;80;55;16;2;14;.875;3600000;0
45333;7899;81;48;4;0;4;1.000;1140000;0
45333;8113;77;0;0;0;0;.00nan;0;0
45333;8132;77;60;48;6;42;.875;3900000;0
45333;8450;81;12;16;6;10;.625;2760000;0
45350;6804;72;84;27;1;26;.963;3600000;0
45350;6879;72;0;0;0;0;.00nan;0;0
45350;7389;74;49;30;5;25;.833;3600000;0
45350;8442;74;0;0;0;0;.00nan;0;0
45437;6824;67;97;68;4;64;.941;3600000;0
45437;7269;67;0;0;0;0;.00nan;0;0
45437;8476;63;0;0;0;0;.00nan;0;0
45437;9247;63;48;7;1;6;.857;3600000;0
45439;6837;73;52;46;7;39;.848;2666000;0
45439;6905;68;0;0;0;0;.00nan;0;0
45439;7816;68;42;18;3;15;.833;3600000;0
45439;8429;73;64;14;0;14;1.000;934000;0
45432;6905;68;64;27;3;24;.889;3600000;0
45432;7389;74;71;37;4;33;.892;2853000;0
45432;7816;68;0;0;0;0;.00nan;0;0
45432;8442;74;16;8;4;4;.500;747000;0
45476;7271;82;85;35;2;33;.943;3600000;0
45476;7302;82;0;0;0;0;.00nan;0;0
45476;8493;80;65;32;3;29;.906;3593000;0
45476;8685;80;0;0;0;0;.00nan;0;0
45392;7409;70;39;25;5;20;.800;3600000;0
45392;7908;64;18;25;7;18;.720;3591000;0
45392;8367;70;0;0;0;0;.00nan;0;0
45392;8404;64;0;0;0;0;.00nan;0;0
45330;6813;83;73;9;0;9;1.000;3600000;0
45330;6821;71;90;68;7;61;.897;3600000;0
45330;7325;83;0;0;0;0;.00nan;0;0
45330;8130;71;0;0;0;0;.00nan;0;0
45405;7598;65;0;0;0;0;.00nan;0;0
45405;7911;65;84;53;4;49;.925;3600000;0
45405;8476;63;24;26;6;20;.769;3058000;0
45405;9247;63;48;0;0;0;.00nan;491000;0
45947;6939;69;66;38;5;33;.868;3548000;0
45947;7596;69;0;0;0;0;.00nan;0;0
45947;8133;76;0;0;0;0;.00nan;0;0
45947;8420;76;56;28;3;25;.893;3600000;0
45528;7237;75;0;0;0;0;.00nan;0;0
45528;7298;75;51;7;1;6;.857;3600000;0
45528;7385;84;11;18;6;12;.667;1015000;0
45528;7855;84;37;48;7;41;.854;2585000;0
45403;7409;70;0;0;0;0;.00nan;0;0
45403;7598;65;58;40;5;35;.875;3581000;0
45403;7911;65;0;0;0;0;.00nan;0;0
45403;8367;70;50;16;3;13;.813;3600000;0
45360;6821;71;70;28;4;24;.857;3900000;0
45360;7899;81;0;0;0;0;.00nan;0;0
45360;8130;71;0;0;0;0;.00nan;0;0
45360;8450;81;58;39;4;35;.897;3900000;0
45383;6813;83;49;24;4;20;.833;3600000;0
45383;7237;75;86;59;5;54;.915;3600000;0
45383;7298;75;0;0;0;0;.00nan;0;0
45383;7325;83;0;0;0;0;.00nan;0;0
45962;8133;76;0;0;0;0;.00nan;0;0
45962;8420;76;82;29;1;28;.966;3755000;0
45962;8476;63;0;0;0;0;.00nan;0;0
45962;9247;63;80;35;2;33;.943;3755000;0
45365;8113;77;40;8;2;6;.750;317000;0
45365;8132;77;70;58;6;52;.897;3283000;0
45365;8499;78;0;0;0;0;.00nan;0;0
45365;8711;78;70;8;0;8;1.000;3600000;0
45396;6939;69;75;39;4;35;.897;3600000;0
45396;7596;69;0;0;0;0;.00nan;0;0
45396;7840;66;0;0;0;0;.00nan;0;0
45396;7864;66;53;24;3;21;.875;3600000;0
45482;6824;67;36;31;5;26;.839;2119000;0
45482;7269;67;83;47;3;44;.936;1481000;0
45482;7271;82;72;6;0;6;1.000;3600000;0
45482;7302;82;0;0;0;0;.00nan;0;0
45972;6837;73;58;36;5;31;.861;3600000;0
45972;7389;74;77;28;2;26;.929;3600000;0
45972;8429;73;0;0;0;0;.00nan;0;0
45972;8442;74;0;0;0;0;.00nan;0;0
45371;6813;83;0;0;0;0;.00nan;0;0
45371;7271;82;100;47;1;46;.979;3600000;0
45371;7302;82;0;0;0;0;.00nan;0;0
45371;7325;83;52;17;2;15;.882;3600000;0
45402;7908;64;0;0;0;0;.00nan;0;0
45402;8404;64;64;17;1;16;.941;3600000;0
45402;8476;63;71;37;3;34;.919;3581000;0
45402;9247;63;0;0;0;0;.00nan;0;0
45369;6804;72;60;10;1;9;.900;3600000;0
45369;6879;72;0;0;0;0;.00nan;0;0
45369;6905;68;0;0;0;0;.00nan;0;0
45369;7816;68;93;52;3;49;.942;3556000;0
45421;6837;73;0;0;0;0;.00nan;0;0
45421;7409;70;40;14;3;11;.786;3600000;0
45421;8367;70;0;0;0;0;.00nan;0;0
45421;8429;73;64;40;4;36;.900;3551000;0
45354;7901;79;0;0;0;0;.00nan;0;0
45354;7904;79;32;22;5;17;.773;3567000;0
45354;8113;77;28;15;4;11;.733;1179000;0
45354;8132;77;100;36;0;36;1.000;2421000;0
45348;7385;84;100;44;1;43;.977;3600000;0
45348;7840;66;36;18;4;14;.778;3600000;0
45348;7855;84;0;0;0;0;.00nan;0;0
45348;7864;66;0;0;0;0;.00nan;0;0
45351;6821;71;0;0;0;0;.00nan;0;0
45351;8130;71;51;28;4;24;.857;3600000;0
45351;8133;76;30;22;5;17;.773;3558000;0
45351;8420;76;0;0;0;0;.00nan;0;0
45956;6905;68;54;27;4;23;.852;3599000;0
45956;6939;69;90;47;3;44;.936;3600000;0
45956;7596;69;0;0;0;0;.00nan;0;0
45956;7816;68;0;0;0;0;.00nan;0;0
45428;6824;67;54;42;6;36;.857;2341000;0
45428;7269;67;57;13;1;12;.923;1259000;0
45428;7899;81;0;0;0;0;.00nan;0;0
45428;8450;81;69;18;1;17;.944;3600000;0
45424;7389;74;46;15;2;13;.867;3600000;0
45424;7598;65;0;0;0;0;.00nan;0;0
45424;7911;65;54;39;6;33;.846;3600000;0
45424;8442;74;0;0;0;0;.00nan;0;0
45352;6804;72;0;0;0;0;.00nan;0;0
45352;6879;72;63;12;1;11;.917;3600000;0
45352;7901;79;49;37;5;32;.865;3600000;0
45352;7904;79;0;0;0;0;.00nan;0;0
45356;6821;71;62;50;6;44;.880;3600000;0
45356;8130;71;0;0;0;0;.00nan;0;0
45356;8499;78;0;0;0;0;.00nan;0;0
45356;8711;78;78;21;1;20;.952;3600000;0
45467;7271;82;86;18;0;18;1.000;3600000;0
45467;7302;82;0;0;0;0;.00nan;0;0
45467;7409;70;55;34;4;30;.882;3600000;0
45467;8367;70;0;0;0;0;.00nan;0;0
45461;6824;67;66;37;3;34;.919;3900000;0
45461;6837;73;69;31;3;28;.903;3900000;0
45461;7269;67;0;0;0;0;.00nan;0;0
45461;8429;73;0;0;0;0;.00nan;0;0
45407;7908;64;0;0;0;0;.00nan;0;0
45407;8404;64;79;30;2;28;.933;3551000;0
45407;8476;63;86;39;1;38;.974;3600000;0
45407;9247;63;0;0;0;0;.00nan;0;0
45434;6813;83;0;0;0;0;.00nan;0;0
45434;7325;83;75;10;0;10;1.000;3600000;0
45434;7598;65;82;65;6;59;.908;3600000;0
45434;7911;65;0;0;0;0;.00nan;0;0
45362;7389;74;0;0;0;0;.00nan;0;0
45362;8133;76;0;0;0;0;.00nan;0;0
45362;8420;76;78;31;2;29;.935;3600000;0
45362;8442;74;49;21;4;17;.810;3585000;0
45353;7385;84;44;52;8;44;.846;2603000;0
45353;7855;84;54;16;2;14;.875;997000;0
45353;8493;80;0;0;0;0;.00nan;0;0
45353;8685;80;43;6;2;4;.667;3600000;0
45381;7237;75;0;0;0;0;.00nan;0;0
45381;7298;75;46;16;3;13;.813;3600000;0
45381;8113;77;0;0;0;0;.00nan;0;0
45381;8132;77;76;75;7;68;.907;3600000;0
45387;6905;68;0;0;0;0;.00nan;0;0
45387;6939;69;80;28;2;26;.929;3600000;0
45387;7596;69;0;0;0;0;.00nan;0;0
45387;7816;68;61;29;3;26;.897;3581000;0
45655;6813;83;0;0;0;0;.00nan;0;0
45655;6821;71;90;53;4;49;.925;3563000;0
45655;7325;83;66;19;2;17;.895;3600000;0
45655;8130;71;0;0;0;0;.00nan;0;0
45349;7385;84;47;22;3;19;.864;1490000;0
45349;7409;70;0;0;0;0;.00nan;0;0
45349;7855;84;24;30;6;24;.800;2110000;0
45349;8367;70;60;13;1;12;.923;3600000;0
45495;6837;73;99;44;1;43;.977;3600000;0
45495;6905;68;27;22;5;17;.773;3600000;0
45495;7816;68;0;0;0;0;.00nan;0;0
45495;8429;73;0;0;0;0;.00nan;0;0
45363;8133;76;0;0;0;0;.00nan;0;0
45363;8420;76;70;60;6;54;.900;3600000;0
45363;8499;78;0;0;0;0;.00nan;0;0
45363;8711;78;43;11;2;9;.818;3600000;0
45625;8113;77;57;5;0;5;1.000;245000;0
45625;8132;77;50;70;11;59;.843;3355000;0
45625;8493;80;0;0;0;0;.00nan;0;0
45625;8685;80;66;9;1;8;.889;3600000;0
45393;6939;69;62;39;5;34;.872;3600000;0
45393;7389;74;58;23;2;21;.913;3600000;0
45393;7596;69;0;0;0;0;.00nan;0;0
45393;8442;74;0;0;0;0;.00nan;0;0
45408;7598;65;71;24;1;23;.958;1399000;0
45408;7911;65;65;35;4;31;.886;2137000;0
45408;8476;63;34;16;4;12;.750;3600000;0
45408;9247;63;0;0;0;0;.00nan;0;0
45418;6804;72;69;30;3;27;.900;3600000;0
45418;6879;72;0;0;0;0;.00nan;0;0
45418;7899;81;0;0;0;0;.00nan;0;0
45418;8450;81;90;51;4;47;.922;3600000;0
45414;7901;79;0;0;0;0;.00nan;0;0
45414;7904;79;60;30;2;28;.933;3900000;0
45414;7908;64;0;0;0;0;.00nan;0;0
45414;8404;64;87;32;2;30;.938;3900000;0
45932;7237;75;0;0;0;0;.00nan;0;0
45932;7298;75;55;21;3;18;.857;3600000;0
45932;7840;66;0;0;0;0;.00nan;0;0
45932;7864;66;78;57;6;51;.895;3600000;0
45483;7271;82;57;11;1;10;.909;3600000;0
45483;7302;82;0;0;0;0;.00nan;0;0
45483;7409;70;85;45;3;42;.933;3600000;0
45483;8367;70;0;0;0;0;.00nan;0;0
45970;7908;64;0;0;0;0;.00nan;0;0
45970;8404;64;61;23;2;21;.913;3900000;0
45970;8476;63;75;29;2;27;.931;3900000;0
45970;9247;63;0;0;0;0;.00nan;0;0
45471;8133;76;31;10;3;7;.700;447000;0
45471;8420;76;46;49;8;41;.837;3153000;0
45471;8493;80;75;10;0;10;1.000;3600000;0
45471;8685;80;0;0;0;0;.00nan;0;0
45444;6824;67;85;24;1;23;.958;3600000;0
45444;7269;67;0;0;0;0;.00nan;0;0
45444;7598;65;0;0;0;0;.00nan;0;0
45444;7911;65;32;24;5;19;.792;3600000;0
45364;7385;84;78;52;5;47;.904;3600000;0
45364;7389;74;56;14;1;13;.929;3600000;0
45364;7855;84;0;0;0;0;.00nan;0;0
45364;8442;74;0;0;0;0;.00nan;0;0
45708;6837;73;71;45;4;41;.911;3529000;0
45708;6905;68;0;0;0;0;.00nan;0;0
45708;7816;68;64;20;2;18;.900;3600000;0
45708;8429;73;0;0;0;0;.00nan;0;0
45389;7901;79;0;0;0;0;.00nan;0;0
45389;7904;79;57;19;2;17;.895;3600000;0
45389;8113;77;46;59;8;51;.864;3600000;0
45389;8132;77;0;0;0;0;.00nan;0;0
45384;6821;71;54;10;2;8;.800;3600000;0
45384;8113;77;0;0;0;0;.00nan;0;0
45384;8130;71;0;0;0;0;.00nan;0;0
45384;8132;77;38;51;8;43;.843;3600000;0
45366;7385;84;60;37;4;33;.892;2054000;0
45366;7855;84;20;29;6;23;.793;1546000;0
45366;8493;80;67;6;0;6;1.000;3600000;0
45366;8685;80;0;0;0;0;.00nan;0;0
45411;6813;83;70;3;0;3;1.000;3600000;0
45411;7325;83;0;0;0;0;.00nan;0;0
45411;8476;63;55;8;0;8;1.000;696000;0
45411;9247;63;52;64;8;56;.875;2904000;0
45413;6804;72;74;16;1;15;.938;3600000;0
45413;6879;72;0;0;0;0;.00nan;0;0
45413;7389;74;0;0;0;0;.00nan;0;0
45413;8442;74;88;55;3;52;.945;3550000;0
45456;7409;70;0;0;0;0;.00nan;0;0
45456;7598;65;94;60;4;56;.933;3565000;0
45456;7911;65;0;0;0;0;.00nan;0;0
45456;8367;70;48;15;2;13;.867;3600000;0
45447;7271;82;0;0;0;0;.00nan;0;0
45447;7302;82;58;12;1;11;.917;3600000;0
45447;7901;79;56;57;6;51;.895;3053000;0
45447;7904;79;50;9;1;8;.889;547000;0
45401;7237;75;40;40;6;34;.850;3600000;0
45401;7298;75;0;0;0;0;.00nan;0;0
45401;8499;78;0;0;0;0;.00nan;0;0
45401;8711;78;61;23;2;21;.913;3600000;0
45854;6837;73;47;44;7;37;.841;2773000;0
45854;7840;66;0;0;0;0;.00nan;0;0
45854;7864;66;53;10;1;9;.900;3600000;0
45854;8429;73;59;12;1;11;.917;827000;0
45433;6824;67;62;48;6;42;.875;3287000;0
45433;7269;67;55;5;0;5;1.000;313000;0
45433;7908;64;60;23;2;21;.913;3600000;0
45433;8404;64;0;0;0;0;.00nan;0;0
45504;6939;69;63;41;4;37;.902;3600000;0
45504;7237;75;0;0;0;0;.00nan;0;0
45504;7298;75;68;19;1;18;.947;3600000;0
45504;7596;69;0;0;0;0;.00nan;0;0
45382;6813;83;44;25;4;21;.840;3871000;0
45382;7325;83;0;0;0;0;.00nan;0;0
45382;8499;78;0;0;0;0;.00nan;0;0
45382;8711;78;50;35;4;31;.886;3900000;0
45950;7271;82;96;41;2;39;.951;3600000;0
45950;7302;82;0;0;0;0;.00nan;0;0
45950;8493;80;42;33;6;27;.818;2796000;0
45950;8685;80;39;13;3;10;.769;804000;0
45436;6804;72;0;0;0;0;.00nan;0;0
45436;6879;72;69;18;1;17;.944;3600000;0
45436;6905;68;0;0;0;0;.00nan;0;0
45436;7816;68;56;50;7;43;.860;3600000;0
45385;7385;84;41;28;4;24;.857;1831000;0
45385;7855;84;47;35;5;30;.857;1769000;0
45385;7899;81;0;0;0;0;.00nan;0;0
45385;8450;81;47;8;2;6;.750;3600000;0
45431;8133;76;43;42;7;35;.833;3600000;0
45431;8420;76;0;0;0;0;.00nan;0;0
45431;8476;63;55;35;4;31;.886;3600000;0
45431;9247;63;0;0;0;0;.00nan;0;0
45427;6939;69;61;20;2;18;.900;3600000;0
45427;7596;69;0;0;0;0;.00nan;0;0
45427;8113;77;0;0;0;0;.00nan;0;0
45427;8132;77;65;54;6;48;.889;3600000;0
45404;6821;71;78;38;2;36;.947;3548000;0
45404;7908;64;0;0;0;0;.00nan;0;0
45404;8130;71;0;0;0;0;.00nan;0;0
45404;8404;64;79;13;0;13;1.000;3600000;0
45565;7271;82;97;22;0;22;1.000;3600000;0
45565;7302;82;0;0;0;0;.00nan;0;0
45565;8493;80;44;5;1;4;.800;338000;0
45565;8685;80;30;33;6;27;.818;3262000;0
45426;7389;74;47;14;2;12;.857;3600000;0
45426;7899;81;0;0;0;0;.00nan;0;0
45426;8442;74;0;0;0;0;.00nan;0;0
45426;8450;81;59;36;4;32;.889;3600000;0
45518;6837;73;97;50;3;47;.940;3582000;0
45518;7409;70;66;19;2;17;.895;3600000;0
45518;8367;70;0;0;0;0;.00nan;0;0
45518;8429;73;0;0;0;0;.00nan;0;0
45406;6821;71;0;0;0;0;.00nan;0;0
45406;8130;71;52;18;2;16;.889;3600000;0
45406;8133;76;0;0;0;0;.00nan;0;0
45406;8420;76;64;42;4;38;.905;3595000;0
45474;6804;72;70;6;0;6;1.000;3600000;0
45474;6879;72;0;0;0;0;.00nan;0;0
45474;7840;66;72;18;0;18;1.000;1372000;0
45474;7864;66;47;40;6;34;.850;2228000;0
45546;7237;75;0;0;0;0;.00nan;0;0
45546;7298;75;71;21;1;20;.952;3600000;0
45546;7901;79;56;5;0;5;1.000;477000;0
45546;7904;79;41;38;6;32;.842;3123000;0
45422;6813;83;0;0;0;0;.00nan;0;0
45422;6905;68;61;44;5;39;.886;3600000;0
45422;7325;83;65;25;2;23;.920;3600000;0
45422;7816;68;0;0;0;0;.00nan;0;0
45440;7840;66;0;0;0;0;.00nan;0;0
45440;7864;66;81;25;1;24;.960;3600000;0
45440;8476;63;61;29;3;26;.897;3520000;0
45440;9247;63;0;0;0;0;.00nan;0;0
45429;7598;65;47;19;3;16;.842;1230000;0
45429;7911;65;51;45;6;39;.867;2370000;0
45429;8499;78;0;0;0;0;.00nan;0;0
45429;8711;78;63;17;1;16;.941;3600000;0
45451;6824;67;36;32;6;26;.813;2863000;0
45451;6939;69;76;27;1;26;.963;3600000;0
45451;7269;67;49;6;1;5;.833;737000;0
45451;7596;69;0;0;0;0;.00nan;0;0
45443;7899;81;0;0;0;0;.00nan;0;0
45443;7908;64;0;0;0;0;.00nan;0;0
45443;8404;64;36;17;4;13;.765;3600000;0
45443;8450;81;44;40;6;34;.850;3600000;0
45971;6905;68;0;0;0;0;.00nan;0;0
45971;6939;69;89;42;2;40;.952;3600000;0
45971;7596;69;0;0;0;0;.00nan;0;0
45971;7816;68;26;22;5;17;.773;3600000;0
45963;6813;83;0;0;0;0;.00nan;0;0
45963;7325;83;63;18;2;16;.889;3600000;0
45963;7901;79;21;35;7;28;.800;2095000;0
45963;7904;79;50;16;2;14;.875;1505000;0
45458;7389;74;78;25;1;24;.960;3600000;0
45458;7598;65;0;0;0;0;.00nan;0;0
45458;7911;65;61;37;5;32;.865;3600000;0
45458;8442;74;0;0;0;0;.00nan;0;0
45496;8113;77;68;51;6;45;.882;3600000;0
45496;8132;77;0;0;0;0;.00nan;0;0
45496;8476;63;0;0;0;0;.00nan;0;0
45496;9247;63;54;16;2;14;.875;3600000;0
45955;7271;82;47;4;1;3;.750;3600000;0
45955;7302;82;0;0;0;0;.00nan;0;0
45955;7385;84;41;35;5;30;.857;2296000;0
45955;7855;84;39;18;3;15;.833;1304000;0
45486;6837;73;73;49;5;44;.898;3600000;0
45486;8133;76;81;32;2;30;.938;3600000;0
45486;8420;76;0;0;0;0;.00nan;0;0
45486;8429;73;0;0;0;0;.00nan;0;0
45494;7840;66;0;0;0;0;.00nan;0;0
45494;7864;66;59;27;3;24;.889;3600000;0
45494;7901;79;49;10;1;9;.900;734000;0
45494;7904;79;15;25;7;18;.720;2866000;0
45430;6804;72;57;17;2;15;.882;3600000;0
45430;6879;72;0;0;0;0;.00nan;0;0
45430;8499;78;54;4;0;4;1.000;508000;0
45430;8711;78;25;35;7;28;.800;3092000;0
45543;6824;67;72;27;2;25;.926;3600000;0
45543;7269;67;0;0;0;0;.00nan;0;0
45543;7840;66;54;24;3;21;.875;3557000;0
45543;7864;66;0;0;0;0;.00nan;0;0
45441;7271;82;56;27;4;23;.852;3600000;0
45441;7302;82;0;0;0;0;.00nan;0;0
45441;8499;78;22;9;4;5;.556;1026000;0
45441;8711;78;41;23;4;19;.826;2574000;0
45480;6804;72;0;0;0;0;.00nan;0;0
45480;6879;72;49;5;1;4;.800;3600000;0
45480;7389;74;49;1;0;1;1.000;272000;0
45480;8442;74;25;35;7;28;.800;3328000;0
45508;6905;68;68;22;2;20;.909;3600000;0
45508;7816;68;0;0;0;0;.00nan;0;0
45508;8476;63;37;33;7;26;.788;2842000;0
45508;9247;63;55;4;0;4;1.000;758000;0
45448;6821;71;62;12;1;11;.917;3600000;0
45448;6837;73;27;27;6;21;.778;1086000;0
45448;8130;71;0;0;0;0;.00nan;0;0
45448;8429;73;56;52;6;46;.885;2514000;0
45416;7385;84;67;36;4;32;.889;3600000;0
45416;7598;65;71;23;1;22;.957;3600000;0
45416;7855;84;0;0;0;0;.00nan;0;0
45416;7911;65;0;0;0;0;.00nan;0;0
45438;6813;83;0;0;0;0;.00nan;0;0
45438;7325;83;86;19;0;19;1.000;3600000;0
45438;8493;80;0;0;0;0;.00nan;0;0
45438;8685;80;81;41;3;38;.927;3600000;0
45435;7237;75;0;0;0;0;.00nan;0;0
45435;7298;75;55;17;2;15;.882;3548000;0
45435;7899;81;0;0;0;0;.00nan;0;0
45435;8450;81;99;45;1;44;.978;3600000;0
45531;6939;69;84;64;5;59;.922;3600000;0
45531;7237;75;52;10;1;9;.900;3600000;0
45531;7298;75;0;0;0;0;.00nan;0;0
45531;7596;69;0;0;0;0;.00nan;0;0
45395;7271;82;77;8;0;8;1.000;3600000;0
45395;7302;82;0;0;0;0;.00nan;0;0
45395;7385;84;88;57;5;52;.912;3600000;0
45395;7855;84;0;0;0;0;.00nan;0;0
45462;8493;80;20;10;4;6;.600;766000;0
45462;8499;78;42;18;3;15;.833;3600000;0
45462;8685;80;56;33;4;29;.879;2834000;0
45462;8711;78;0;0;0;0;.00nan;0;0
45512;6824;67;97;56;3;53;.946;3600000;0
45512;7269;67;0;0;0;0;.00nan;0;0
45512;8476;63;42;8;2;6;.750;3600000;0
45512;9247;63;0;0;0;0;.00nan;0;0
45500;6804;72;45;21;4;17;.810;3600000;0
45500;6879;72;0;0;0;0;.00nan;0;0
45500;7409;70;41;34;5;29;.853;3533000;0
45500;8367;70;0;0;0;0;.00nan;0;0
45446;6939;69;67;49;5;44;.898;3600000;0
45446;7596;69;0;0;0;0;.00nan;0;0
45446;7908;64;0;0;0;0;.00nan;0;0
45446;8404;64;71;16;1;15;.938;3600000;0
45442;6821;71;46;15;3;12;.800;3336000;0
45442;7840;66;78;53;5;48;.906;3600000;0
45442;7864;66;0;0;0;0;.00nan;0;0
45442;8130;71;51;1;0;1;1.000;264000;0
45452;7899;81;0;0;0;0;.00nan;0;0
45452;8133;76;61;25;2;23;.920;2566000;0
45452;8420;76;26;16;4;12;.750;980000;0
45452;8450;81;58;33;4;29;.879;3600000;0
45555;7901;79;0;0;0;0;.00nan;0;0
45555;7904;79;80;36;2;34;.944;3600000;0
45555;8493;80;29;26;5;21;.808;3600000;0
45555;8685;80;0;0;0;0;.00nan;0;0
45409;7385;84;0;0;0;0;.00nan;0;0
45409;7855;84;63;34;3;31;.912;3543000;0
45409;8133;76;0;0;0;0;.00nan;0;0
45409;8420;76;79;29;2;27;.931;3600000;0
45459;6821;71;78;34;3;31;.912;3542000;0
45459;7409;70;0;0;0;0;.00nan;0;0
45459;8130;71;0;0;0;0;.00nan;0;0
45459;8367;70;57;20;2;18;.900;3600000;0
45465;7908;64;59;12;1;11;.917;3600000;0
45465;8113;77;0;0;0;0;.00nan;0;0
45465;8132;77;62;48;6;42;.875;3600000;0
45465;8404;64;0;0;0;0;.00nan;0;0
45514;6837;73;69;54;6;48;.889;3600000;0
45514;6905;68;0;0;0;0;.00nan;0;0
45514;7816;68;92;18;0;18;1.000;3600000;0
45514;8429;73;0;0;0;0;.00nan;0;0
45453;6813;83;0;0;0;0;.00nan;0;0
45453;7325;83;62;16;1;15;.938;3600000;0
45453;7899;81;69;44;4;40;.909;3600000;0
45453;8450;81;0;0;0;0;.00nan;0;0
45485;7271;82;70;15;1;14;.933;3600000;0
45485;7302;82;0;0;0;0;.00nan;0;0
45485;8113;77;86;69;6;63;.913;3600000;0
45485;8132;77;0;0;0;0;.00nan;0;0
45563;6905;68;0;0;0;0;.00nan;0;0
45563;6939;69;86;46;4;42;.913;3600000;0
45563;7596;69;0;0;0;0;.00nan;0;0
45563;7816;68;71;22;1;21;.955;3600000;0
45449;6813;83;73;20;1;19;.950;3600000;0
45449;7325;83;0;0;0;0;.00nan;0;0
45449;7389;74;39;41;7;34;.829;3224000;0
45449;8442;74;49;1;0;1;1.000;376000;0
45904;7237;75;0;0;0;0;.00nan;0;0
45904;7298;75;54;18;2;16;.889;3600000;0
45904;8133;76;98;57;3;54;.947;3543000;0
45904;8420;76;0;0;0;0;.00nan;0;0
45589;6824;67;25;36;8;28;.778;3089000;0
45589;7269;67;52;10;1;9;.900;511000;0
45589;7901;79;0;0;0;0;.00nan;0;0
45589;7904;79;52;11;1;10;.909;3600000;0
45455;7598;65;71;49;5;44;.898;2960000;0
45455;7908;64;0;0;0;0;.00nan;0;0
45455;7911;65;20;9;4;5;.556;640000;0
45455;8404;64;55;24;3;21;.875;3600000;0
45497;8133;76;0;0;0;0;.00nan;0;0
45497;8420;76;97;63;3;60;.952;3540000;0
45497;8493;80;0;0;0;0;.00nan;0;0
45497;8685;80;71;19;1;18;.947;3600000;0
45425;6905;68;91;15;0;15;1.000;3600000;0
45425;7385;84;35;33;6;27;.818;2571000;0
45425;7816;68;0;0;0;0;.00nan;0;0
45425;7855;84;56;14;1;13;.929;1029000;0
45470;7409;70;66;38;4;34;.895;3723000;0
45470;7899;81;0;0;0;0;.00nan;0;0
45470;8367;70;0;0;0;0;.00nan;0;0
45470;8450;81;54;29;5;24;.828;3723000;0
45530;6837;73;53;40;6;34;.850;3153000;0
45530;8429;73;58;4;0;4;1.000;447000;0
45530;8476;63;0;0;0;0;.00nan;0;0
45530;9247;63;100;31;0;31;1.000;3600000;0
45466;8113;77;0;0;0;0;.00nan;0;0
45466;8132;77;97;50;3;47;.940;3600000;0
45466;8499;78;0;0;0;0;.00nan;0;0
45466;8711;78;52;14;2;12;.857;3600000;0
45460;6939;69;61;27;3;24;.889;3900000;0
45460;7596;69;0;0;0;0;.00nan;0;0
45460;7598;65;0;0;0;0;.00nan;0;0
45460;7911;65;76;40;3;37;.925;3900000;0
45478;6804;72;36;13;3;10;.769;3600000;0
45478;6879;72;0;0;0;0;.00nan;0;0
45478;7908;64;68;43;4;39;.907;3600000;0
45478;8404;64;0;0;0;0;.00nan;0;0
45488;7901;79;0;0;0;0;.00nan;0;0
45488;7904;79;48;12;2;10;.833;3600000;0
45488;8113;77;56;41;5;36;.878;3600000;0
45488;8132;77;0;0;0;0;.00nan;0;0
45489;7389;74;51;33;4;29;.879;3900000;0
45489;7409;70;0;0;0;0;.00nan;0;0
45489;8367;70;38;25;4;21;.840;3900000;0
45489;8442;74;0;0;0;0;.00nan;0;0
45491;7271;82;92;33;1;32;.970;3600000;0
45491;7302;82;0;0;0;0;.00nan;0;0
45491;7899;81;78;45;3;42;.933;3596000;0
45491;8450;81;0;0;0;0;.00nan;0;0
45509;6804;72;0;0;0;0;.00nan;0;0
45509;6824;67;81;69;5;64;.928;3600000;0
45509;6879;72;39;6;2;4;.667;3600000;0
45509;7269;67;0;0;0;0;.00nan;0;0
45498;6821;71;47;25;4;21;.840;3600000;0
45498;6905;68;58;30;5;25;.833;3588000;0
45498;7816;68;0;0;0;0;.00nan;0;0
45498;8130;71;0;0;0;0;.00nan;0;0
45419;6813;83;0;0;0;0;.00nan;0;0
45419;7325;83;62;2;0;2;1.000;3600000;0
45419;7385;84;98;84;4;80;.952;3600000;0
45419;7855;84;0;0;0;0;.00nan;0;0
45468;7237;75;58;12;1;11;.917;1283000;0
45468;7298;75;35;35;6;29;.829;2317000;0
45468;8499;78;46;10;2;8;.800;1370000;0
45468;8711;78;23;29;6;23;.793;2175000;0
45695;6824;67;81;51;5;46;.902;3600000;0
45695;7269;67;0;0;0;0;.00nan;0;0
45695;7840;66;0;0;0;0;.00nan;0;0
45695;7864;66;59;11;1;10;.909;3600000;0
45511;7389;74;0;0;0;0;.00nan;0;0
45511;7901;79;38;29;6;23;.793;3600000;0
45511;7904;79;0;0;0;0;.00nan;0;0
45511;8442;74;51;23;3;20;.870;3600000;0
45973;6905;68;0;0;0;0;.00nan;0;0
45973;6939;69;89;46;3;43;.935;3900000;0
45973;7596;69;0;0;0;0;.00nan;0;0
45973;7816;68;35;13;3;10;.769;3868000;0
45502;8113;77;0;0;0;0;.00nan;0;0
45502;8132;77;70;53;5;48;.906;3600000;0
45502;8133;76;50;20;3;17;.850;3600000;0
45502;8420;76;0;0;0;0;.00nan;0;0
45503;6821;71;72;31;3;28;.903;3824000;0
45503;7409;70;70;30;2;28;.933;3809000;0
45503;8130;71;0;0;0;0;.00nan;0;0
45503;8367;70;0;0;0;0;.00nan;0;0
45475;7237;75;0;0;0;0;.00nan;0;0
45475;7298;75;56;35;5;30;.857;3600000;0
45475;8499;78;0;0;0;0;.00nan;0;0
45475;8711;78;95;24;0;24;1.000;3600000;0
45492;6804;72;31;24;5;19;.792;3584000;0
45492;6879;72;0;0;0;0;.00nan;0;0
45492;7271;82;71;41;4;37;.902;3600000;0
45492;7302;82;0;0;0;0;.00nan;0;0
45454;6813;83;87;16;0;16;1.000;3600000;0
45454;7325;83;0;0;0;0;.00nan;0;0
45454;8493;80;89;55;3;52;.945;3600000;0
45454;8685;80;0;0;0;0;.00nan;0;0
45499;7598;65;61;30;3;27;.900;3120000;0
45499;7911;65;26;6;3;3;.500;480000;0
45499;8476;63;0;0;0;0;.00nan;0;0
45499;9247;63;53;15;2;13;.867;3600000;0
45469;6813;83;0;0;0;0;.00nan;0;0
45469;6837;73;75;69;6;63;.913;3600000;0
45469;7325;83;44;8;2;6;.750;3600000;0
45469;8429;73;0;0;0;0;.00nan;0;0
45540;7901;79;0;0;0;0;.00nan;0;0
45540;7904;79;72;29;2;27;.931;3900000;0
45540;8133;76;0;0;0;0;.00nan;0;0
45540;8420;76;86;37;2;35;.946;3900000;0
45818;7237;75;58;38;4;34;.895;3600000;0
45818;7298;75;0;0;0;0;.00nan;0;0
45818;7899;81;0;0;0;0;.00nan;0;0
45818;8450;81;26;25;6;19;.760;3591000;0
45979;7409;70;0;0;0;0;.00nan;0;0
45979;8367;70;70;41;4;37;.902;3600000;0
45979;8499;78;0;0;0;0;.00nan;0;0
45979;8711;78;49;16;2;14;.875;3600000;0
45967;7271;82;0;0;0;0;.00nan;0;0
45967;7302;82;46;5;1;4;.800;3600000;0
45967;7385;84;32;34;6;28;.824;1865000;0
45967;7855;84;49;29;4;25;.862;1735000;0
45560;6905;68;76;37;4;33;.892;3518000;0
45560;7816;68;0;0;0;0;.00nan;0;0
45560;7840;66;55;19;2;17;.895;3600000;0
45560;7864;66;0;0;0;0;.00nan;0;0
45472;6824;67;97;52;3;49;.942;3600000;0
45472;7269;67;0;0;0;0;.00nan;0;0
45472;7908;64;0;0;0;0;.00nan;0;0
45472;8404;64;56;7;1;6;.857;3600000;0
45529;6837;73;86;47;4;43;.915;3900000;0
45529;7389;74;33;23;4;19;.826;3900000;0
45529;8429;73;0;0;0;0;.00nan;0;0
45529;8442;74;0;0;0;0;.00nan;0;0
45510;7899;81;28;6;3;3;.500;324000;0
45510;8450;81;56;20;2;18;.900;3238000;0
45510;8493;80;0;0;0;0;.00nan;0;0
45510;8685;80;65;36;4;32;.889;3600000;0
45477;7598;65;33;20;5;15;.750;1579000;0
45477;7908;64;38;8;2;6;.750;3600000;0
45477;7911;65;46;36;6;30;.833;2021000;0
45477;8404;64;0;0;0;0;.00nan;0;0
45516;7840;66;0;0;0;0;.00nan;0;0
45516;7864;66;79;41;3;38;.927;3617000;0
45516;8476;63;61;33;4;29;.879;3617000;0
45516;9247;63;0;0;0;0;.00nan;0;0
45420;6821;71;73;22;1;21;.955;3600000;0
45420;7385;84;47;32;5;27;.844;1848000;0
45420;7855;84;51;18;2;16;.889;1752000;0
45420;8130;71;0;0;0;0;.00nan;0;0
45527;7271;82;70;6;0;6;1.000;3600000;0
45527;7302;82;0;0;0;0;.00nan;0;0
45527;7389;74;24;14;4;10;.714;1169000;0
45527;8442;74;60;31;3;28;.903;2431000;0
45505;7899;81;0;0;0;0;.00nan;0;0
45505;8113;77;73;43;4;39;.907;3600000;0
45505;8132;77;0;0;0;0;.00nan;0;0
45505;8450;81;80;15;0;15;1.000;3600000;0
45479;6824;67;71;40;4;36;.900;3595000;0
45479;7269;67;0;0;0;0;.00nan;0;0
45479;7385;84;0;0;0;0;.00nan;0;0
45479;7855;84;38;15;3;12;.800;3600000;0
45481;7908;64;74;47;4;43;.915;3273000;0
45481;8404;64;38;10;3;7;.700;327000;0
45481;8499;78;83;26;1;25;.962;3600000;0
45481;8711;78;0;0;0;0;.00nan;0;0
45493;6813;83;0;0;0;0;.00nan;0;0
45493;6837;73;27;25;5;20;.800;1126000;0
45493;7325;83;52;20;3;17;.850;3600000;0
45493;8429;73;78;49;3;46;.939;2474000;0
45581;6905;68;0;0;0;0;.00nan;0;0
45581;7816;68;91;17;0;17;1.000;3600000;0
45581;8113;77;0;0;0;0;.00nan;0;0
45581;8132;77;65;57;7;50;.877;3600000;0
45487;7385;84;40;65;10;55;.846;3600000;0
45487;7855;84;0;0;0;0;.00nan;0;0
45487;8476;63;56;9;1;8;.889;3600000;0
45487;9247;63;0;0;0;0;.00nan;0;0
45520;6821;71;71;17;2;15;.882;3600000;0
45520;6824;67;0;0;0;0;.00nan;0;0
45520;7269;67;88;65;6;59;.908;3600000;0
45520;8130;71;0;0;0;0;.00nan;0;0
45473;6813;83;0;0;0;0;.00nan;0;0
45473;7325;83;42;24;4;20;.833;3900000;0
45473;8493;80;83;43;4;39;.907;3900000;0
45473;8685;80;0;0;0;0;.00nan;0;0
45522;7271;82;54;15;2;13;.867;3600000;0
45522;7302;82;0;0;0;0;.00nan;0;0
45522;7899;81;40;2;1;1;.500;324000;0
45522;8450;81;27;35;7;28;.800;3276000;0
45559;6804;72;50;6;1;5;.833;3600000;0
45559;6879;72;0;0;0;0;.00nan;0;0
45559;8133;76;98;72;5;67;.931;3600000;0
45559;8420;76;0;0;0;0;.00nan;0;0
45542;7409;70;33;26;5;21;.808;3638000;0
45542;7840;66;66;49;6;43;.878;3638000;0
45542;7864;66;0;0;0;0;.00nan;0;0
45542;8367;70;0;0;0;0;.00nan;0;0
45507;6939;69;70;40;4;36;.900;3576000;0
45507;7596;69;0;0;0;0;.00nan;0;0
45507;7908;64;0;0;0;0;.00nan;0;0
45507;8404;64;44;18;3;15;.833;3600000;0
45506;7598;65;43;24;4;20;.833;1488000;0
45506;7911;65;30;29;6;23;.793;2112000;0
45506;8499;78;0;0;0;0;.00nan;0;0
45506;8711;78;33;19;4;15;.789;3600000;0
45593;6905;68;0;0;0;0;.00nan;0;0
45593;7816;68;83;27;1;26;.963;3600000;0
45593;8476;63;53;13;1;12;.923;1584000;0
45593;9247;63;16;23;6;17;.739;2016000;0
45776;7389;74;25;20;5;15;.750;2304000;0
45776;8442;74;38;17;3;14;.824;1296000;0
45776;8493;80;0;0;0;0;.00nan;0;0
45776;8685;80;85;12;0;12;1.000;3600000;0
45484;7237;75;53;13;1;12;.923;793000;0
45484;7298;75;37;34;6;28;.824;2807000;0
45484;7908;64;0;0;0;0;.00nan;0;0
45484;8404;64;49;26;4;22;.846;3600000;0
45526;6837;73;58;42;5;37;.881;3600000;0
45526;7409;70;42;20;3;17;.850;3600000;0
45526;8367;70;0;0;0;0;.00nan;0;0
45526;8429;73;0;0;0;0;.00nan;0;0
45552;7899;81;0;0;0;0;.00nan;0;0
45552;8133;76;0;0;0;0;.00nan;0;0
45552;8420;76;44;32;5;27;.844;3600000;0
45552;8450;81;30;32;6;26;.813;3570000;0
45515;7840;66;77;48;4;44;.917;3600000;0
45515;7864;66;0;0;0;0;.00nan;0;0
45515;8499;78;0;0;0;0;.00nan;0;0
45515;8711;78;89;18;0;18;1.000;3600000;0
45564;6804;72;43;2;1;1;.500;3600000;0
45564;6824;67;56;52;7;45;.865;2023000;0
45564;6879;72;0;0;0;0;.00nan;0;0
45564;7269;67;67;39;4;35;.897;1577000;0
45517;6813;83;51;9;1;8;.889;3600000;0
45517;7325;83;0;0;0;0;.00nan;0;0
45517;7598;65;22;12;4;8;.667;966000;0
45517;7911;65;44;47;8;39;.830;2634000;0
45553;6939;69;34;13;4;9;.692;3600000;0
45553;7385;84;61;50;5;45;.900;3600000;0
45553;7596;69;0;0;0;0;.00nan;0;0
45553;7855;84;0;0;0;0;.00nan;0;0
45548;6821;71;75;24;1;23;.958;3600000;0
45548;7901;79;0;0;0;0;.00nan;0;0
45548;7904;79;73;32;2;30;.938;3600000;0
45548;8130;71;0;0;0;0;.00nan;0;0
45523;7271;82;46;5;1;4;.800;3600000;0
45523;7302;82;0;0;0;0;.00nan;0;0
45523;8113;77;76;70;7;63;.900;3216000;0
45523;8132;77;12;15;6;9;.600;384000;0
45547;6821;71;92;42;3;39;.929;3900000;0
45547;7901;79;52;25;3;22;.880;3900000;0
45547;7904;79;0;0;0;0;.00nan;0;0
45547;8130;71;0;0;0;0;.00nan;0;0
45980;7840;66;65;22;2;20;.909;2416000;0
45980;7864;66;21;12;4;8;.667;1184000;0
45980;7908;64;62;22;2;20;.909;3600000;0
45980;8404;64;0;0;0;0;.00nan;0;0
45533;6804;72;73;18;2;16;.889;3600000;0
45533;6837;73;98;64;3;61;.953;3590000;0
45533;6879;72;0;0;0;0;.00nan;0;0
45533;8429;73;0;0;0;0;.00nan;0;0
45534;6905;68;68;42;5;37;.881;3600000;0
45534;7409;70;44;24;4;20;.833;3600000;0
45534;7816;68;0;0;0;0;.00nan;0;0
45534;8367;70;0;0;0;0;.00nan;0;0
45761;7389;74;65;34;3;31;.912;3564000;0
45761;8442;74;0;0;0;0;.00nan;0;0
45761;8493;80;0;0;0;0;.00nan;0;0
45761;8685;80;77;24;1;23;.958;3600000;0
45521;7598;65;0;0;0;0;.00nan;0;0
45521;7911;65;34;33;6;27;.818;3540000;0
45521;8133;76;51;30;4;26;.867;3600000;0
45521;8420;76;0;0;0;0;.00nan;0;0
45562;7598;65;78;51;4;47;.922;3876000;0
45562;7911;65;0;0;0;0;.00nan;0;0
45562;8476;63;37;12;3;9;.750;3829000;0
45562;9247;63;0;0;0;0;.00nan;0;0
45596;7840;66;47;40;6;34;.850;3600000;0
45596;7864;66;0;0;0;0;.00nan;0;0
45596;7901;79;0;0;0;0;.00nan;0;0
45596;7904;79;92;17;0;17;1.000;3600000;0
45981;7271;82;90;33;2;31;.939;3900000;0
45981;7302;82;0;0;0;0;.00nan;0;0
45981;8493;80;67;27;2;25;.926;3900000;0
45981;8685;80;0;0;0;0;.00nan;0;0
45538;7899;81;0;0;0;0;.00nan;0;0
45538;8133;76;44;4;1;3;.750;632000;0
45538;8420;76;34;32;6;26;.813;2968000;0
45538;8450;81;30;19;5;14;.737;3600000;0
45550;6821;71;68;9;0;9;1.000;3600000;0
45550;7385;84;28;40;8;32;.800;2114000;0
45550;7855;84;44;37;5;32;.865;1486000;0
45550;8130;71;0;0;0;0;.00nan;0;0
45592;6837;73;53;24;3;21;.875;3600000;0
45592;8113;77;56;4;0;4;1.000;565000;0
45592;8132;77;38;35;6;29;.829;3035000;0
45592;8429;73;0;0;0;0;.00nan;0;0
45551;6813;83;0;0;0;0;.00nan;0;0
45551;6939;69;53;18;2;16;.889;1288000;0
45551;7325;83;56;16;2;14;.875;3600000;0
45551;7596;69;29;27;7;20;.741;2312000;0
45566;6905;68;0;0;0;0;.00nan;0;0
45566;7816;68;28;46;8;38;.826;3600000;0
45566;8499;78;0;0;0;0;.00nan;0;0
45566;8711;78;95;24;0;24;1.000;3600000;0
45513;7409;70;20;10;4;6;.600;922000;0
45513;7908;64;0;0;0;0;.00nan;0;0
45513;8367;70;57;12;1;11;.917;2662000;0
45513;8404;64;63;37;4;33;.892;3600000;0
45584;6824;67;79;48;4;44;.917;3600000;0
45584;7269;67;0;0;0;0;.00nan;0;0
45584;8476;63;0;0;0;0;.00nan;0;0
45584;9247;63;51;11;1;10;.909;3600000;0
45544;7901;79;63;19;1;18;.947;939000;0
45544;7904;79;54;52;8;44;.846;2661000;0
45544;8499;78;0;0;0;0;.00nan;0;0
45544;8711;78;42;20;3;17;.850;3600000;0
45549;7237;75;0;0;0;0;.00nan;0;0
45549;7298;75;8;19;6;13;.684;3600000;0
45549;8133;76;91;44;2;42;.955;3600000;0
45549;8420;76;0;0;0;0;.00nan;0;0
45519;6813;83;52;8;1;7;.875;3600000;0
45519;7325;83;0;0;0;0;.00nan;0;0
45519;7840;66;47;15;2;13;.867;1055000;0
45519;7864;66;49;44;6;38;.864;2545000;0
45536;6821;71;87;47;3;44;.936;3642000;0
45536;7271;82;54;11;2;9;.818;3642000;0
45536;7302;82;0;0;0;0;.00nan;0;0
45536;8130;71;0;0;0;0;.00nan;0;0
45557;7598;65;0;0;0;0;.00nan;0;0
45557;7911;65;27;11;4;7;.636;3900000;0
45557;8113;77;74;47;4;43;.915;3900000;0
45557;8132;77;0;0;0;0;.00nan;0;0
45524;7389;74;49;32;5;27;.844;3600000;0
45524;7908;64;61;21;2;19;.905;3600000;0
45524;8404;64;0;0;0;0;.00nan;0;0
45524;8442;74;0;0;0;0;.00nan;0;0
45567;6804;72;68;7;0;7;1.000;3600000;0
45567;6879;72;0;0;0;0;.00nan;0;0
45567;6905;68;98;70;4;66;.943;3600000;0
45567;7816;68;0;0;0;0;.00nan;0;0
45573;7385;84;74;32;2;30;.938;1445000;0
45573;7855;84;61;38;4;34;.895;2155000;0
45573;7899;81;35;15;4;11;.733;3600000;0
45573;8450;81;0;0;0;0;.00nan;0;0
45675;6824;67;86;56;5;51;.911;3600000;0
45675;7269;67;0;0;0;0;.00nan;0;0
45675;8476;63;86;15;0;15;1.000;3600000;0
45675;9247;63;0;0;0;0;.00nan;0;0
45532;7598;65;66;35;5;30;.857;3600000;0
45532;7840;66;34;28;6;22;.786;3576000;0
45532;7864;66;0;0;0;0;.00nan;0;0
45532;7911;65;0;0;0;0;.00nan;0;0
45588;6837;73;29;32;6;26;.813;2679000;0
45588;6939;69;72;37;3;34;.919;3600000;0
45588;7596;69;0;0;0;0;.00nan;0;0
45588;8429;73;48;10;1;9;.900;921000;0
45768;7389;74;0;0;0;0;.00nan;0;0
45768;8133;76;68;10;0;10;1.000;447000;0
45768;8420;76;24;29;6;23;.793;3153000;0
45768;8442;74;67;23;1;22;.957;3600000;0
45535;6813;83;0;0;0;0;.00nan;0;0
45535;7325;83;72;25;2;23;.920;3600000;0
45535;7901;79;0;0;0;0;.00nan;0;0
45535;7904;79;80;48;3;45;.938;3563000;0
45525;6905;68;0;0;0;0;.00nan;0;0
45525;7816;68;100;52;3;49;.942;3900000;0
45525;7908;64;0;0;0;0;.00nan;0;0
45525;8404;64;40;19;3;16;.842;3900000;0
45570;7237;75;69;7;0;7;1.000;3600000;0
45570;7298;75;0;0;0;0;.00nan;0;0
45570;7385;84;21;12;4;8;.667;1105000;0
45570;7855;84;92;57;4;53;.930;2495000;0
45558;6821;71;72;45;5;40;.889;3600000;0
45558;7271;82;85;15;0;15;1.000;3600000;0
45558;7302;82;0;0;0;0;.00nan;0;0
45558;8130;71;0;0;0;0;.00nan;0;0
45545;7409;70;61;41;5;36;.878;3600000;0
45545;8367;70;0;0;0;0;.00nan;0;0
45545;8499;78;0;0;0;0;.00nan;0;0
45545;8711;78;61;18;1;17;.944;3600000;0
45595;7409;70;31;19;4;15;.789;3600000;0
45595;7840;66;41;37;6;31;.838;2123000;0
45595;7864;66;67;30;3;27;.900;1477000;0
45595;8367;70;0;0;0;0;.00nan;0;0
45851;6824;67;83;63;5;58;.921;3600000;0
45851;7269;67;0;0;0;0;.00nan;0;0
45851;7389;74;73;18;1;17;.944;3600000;0
45851;8442;74;0;0;0;0;.00nan;0;0
45604;7237;75;65;11;1;10;.909;3600000;0
45604;7298;75;0;0;0;0;.00nan;0;0
45604;8113;77;40;16;3;13;.813;1359000;0
45604;8132;77;62;46;5;41;.891;2241000;0
45579;7901;79;100;49;2;47;.959;3600000;0
45579;7904;79;0;0;0;0;.00nan;0;0
45579;8493;80;0;0;0;0;.00nan;0;0
45579;8685;80;26;21;5;16;.762;3600000;0
45582;6804;72;56;13;1;12;.923;3600000;0
45582;6837;73;89;63;6;57;.905;3600000;0
45582;6879;72;0;0;0;0;.00nan;0;0
45582;8429;73;0;0;0;0;.00nan;0;0
45574;6804;72;0;0;0;0;.00nan;0;0
45574;6879;72;69;7;0;7;1.000;3600000;0
45574;8133;76;86;54;5;49;.907;3600000;0
45574;8420;76;0;0;0;0;.00nan;0;0
45569;7598;65;0;0;0;0;.00nan;0;0
45569;7911;65;94;57;5;52;.912;3600000;0
45569;8493;80;56;18;2;16;.889;3600000;0
45569;8685;80;0;0;0;0;.00nan;0;0
45677;6939;69;75;38;3;35;.921;3573000;0
45677;7596;69;0;0;0;0;.00nan;0;0
45677;8476;63;65;28;2;26;.929;3600000;0
45677;9247;63;0;0;0;0;.00nan;0;0
45539;7271;82;83;33;2;31;.939;3600000;0
45539;7302;82;0;0;0;0;.00nan;0;0
45539;7899;81;0;0;0;0;.00nan;0;0
45539;8450;81;70;44;4;40;.909;3530000;0
45759;6939;69;15;26;6;20;.769;2912000;0
45759;7596;69;50;1;0;1;1.000;627000;0
45759;7840;66;53;27;4;23;.852;3600000;0
45759;7864;66;0;0;0;0;.00nan;0;0
45646;6824;67;91;78;6;72;.923;3600000;0
45646;7269;67;0;0;0;0;.00nan;0;0
45646;7908;64;0;0;0;0;.00nan;0;0
45646;8404;64;50;10;1;9;.900;3600000;0
45580;6905;68;0;0;0;0;.00nan;0;0
45580;7816;68;64;27;2;25;.926;3600000;0
45580;7899;81;0;0;0;0;.00nan;0;0
45580;8450;81;100;26;0;26;1.000;3600000;0
45704;7237;75;0;0;0;0;.00nan;0;0
45704;7298;75;77;18;1;17;.944;3600000;0
45704;7385;84;95;63;5;58;.921;3600000;0
45704;7855;84;0;0;0;0;.00nan;0;0
45586;6804;72;0;0;0;0;.00nan;0;0
45586;6821;71;100;52;2;50;.962;3600000;0
45586;6879;72;37;13;3;10;.769;3580000;0
45586;8130;71;0;0;0;0;.00nan;0;0
45571;7598;65;20;8;4;4;.500;929000;0
45571;7911;65;46;50;7;43;.860;2671000;0
45571;8493;80;0;0;0;0;.00nan;0;0
45571;8685;80;50;14;2;12;.857;3600000;0
45561;7271;82;0;0;0;0;.00nan;0;0
45561;7302;82;37;11;3;8;.727;3900000;0
45561;8133;76;0;0;0;0;.00nan;0;0
45561;8420;76;96;50;3;47;.940;3900000;0
45585;7901;79;0;0;0;0;.00nan;0;0
45585;7904;79;81;45;4;41;.911;3600000;0
45585;8499;78;0;0;0;0;.00nan;0;0
45585;8711;78;59;20;2;18;.900;3600000;0
45600;7409;70;61;11;1;10;.909;3900000;0
45600;8113;77;0;0;0;0;.00nan;0;0
45600;8132;77;96;54;1;53;.981;3900000;0
45600;8367;70;0;0;0;0;.00nan;0;0
45591;6813;83;0;0;0;0;.00nan;0;0
45591;6821;71;98;60;4;56;.933;3600000;0
45591;7325;83;54;13;1;12;.923;3600000;0
45591;8130;71;0;0;0;0;.00nan;0;0
45590;7389;74;65;28;2;26;.929;3600000;0
45590;7908;64;67;29;3;26;.897;3595000;0
45590;8404;64;0;0;0;0;.00nan;0;0
45590;8442;74;0;0;0;0;.00nan;0;0
45608;6804;72;39;7;2;5;.714;3600000;0
45608;6879;72;0;0;0;0;.00nan;0;0
45608;8113;77;65;54;6;48;.889;1933000;0
45608;8132;77;51;33;5;28;.848;1667000;0
45583;7385;84;0;0;0;0;.00nan;0;0
45583;7409;70;72;6;0;6;1.000;3600000;0
45583;7855;84;86;58;4;54;.931;3600000;0
45583;8367;70;0;0;0;0;.00nan;0;0
45575;6824;67;62;63;7;56;.889;2981000;0
45575;7269;67;39;15;3;12;.800;619000;0
45575;8499;78;69;6;0;6;1.000;3600000;0
45575;8711;78;0;0;0;0;.00nan;0;0
45578;7598;65;63;30;3;27;.900;3685000;0
45578;7840;66;0;0;0;0;.00nan;0;0
45578;7864;66;43;25;4;21;.840;3685000;0
45578;7911;65;0;0;0;0;.00nan;0;0
45891;6905;68;97;38;1;37;.974;3900000;0
45891;7816;68;0;0;0;0;.00nan;0;0
45891;8476;63;90;30;1;29;.967;3900000;0
45891;9247;63;0;0;0;0;.00nan;0;0
45633;6837;73;99;45;2;43;.956;3600000;0
45633;6939;69;43;24;4;20;.833;3538000;0
45633;7596;69;0;0;0;0;.00nan;0;0
45633;8429;73;0;0;0;0;.00nan;0;0
45744;7271;82;74;16;1;15;.938;3600000;0
45744;7302;82;0;0;0;0;.00nan;0;0
45744;8493;80;59;44;5;39;.886;3600000;0
45744;8685;80;0;0;0;0;.00nan;0;0
45668;7237;75;0;0;0;0;.00nan;0;0
45668;7298;75;4;24;8;16;.667;3600000;0
45668;8133;76;98;69;5;64;.928;3600000;0
45668;8420;76;0;0;0;0;.00nan;0;0
45609;7899;81;0;0;0;0;.00nan;0;0
45609;7901;79;0;0;0;0;.00nan;0;0
45609;7904;79;91;49;3;46;.939;3874000;0
45609;8450;81;54;20;2;18;.900;3874000;0
45576;6813;83;78;13;0;13;1.000;3600000;0
45576;7325;83;0;0;0;0;.00nan;0;0
45576;7389;74;85;46;3;43;.935;3233000;0
45576;8442;74;27;9;3;6;.667;367000;0
45623;6804;72;72;18;1;17;.944;3600000;0
45623;6879;72;0;0;0;0;.00nan;0;0
45623;8476;63;79;44;3;41;.932;3600000;0
45623;9247;63;0;0;0;0;.00nan;0;0
45620;6905;68;0;0;0;0;.00nan;0;0
45620;7271;82;46;10;2;8;.800;3600000;0
45620;7302;82;0;0;0;0;.00nan;0;0
45620;7816;68;94;52;3;49;.942;3552000;0
45622;7385;84;74;51;5;46;.902;3600000;0
45622;7855;84;0;0;0;0;.00nan;0;0
45622;8493;80;0;0;0;0;.00nan;0;0
45622;8685;80;54;8;1;7;.875;3600000;0
45568;7901;79;31;32;7;25;.781;2361000;0
45568;7904;79;50;16;2;14;.875;1239000;0
45568;7908;64;0;0;0;0;.00nan;0;0
45568;8404;64;66;22;2;20;.909;3600000;0
45637;7840;66;84;52;2;50;.962;3900000;0
45637;7864;66;0;0;0;0;.00nan;0;0
45637;7899;81;55;19;2;17;.895;3900000;0
45637;8450;81;0;0;0;0;.00nan;0;0
45607;6824;67;75;57;6;51;.895;2477000;0
45607;7269;67;73;23;1;22;.957;1123000;0
45607;7409;70;86;13;0;13;1.000;3600000;0
45607;8367;70;0;0;0;0;.00nan;0;0
45611;6821;71;87;36;2;34;.944;3900000;0
45611;6939;69;93;40;2;38;.950;3900000;0
45611;7596;69;0;0;0;0;.00nan;0;0
45611;8130;71;0;0;0;0;.00nan;0;0
45602;6837;73;91;48;4;44;.917;3655000;0
45602;8429;73;0;0;0;0;.00nan;0;0
45602;8499;78;50;16;3;13;.813;3655000;0
45602;8711;78;0;0;0;0;.00nan;0;0
45813;7598;65;0;0;0;0;.00nan;0;0
45813;7911;65;41;28;5;23;.821;3600000;0
45813;8113;77;0;0;0;0;.00nan;0;0
45813;8132;77;37;33;6;27;.818;3572000;0
45577;7237;75;50;23;4;19;.826;3900000;0
45577;7298;75;0;0;0;0;.00nan;0;0
45577;8133;76;0;0;0;0;.00nan;0;0
45577;8420;76;94;59;4;55;.932;3900000;0
45572;6824;67;80;67;6;61;.910;3600000;0
45572;7269;67;0;0;0;0;.00nan;0;0
45572;7908;64;0;0;0;0;.00nan;0;0
45572;8404;64;48;5;1;4;.800;3600000;0
45587;7237;75;0;0;0;0;.00nan;0;0
45587;7298;75;57;25;3;22;.880;3600000;0
45587;8499;78;0;0;0;0;.00nan;0;0
45587;8711;78;23;29;6;23;.793;3543000;0
45614;6939;69;80;28;2;26;.929;3600000;0
45614;7409;70;77;36;3;33;.917;3544000;0
45614;7596;69;0;0;0;0;.00nan;0;0
45614;8367;70;0;0;0;0;.00nan;0;0
45624;7389;74;39;18;3;15;.833;3900000;0
45624;7901;79;0;0;0;0;.00nan;0;0
45624;7904;79;63;35;3;32;.914;3900000;0
45624;8442;74;0;0;0;0;.00nan;0;0
45597;6821;71;100;33;1;32;.970;3600000;0
45597;8130;71;0;0;0;0;.00nan;0;0
45597;8493;80;0;0;0;0;.00nan;0;0
45597;8685;80;53;23;3;20;.870;3514000;0
45630;6804;72;53;15;2;13;.867;3600000;0
45630;6837;73;69;56;6;50;.893;2931000;0
45630;6879;72;0;0;0;0;.00nan;0;0
45630;8429;73;51;14;2;12;.857;669000;0
45640;6813;83;0;0;0;0;.00nan;0;0
45640;6905;68;57;35;5;30;.857;3600000;0
45640;7325;83;64;21;2;19;.905;3600000;0
45640;7816;68;0;0;0;0;.00nan;0;0
45601;6821;71;46;26;4;22;.846;3600000;0
45601;8130;71;0;0;0;0;.00nan;0;0
45601;8133;76;100;32;0;32;1.000;3600000;0
45601;8420;76;0;0;0;0;.00nan;0;0
45612;6824;67;51;47;6;41;.872;2891000;0
45612;7269;67;53;10;1;9;.900;709000;0
45612;7840;66;81;18;1;17;.944;3600000;0
45612;7864;66;0;0;0;0;.00nan;0;0
45615;6837;73;71;36;3;33;.917;3900000;0
45615;7598;65;81;32;3;29;.906;3900000;0
45615;7911;65;0;0;0;0;.00nan;0;0
45615;8429;73;0;0;0;0;.00nan;0;0
45635;7901;79;69;43;5;38;.884;3585000;0
45635;7904;79;0;0;0;0;.00nan;0;0
45635;8476;63;43;22;4;18;.818;3600000;0
45635;9247;63;0;0;0;0;.00nan;0;0
45639;7385;84;89;43;3;40;.930;3600000;0
45639;7855;84;0;0;0;0;.00nan;0;0
45639;8113;77;38;32;6;26;.813;3600000;0
45639;8132;77;0;0;0;0;.00nan;0;0
45599;6813;83;42;9;2;7;.778;3600000;0
45599;7325;83;0;0;0;0;.00nan;0;0
45599;7409;70;0;0;0;0;.00nan;0;0
45599;8367;70;80;55;5;50;.909;3600000;0
45672;6939;69;60;28;3;25;.893;3600000;0
45672;7596;69;0;0;0;0;.00nan;0;0
45672;8133;76;56;36;4;32;.889;3570000;0
45672;8420;76;0;0;0;0;.00nan;0;0
45594;8493;80;57;26;3;23;.885;3600000;0
45594;8499;78;55;8;0;8;1.000;675000;0
45594;8685;80;0;0;0;0;.00nan;0;0
45594;8711;78;25;32;6;26;.813;2925000;0
45629;7389;74;36;14;3;11;.786;3600000;0
45629;7598;65;0;0;0;0;.00nan;0;0
45629;7911;65;60;43;6;37;.860;3600000;0
45629;8442;74;0;0;0;0;.00nan;0;0
45706;7840;66;0;0;0;0;.00nan;0;0
45706;7864;66;45;44;6;38;.864;3600000;0
45706;8476;63;59;30;3;27;.900;3600000;0
45706;9247;63;0;0;0;0;.00nan;0;0
45653;7271;82;73;10;0;10;1.000;3600000;0
45653;7302;82;0;0;0;0;.00nan;0;0
45653;7385;84;70;59;6;53;.898;2949000;0
45653;7855;84;57;19;2;17;.895;651000;0
45606;6804;72;80;29;3;26;.897;3523000;0
45606;6879;72;0;0;0;0;.00nan;0;0
45606;7908;64;86;26;1;25;.962;3600000;0
45606;8404;64;0;0;0;0;.00nan;0;0
45605;6813;83;0;0;0;0;.00nan;0;0
45605;6821;71;64;50;6;44;.880;3600000;0
45605;7325;83;62;19;1;18;.947;3600000;0
45605;8130;71;0;0;0;0;.00nan;0;0
45610;7237;75;59;14;1;13;.929;3600000;0
45610;7298;75;0;0;0;0;.00nan;0;0
45610;8113;77;79;35;1;34;.971;1609000;0
45610;8132;77;22;36;7;29;.806;1991000;0
45643;6905;68;0;0;0;0;.00nan;0;0
45643;7816;68;48;11;2;9;.818;3600000;0
45643;8113;77;21;18;5;13;.722;1041000;0
45643;8132;77;44;43;7;36;.837;2559000;0
45603;7908;64;0;0;0;0;.00nan;0;0
45603;8133;76;0;0;0;0;.00nan;0;0
45603;8404;64;57;20;2;18;.900;3600000;0
45603;8420;76;82;54;4;50;.926;3600000;0
45667;7271;82;68;26;2;24;.923;3600000;0
45667;7302;82;0;0;0;0;.00nan;0;0
45667;8476;63;0;0;0;0;.00nan;0;0
45667;9247;63;71;41;4;37;.902;3600000;0
45680;6939;69;89;17;0;17;1.000;3600000;0
45680;7385;84;0;0;0;0;.00nan;0;0
45680;7596;69;0;0;0;0;.00nan;0;0
45680;7855;84;97;54;1;53;.981;3592000;0
45598;7237;75;0;0;0;0;.00nan;0;0
45598;7298;75;50;47;7;40;.851;3543000;0
45598;8499;78;0;0;0;0;.00nan;0;0
45598;8711;78;37;34;6;28;.824;3600000;0
45631;6837;73;77;30;2;28;.933;3600000;0
45631;7389;74;0;0;0;0;.00nan;0;0
45631;8429;73;0;0;0;0;.00nan;0;0
45631;8442;74;61;38;4;34;.895;3540000;0
45632;6824;67;52;39;6;33;.846;2708000;0
45632;7269;67;31;14;4;10;.714;892000;0
45632;7598;65;27;13;4;9;.692;3600000;0
45632;7911;65;0;0;0;0;.00nan;0;0
45642;6804;72;0;0;0;0;.00nan;0;0
45642;6879;72;64;16;1;15;.938;3600000;0
45642;7901;79;0;0;0;0;.00nan;0;0
45642;7904;79;44;42;6;36;.857;3600000;0
45617;6905;68;76;32;2;30;.938;3600000;0
45617;7409;70;31;31;6;25;.806;3600000;0
45617;7816;68;0;0;0;0;.00nan;0;0
45617;8367;70;0;0;0;0;.00nan;0;0
45868;8113;77;76;53;5;48;.906;3600000;0
45868;8132;77;0;0;0;0;.00nan;0;0
45868;8476;63;0;0;0;0;.00nan;0;0
45868;9247;63;63;18;2;16;.889;3600000;0
45671;7271;82;58;34;4;30;.882;3900000;0
45671;7302;82;0;0;0;0;.00nan;0;0
45671;8493;80;0;0;0;0;.00nan;0;0
45671;8685;80;67;40;4;36;.900;3900000;0
45656;6813;83;46;12;2;10;.833;3600000;0
45656;7325;83;0;0;0;0;.00nan;0;0
45656;8113;77;0;0;0;0;.00nan;0;0
45656;8132;77;55;85;11;74;.871;3600000;0
45647;7271;82;71;38;4;34;.895;3797000;0
45647;7302;82;0;0;0;0;.00nan;0;0
45647;7908;64;46;29;5;24;.828;3805000;0
45647;8404;64;0;0;0;0;.00nan;0;0
45628;7596;79;50;36;5;31;.861;3581000;0
45628;7904;79;0;0;0;0;.00nan;0;0
45628;8499;78;0;0;0;0;.00nan;0;0
45628;8711;78;45;19;3;16;.842;3600000;0
45674;7598;65;50;3;0;3;1.000;386000;0
45674;7840;66;68;30;2;28;.933;3600000;0
45674;7864;66;0;0;0;0;.00nan;0;0
45674;7911;65;42;35;6;29;.829;3214000;0
45613;6821;71;0;0;0;0;.00nan;0;0
45613;7899;81;0;0;0;0;.00nan;0;0
45613;8130;71;85;32;1;31;.969;3600000;0
45613;8450;81;78;29;2;27;.931;3600000;0
45634;6939;69;80;40;3;37;.925;3794000;0
45634;7327;69;0;0;0;0;.00nan;0;0
45634;7409;70;69;30;2;28;.933;3794000;0
45634;8367;70;0;0;0;0;.00nan;0;0
45702;6813;83;0;0;0;0;.00nan;0;0
45702;7237;75;0;0;0;0;.00nan;0;0
45702;7298;75;73;54;5;49;.907;3713000;0
45702;7325;83;47;31;4;27;.871;3759000;0
45705;6837;73;78;25;2;23;.920;3561000;0
45705;7385;84;100;52;1;51;.981;3600000;0
45705;7855;84;0;0;0;0;.00nan;0;0
45705;8429;73;0;0;0;0;.00nan;0;0
45730;6824;67;66;49;6;43;.878;3011000;0
45730;7269;67;66;21;1;20;.952;589000;0
45730;8493;80;73;6;0;6;1.000;3600000;0
45730;8685;80;0;0;0;0;.00nan;0;0
45648;7596;79;0;0;0;0;.00nan;0;0
45648;7904;79;70;39;5;34;.872;3600000;0
45648;8499;78;81;28;1;27;.964;3600000;0
45648;8711;78;0;0;0;0;.00nan;0;0
45651;6821;71;57;34;5;29;.853;3600000;0
45651;6939;69;90;40;1;39;.975;3600000;0
45651;7327;69;0;0;0;0;.00nan;0;0
45651;8130;71;0;0;0;0;.00nan;0;0
45663;7389;74;8;15;6;9;.600;1853000;0
45663;7840;66;24;5;3;2;.400;330000;0
45663;7864;66;37;37;7;30;.811;3270000;0
45663;8442;74;59;6;0;6;1.000;1747000;0
45627;7409;70;0;0;0;0;.00nan;0;0
45627;8133;76;68;30;2;28;.933;3900000;0
45627;8367;70;65;29;2;27;.931;3900000;0
45627;8420;76;0;0;0;0;.00nan;0;0
45626;7908;64;0;0;0;0;.00nan;0;0
45626;8404;64;74;34;2;32;.941;3600000;0
45626;8476;63;0;0;0;0;.00nan;0;0
45626;9247;63;67;30;3;27;.900;3558000;0
45644;6905;68;0;0;0;0;.00nan;0;0
45644;7598;65;88;59;4;55;.932;3600000;0
45644;7816;68;46;17;3;14;.824;3600000;0
45644;7911;65;0;0;0;0;.00nan;0;0
45724;6804;72;58;12;1;11;.917;3600000;0
45724;6837;73;89;62;4;58;.935;3600000;0
45724;6879;72;0;0;0;0;.00nan;0;0
45724;8429;73;0;0;0;0;.00nan;0;0
45717;6905;68;69;10;1;9;.900;3600000;0
45717;7389;74;86;39;2;37;.949;3563000;0
45717;7816;68;0;0;0;0;.00nan;0;0
45717;8442;74;0;0;0;0;.00nan;0;0
45619;7237;75;57;33;4;29;.879;3134000;0
45619;7298;75;26;6;3;3;.500;466000;0
45619;7899;81;0;0;0;0;.00nan;0;0
45619;8450;81;83;37;2;35;.946;3600000;0
45679;7271;82;72;24;1;23;.958;3600000;0
45679;7302;82;0;0;0;0;.00nan;0;0
45679;8493;80;53;28;3;25;.893;3600000;0
45679;8685;80;0;0;0;0;.00nan;0;0
45732;6824;67;52;54;8;46;.852;3600000;0
45732;7269;67;0;0;0;0;.00nan;0;0
45732;8133;76;0;0;0;0;.00nan;0;0
45732;8420;76;67;5;0;5;1.000;3600000;0
45616;6821;71;100;43;0;43;1.000;3600000;0
45616;7899;81;61;24;2;22;.917;3574000;0
45616;8130;71;0;0;0;0;.00nan;0;0
45616;8450;81;0;0;0;0;.00nan;0;0
45670;7271;82;44;9;2;7;.778;3600000;0
45670;7302;82;0;0;0;0;.00nan;0;0
45670;7596;79;35;32;6;26;.813;1717000;0
45670;7904;79;73;31;3;28;.903;1883000;0
45716;6813;83;0;0;0;0;.00nan;0;0
45716;7325;83;50;13;2;11;.846;3600000;0
45716;7385;84;44;24;4;20;.833;1117000;0
45716;7855;84;63;58;7;51;.879;2483000;0
45782;8113;77;80;41;3;38;.927;3555000;0
45782;8132;77;0;0;0;0;.00nan;0;0
45782;8133;76;69;21;2;19;.905;3600000;0
45782;8420;76;0;0;0;0;.00nan;0;0
45618;7385;84;64;53;7;46;.868;3600000;0
45618;7855;84;0;0;0;0;.00nan;0;0
45618;8499;78;0;0;0;0;.00nan;0;0
45618;8711;78;46;10;2;8;.800;3600000;0
45712;6837;73;59;33;4;29;.879;3600000;0
45712;8429;73;0;0;0;0;.00nan;0;0
45712;8493;80;0;0;0;0;.00nan;0;0
45712;8685;80;40;34;5;29;.853;3600000;0
45638;6804;72;53;15;2;13;.867;3600000;0
45638;6879;72;0;0;0;0;.00nan;0;0
45638;7409;70;57;34;4;30;.882;3563000;0
45638;8367;70;0;0;0;0;.00nan;0;0
45665;7598;65;43;34;5;29;.853;3546000;0
45665;7840;66;46;21;3;18;.857;3600000;0
45665;7864;66;0;0;0;0;.00nan;0;0
45665;7911;65;0;0;0;0;.00nan;0;0
45636;6824;67;89;90;6;84;.933;2972000;0
45636;7269;67;52;3;0;3;1.000;628000;0
45636;7908;64;0;0;0;0;.00nan;0;0
45636;8404;64;44;6;1;5;.833;3600000;0
45746;6804;72;71;7;0;7;1.000;3600000;0
45746;6879;72;0;0;0;0;.00nan;0;0
45746;7389;74;62;50;6;44;.880;3600000;0
45746;8442;74;0;0;0;0;.00nan;0;0
45659;6905;68;0;0;0;0;.00nan;0;0
45659;6939;69;51;40;6;34;.850;3600000;0
45659;7327;69;0;0;0;0;.00nan;0;0
45659;7816;68;88;19;0;19;1.000;3600000;0
45719;7237;75;56;15;2;13;.867;3600000;0
45719;7298;75;0;0;0;0;.00nan;0;0
45719;8113;77;46;26;4;22;.846;1573000;0
45719;8132;77;36;38;6;32;.842;2027000;0
45676;6804;72;36;11;4;7;.636;3900000;0
45676;6879;72;0;0;0;0;.00nan;0;0
45676;7598;65;0;0;0;0;.00nan;0;0
45676;7911;65;80;74;4;70;.946;3900000;0
45662;6821;71;74;55;6;49;.891;3600000;0
45662;7271;82;48;18;3;15;.833;3600000;0
45662;7302;82;0;0;0;0;.00nan;0;0
45662;8130;71;0;0;0;0;.00nan;0;0
45727;7237;75;0;0;0;0;.00nan;0;0
45727;7298;75;72;45;4;41;.911;3543000;0
45727;8476;63;47;24;3;21;.875;3600000;0
45727;9247;63;0;0;0;0;.00nan;0;0
45658;8133;76;64;17;1;16;.941;1411000;0
45658;8420;76;29;28;6;22;.786;2189000;0
45658;8499;78;0;0;0;0;.00nan;0;0
45658;8711;78;28;12;4;8;.667;3600000;0
45649;7908;64;0;0;0;0;.00nan;0;0
45649;8404;64;90;29;1;28;.966;3600000;0
45649;8493;80;0;0;0;0;.00nan;0;0
45649;8685;80;41;38;6;32;.842;3600000;0
45673;7596;79;84;20;0;20;1.000;3600000;0
45673;7904;79;0;0;0;0;.00nan;0;0
45673;8113;77;26;29;6;23;.793;2950000;0
45673;8132;77;57;10;1;9;.900;650000;0
45681;7271;82;54;8;1;7;.875;3600000;0
45681;7302;82;0;0;0;0;.00nan;0;0
45681;7840;66;74;51;5;46;.902;3600000;0
45681;8726;66;0;0;0;0;.00nan;0;0
45650;6813;83;0;0;0;0;.00nan;0;0
45650;7325;83;53;15;2;13;.867;3600000;0
45650;7899;81;61;47;5;42;.894;2915000;0
45650;8450;81;29;17;4;13;.765;685000;0
45645;6939;69;60;54;6;48;.889;3600000;0
45645;7327;69;0;0;0;0;.00nan;0;0
45645;7409;70;39;26;5;21;.808;3600000;0
45645;8367;70;0;0;0;0;.00nan;0;0
45734;6837;73;56;52;7;45;.865;3600000;0
45734;8429;73;0;0;0;0;.00nan;0;0
45734;8493;80;68;33;3;30;.909;3600000;0
45734;8685;80;0;0;0;0;.00nan;0;0
45736;7385;84;0;0;0;0;.00nan;0;0
45736;7389;74;56;10;1;9;.900;3600000;0
45736;7855;84;89;80;6;74;.925;3600000;0
45736;8442;74;0;0;0;0;.00nan;0;0
45701;6804;72;55;10;1;9;.900;3600000;0
45701;6879;72;0;0;0;0;.00nan;0;0
45701;7598;65;87;71;4;67;.944;3600000;0
45701;7911;65;0;0;0;0;.00nan;0;0
45660;7596;79;43;26;4;22;.846;3577000;0
45660;7904;79;0;0;0;0;.00nan;0;0
45660;8499;78;62;33;3;30;.909;3600000;0
45660;8711;78;0;0;0;0;.00nan;0;0
45652;7389;74;44;5;1;4;.800;1222000;0
45652;7409;70;75;28;1;27;.964;3600000;0
45652;8367;70;0;0;0;0;.00nan;0;0
45652;8442;74;24;35;6;29;.829;2378000;0
45886;6905;68;0;0;0;0;.00nan;0;0
45886;7385;84;37;34;6;28;.824;2197000;0
45886;7816;68;49;16;2;14;.875;3600000;0
45886;7855;84;54;19;2;17;.895;1403000;0
45678;7840;66;74;30;2;28;.933;3600000;0
45678;8133;76;0;0;0;0;.00nan;0;0
45678;8420;76;65;33;3;30;.909;3590000;0
45678;8726;66;0;0;0;0;.00nan;0;0
45739;6813;83;83;12;0;12;1.000;3600000;0
45739;7325;83;0;0;0;0;.00nan;0;0
45739;8493;80;61;22;2;20;.909;925000;0
45739;8685;80;45;44;6;38;.864;2675000;0
45621;6821;71;76;36;3;33;.917;3600000;0
45621;7899;81;0;0;0;0;.00nan;0;0
45621;8130;71;0;0;0;0;.00nan;0;0
45621;8450;81;49;34;5;29;.853;3573000;0
45661;6939;69;43;48;6;42;.875;3189000;0
45661;7327;69;50;6;1;5;.833;411000;0
45661;7908;64;0;0;0;0;.00nan;0;0
45661;8404;64;64;15;1;14;.933;3600000;0
45767;6837;73;82;31;2;29;.935;3600000;0
45767;8113;77;46;27;4;23;.852;3600000;0
45767;8132;77;0;0;0;0;.00nan;0;0
45767;8429;73;0;0;0;0;.00nan;0;0
45707;6824;67;77;38;3;35;.921;3600000;0
45707;7269;67;0;0;0;0;.00nan;0;0
45707;7598;65;39;1;1;0;.000;520000;0
45707;7911;65;36;35;6;29;.829;3080000;0
45669;7908;64;53;11;1;10;.909;3600000;0
45669;8113;77;61;22;2;20;.909;1799000;0
45669;8132;77;33;32;6;26;.813;1801000;0
45669;8404;64;0;0;0;0;.00nan;0;0
45977;7385;84;80;51;4;47;.922;3600000;0
45977;7855;84;0;0;0;0;.00nan;0;0
45977;8493;80;89;18;0;18;1.000;3600000;0
45977;8685;80;0;0;0;0;.00nan;0;0
45763;6905;68;23;22;6;16;.727;3558000;0
45763;7389;74;38;26;5;21;.808;3600000;0
45763;7816;68;0;0;0;0;.00nan;0;0
45763;8442;74;0;0;0;0;.00nan;0;0
45743;6837;73;59;57;7;50;.877;3600000;0
45743;7237;75;0;0;0;0;.00nan;0;0
45743;7298;75;64;21;2;19;.905;3600000;0
45743;8429;73;0;0;0;0;.00nan;0;0
45684;6821;71;0;0;0;0;.00nan;0;0
45684;7271;82;62;11;1;10;.909;3600000;0
45684;7302;82;0;0;0;0;.00nan;0;0
45684;8130;71;89;59;3;56;.949;3564000;0
45654;6824;67;54;49;6;43;.878;2098000;0
45654;7269;67;54;32;4;28;.875;1502000;0
45654;7409;70;59;14;1;13;.929;3600000;0
45654;8367;70;0;0;0;0;.00nan;0;0
45657;7899;81;67;36;4;32;.889;3900000;0
45657;8450;81;0;0;0;0;.00nan;0;0
45657;8499;78;0;0;0;0;.00nan;0;0
45657;8711;78;74;43;4;39;.907;3900000;0
45683;7596;79;28;26;6;20;.769;3588000;0
45683;7904;79;0;0;0;0;.00nan;0;0
45683;8133;76;77;41;4;37;.902;3600000;0
45683;8420;76;0;0;0;0;.00nan;0;0
45664;6804;72;60;11;1;10;.909;3600000;0
45664;6879;72;0;0;0;0;.00nan;0;0
45664;6939;69;78;60;6;54;.900;3194000;0
45664;7327;69;48;9;1;8;.889;406000;0
45911;6905;68;0;0;0;0;.00nan;0;0
45911;7237;75;81;39;3;36;.923;3600000;0
45911;7298;75;0;0;0;0;.00nan;0;0
45911;7816;68;47;26;4;22;.846;3546000;0
45687;6824;67;88;68;4;64;.941;3600000;0
45687;7269;67;0;0;0;0;.00nan;0;0
45687;7840;66;0;0;0;0;.00nan;0;0
45687;8726;66;62;12;1;11;.917;3600000;0
45790;6813;83;24;18;5;13;.722;3600000;0
45790;7325;83;0;0;0;0;.00nan;0;0
45790;7385;84;65;39;4;35;.897;2292000;0
45790;7855;84;65;31;3;28;.903;1291000;0
45688;6821;71;80;40;3;37;.925;3571000;0
45688;8130;71;0;0;0;0;.00nan;0;0
45688;8493;80;66;25;1;24;.960;3600000;0
45688;8685;80;0;0;0;0;.00nan;0;0
45718;6905;68;55;3;0;3;1.000;197000;0
45718;7598;65;27;6;3;3;.500;400000;0
45718;7816;68;77;21;1;20;.952;3403000;0
45718;7911;65;71;35;3;32;.914;3200000;0
45742;6804;72;0;0;0;0;.00nan;0;0
45742;6879;72;64;16;1;15;.938;3600000;0
45742;6939;69;94;62;3;59;.952;3567000;0
45742;7327;69;0;0;0;0;.00nan;0;0
45733;7385;84;92;53;3;50;.943;3600000;0
45733;7855;84;0;0;0;0;.00nan;0;0
45733;8133;76;0;0;0;0;.00nan;0;0
45733;8420;76;30;26;5;21;.808;3512000;0
45682;8113;77;58;51;6;45;.882;2489000;0
45682;8132;77;35;21;4;17;.810;1111000;0
45682;8499;78;0;0;0;0;.00nan;0;0
45682;8711;78;70;21;1;20;.952;3600000;0
45741;7237;75;70;13;0;13;1.000;1841000;0
45741;7298;75;27;19;5;14;.737;1892000;0
45741;7908;64;0;0;0;0;.00nan;0;0
45741;8404;64;68;45;6;39;.867;3733000;0
45686;6813;83;0;0;0;0;.00nan;0;0
45686;7271;82;89;35;1;34;.971;3573000;0
45686;7302;82;0;0;0;0;.00nan;0;0
45686;7325;83;99;23;0;23;1.000;3600000;0
45690;8113;77;0;0;0;0;.00nan;0;0
45690;8132;77;75;54;5;49;.907;3600000;0
45690;8499;78;48;8;1;7;.875;3600000;0
45690;8711;78;0;0;0;0;.00nan;0;0
45725;6824;67;82;60;6;54;.900;2799000;0
45725;6939;69;64;12;1;11;.917;3600000;0
45725;7269;67;40;15;3;12;.800;801000;0
45725;7327;69;0;0;0;0;.00nan;0;0
45821;6837;73;48;24;4;20;.833;3596000;0
45821;7389;74;60;31;3;28;.903;3600000;0
45821;8429;73;0;0;0;0;.00nan;0;0
45821;8442;74;0;0;0;0;.00nan;0;0
45740;7237;75;0;0;0;0;.00nan;0;0
45740;7298;75;46;17;3;14;.824;3600000;0
45740;7598;65;41;37;6;31;.838;1852000;0
45740;7911;65;71;26;1;25;.962;1748000;0
45666;7409;70;13;20;6;14;.700;3600000;0
45666;8367;70;0;0;0;0;.00nan;0;0
45666;8476;63;0;0;0;0;.00nan;0;0
45666;9247;63;59;23;2;21;.913;3600000;0
45693;6804;72;56;16;2;14;.875;3600000;0
45693;6879;72;0;0;0;0;.00nan;0;0
45693;7840;66;45;46;7;39;.848;3153000;0
45693;8726;66;26;14;4;10;.714;447000;0
45715;7899;81;0;0;0;0;.00nan;0;0
45715;8450;81;60;18;1;17;.944;3600000;0
45715;8493;80;0;0;0;0;.00nan;0;0
45715;8685;80;83;46;3;43;.935;3600000;0
45699;6821;71;98;44;1;43;.977;3600000;0
45699;7596;79;44;14;3;11;.786;3566000;0
45699;7904;79;0;0;0;0;.00nan;0;0
45699;8130;71;0;0;0;0;.00nan;0;0
45921;7389;74;0;0;0;0;.00nan;0;0
45921;7816;68;76;24;1;23;.958;3600000;0
45921;7895;68;0;0;0;0;.00nan;0;0
45921;8442;74;53;31;3;28;.903;3590000;0
45714;7596;79;0;0;0;0;.00nan;0;0
45714;7904;79;60;19;2;17;.895;3600000;0
45714;8133;76;97;52;3;49;.942;3585000;0
45714;8420;76;0;0;0;0;.00nan;0;0
45793;7908;64;0;0;0;0;.00nan;0;0
45793;8404;64;50;27;3;24;.889;3600000;0
45793;8476;63;0;0;0;0;.00nan;0;0
45793;9247;63;47;29;4;25;.862;3600000;0
45692;7840;66;0;0;0;0;.00nan;0;0
45692;8113;77;86;25;0;25;1.000;1919000;0
45692;8132;77;27;23;6;17;.739;1681000;0
45692;8726;66;56;23;3;20;.870;3600000;0
45696;6804;72;85;23;0;23;1.000;3900000;0
45696;6879;72;0;0;0;0;.00nan;0;0
45696;7409;70;100;46;0;46;1.000;3900000;0
45696;8367;70;0;0;0;0;.00nan;0;0
45685;6813;83;0;0;0;0;.00nan;0;0
45685;7325;83;57;18;2;16;.889;3600000;0
45685;7899;81;49;38;6;32;.842;3200000;0
45685;8450;81;31;11;3;8;.727;400000;0
45774;6837;73;94;65;4;61;.938;3882000;0
45774;7237;75;37;12;3;9;.750;3882000;0
45774;7298;75;0;0;0;0;.00nan;0;0
45774;8429;73;0;0;0;0;.00nan;0;0
45735;8133;76;0;0;0;0;.00nan;0;0
45735;8420;76;57;34;4;30;.882;3541000;0
45735;8493;80;61;26;2;24;.923;3600000;0
45735;8685;80;0;0;0;0;.00nan;0;0
45775;6837;73;37;31;6;25;.806;1791000;0
45775;8429;73;40;30;4;26;.867;1809000;0
45775;8476;63;38;9;2;7;.778;3600000;0
45775;9247;63;0;0;0;0;.00nan;0;0
45710;7389;74;11;18;6;12;.667;1618000;0
45710;7409;70;38;12;3;9;.750;3600000;0
45710;8367;70;0;0;0;0;.00nan;0;0
45710;8442;74;38;27;4;23;.852;1982000;0
45700;6824;67;58;40;5;35;.875;3600000;0
45700;6939;69;63;17;1;16;.941;3600000;0
45700;7269;67;0;0;0;0;.00nan;0;0
45700;7327;69;0;0;0;0;.00nan;0;0
45709;7596;79;46;30;5;25;.833;3900000;0
45709;7904;79;0;0;0;0;.00nan;0;0
45709;8499;78;0;0;0;0;.00nan;0;0
45709;8711;78;64;48;5;43;.896;3900000;0
45694;6821;71;55;32;4;28;.875;3548000;0
45694;7271;82;57;18;2;16;.889;3600000;0
45694;7302;82;0;0;0;0;.00nan;0;0
45694;8130;71;0;0;0;0;.00nan;0;0
45689;6813;83;64;24;3;21;.875;3600000;0
45689;7325;83;0;0;0;0;.00nan;0;0
45689;7908;64;60;44;5;39;.886;3578000;0
45689;8404;64;0;0;0;0;.00nan;0;0
45691;7598;65;0;0;0;0;.00nan;0;0
45691;7840;66;47;34;6;28;.824;3600000;0
45691;7911;65;71;35;4;31;.886;3600000;0
45691;8726;66;0;0;0;0;.00nan;0;0
45923;6824;67;33;19;4;15;.789;945000;0
45923;7269;67;91;55;4;51;.927;2655000;0
45923;7816;68;67;10;1;9;.900;3600000;0
45923;7895;68;0;0;0;0;.00nan;0;0
45737;7271;82;69;21;2;19;.905;3600000;0
45737;7302;82;0;0;0;0;.00nan;0;0
45737;7899;81;69;32;2;30;.938;2539000;0
45737;8450;81;28;15;4;11;.733;1061000;0
45698;6824;67;100;51;1;50;.980;3900000;0
45698;7269;67;0;0;0;0;.00nan;0;0
45698;7840;66;60;15;1;14;.933;3900000;0
45698;8726;66;0;0;0;0;.00nan;0;0
45778;6939;69;79;38;3;35;.921;3546000;0
45778;7327;69;0;0;0;0;.00nan;0;0
45778;8493;80;0;0;0;0;.00nan;0;0
45778;8685;80;74;27;2;25;.926;3600000;0
45728;7237;75;0;0;0;0;.00nan;0;0
45728;7298;75;77;39;3;36;.923;3600000;0
45728;7596;79;59;53;7;46;.868;3600000;0
45728;7904;79;0;0;0;0;.00nan;0;0
45799;8133;76;0;0;0;0;.00nan;0;0
45799;8420;76;67;62;6;56;.903;3600000;0
45799;8499;78;0;0;0;0;.00nan;0;0
45799;8711;78;99;40;1;39;.975;3600000;0
45808;6905;68;62;39;5;34;.872;3563000;0
45808;7409;70;77;37;3;34;.919;3600000;0
45808;7816;68;0;0;0;0;.00nan;0;0
45808;8367;70;0;0;0;0;.00nan;0;0
45755;6804;72;73;20;1;19;.950;3600000;0
45755;6879;72;0;0;0;0;.00nan;0;0
45755;6939;69;67;66;8;58;.879;3155000;0
45755;7327;69;55;4;0;4;1.000;445000;0
45751;6824;67;45;54;8;46;.852;2629000;0
45751;7269;67;27;24;5;19;.792;971000;0
45751;8499;78;43;2;1;1;.500;3600000;0
45751;8711;78;0;0;0;0;.00nan;0;0
45920;7385;84;94;60;4;56;.933;3600000;0
45920;7855;84;0;0;0;0;.00nan;0;0
45920;8133;76;50;20;3;17;.850;3600000;0
45920;8420;76;0;0;0;0;.00nan;0;0
45750;8476;63;0;0;0;0;.00nan;0;0
45750;8493;80;46;31;5;26;.839;3566000;0
45750;8685;80;0;0;0;0;.00nan;0;0
45750;9247;63;63;39;4;35;.897;3600000;0
45747;6837;73;93;70;6;64;.914;3600000;0
45747;7596;79;0;0;0;0;.00nan;0;0
45747;7904;79;60;13;1;12;.923;3600000;0
45747;8429;73;0;0;0;0;.00nan;0;0
45703;7840;66;0;0;0;0;.00nan;0;0
45703;7908;64;0;0;0;0;.00nan;0;0
45703;8404;64;58;16;1;15;.938;3600000;0
45703;8726;66;79;56;5;51;.911;3600000;0
45697;6813;83;0;0;0;0;.00nan;0;0
45697;7271;82;47;33;5;28;.848;3600000;0
45697;7302;82;0;0;0;0;.00nan;0;0
45697;7325;83;68;26;2;24;.923;3600000;0
45723;6821;71;61;18;2;16;.889;3600000;0
45723;7598;65;59;31;3;28;.903;2428000;0
45723;7911;65;36;19;4;15;.789;1172000;0
45723;8130;71;0;0;0;0;.00nan;0;0
45713;7899;81;0;0;0;0;.00nan;0;0
45713;8113;77;35;33;6;27;.818;1560000;0
45713;8132;77;49;25;3;22;.880;2040000;0
45713;8450;81;60;14;1;13;.929;3600000;0
45720;6804;72;42;14;3;11;.786;3600000;0
45720;6879;72;0;0;0;0;.00nan;0;0
45720;7840;66;52;55;8;47;.855;3600000;0
45720;8726;66;0;0;0;0;.00nan;0;0
45766;6824;67;85;38;3;35;.921;3573000;0
45766;7269;67;0;0;0;0;.00nan;0;0
45766;7598;65;0;0;0;0;.00nan;0;0
45766;7911;65;69;15;1;14;.933;3600000;0
45738;6813;83;0;0;0;0;.00nan;0;0
45738;7325;83;83;25;1;24;.960;3600000;0
45738;7899;81;61;5;0;5;1.000;478000;0
45738;8450;81;74;50;6;44;.880;3122000;0
45783;6837;73;87;44;3;41;.932;3609000;0
45783;6939;69;68;33;4;29;.879;3609000;0
45783;7327;69;0;0;0;0;.00nan;0;0
45783;8429;73;0;0;0;0;.00nan;0;0
45731;6821;71;74;40;4;36;.900;3554000;0
45731;8130;71;0;0;0;0;.00nan;0;0
45731;8476;63;0;0;0;0;.00nan;0;0
45731;9247;63;53;24;3;21;.875;3600000;0
45787;7237;75;0;0;0;0;.00nan;0;0
45787;7298;75;73;10;0;10;1.000;3600000;0
45787;7389;74;56;43;6;37;.860;3115000;0
45787;8442;74;49;2;0;2;1.000;485000;0
45941;7908;64;52;2;0;2;1.000;271000;0
45941;8404;64;32;35;6;29;.829;3329000;0
45941;8493;80;0;0;0;0;.00nan;0;0
45941;8685;80;74;32;2;30;.938;3600000;0
45752;8133;76;93;50;2;48;.960;3631000;0
45752;8420;76;0;0;0;0;.00nan;0;0
45752;8499;78;0;0;0;0;.00nan;0;0
45752;8711;78;64;15;1;14;.933;3631000;0
45883;7385;84;26;26;6;20;.769;1841000;0
45883;7855;84;68;11;0;11;1.000;1722000;0
45883;8113;77;0;0;0;0;.00nan;0;0
45883;8132;77;68;48;5;43;.896;3600000;0
45711;6821;71;0;0;0;0;.00nan;0;0
45711;8113;77;0;0;0;0;.00nan;0;0
45711;8130;71;59;20;2;18;.900;3600000;0
45711;8132;77;42;52;7;45;.865;3600000;0
45825;7389;74;0;0;0;0;.00nan;0;0
45825;8442;74;86;44;3;41;.932;3579000;0
45825;8476;63;81;30;1;29;.967;3600000;0
45825;9247;63;0;0;0;0;.00nan;0;0
45749;6905;68;79;35;2;33;.943;3900000;0
45749;7596;79;75;26;2;24;.923;3900000;0
45749;7816;68;0;0;0;0;.00nan;0;0
45749;7904;79;0;0;0;0;.00nan;0;0
45757;6804;72;64;33;3;30;.909;3776000;0
45757;6879;72;0;0;0;0;.00nan;0;0
45757;7237;75;0;0;0;0;.00nan;0;0
45757;7298;75;84;49;4;45;.918;3775000;0
45760;7271;82;66;19;2;17;.895;3600000;0
45760;7302;82;0;0;0;0;.00nan;0;0
45760;7899;81;61;41;5;36;.878;3600000;0
45760;8450;81;0;0;0;0;.00nan;0;0
45878;6837;73;77;46;5;41;.891;3600000;0
45878;7908;64;80;26;1;25;.962;3600000;0
45878;8404;64;0;0;0;0;.00nan;0;0
45878;8429;73;0;0;0;0;.00nan;0;0
45769;6813;83;74;29;2;27;.931;3600000;0
45769;7325;83;0;0;0;0;.00nan;0;0
45769;7409;70;44;25;4;21;.840;1586000;0
45769;8367;70;39;32;6;26;.813;2014000;0
45756;6905;68;0;0;0;0;.00nan;0;0
45756;7271;82;96;25;0;25;1.000;3600000;0
45756;7302;82;0;0;0;0;.00nan;0;0
45756;7816;68;86;62;6;56;.903;3600000;0
45789;7409;70;63;10;1;9;.900;3600000;0
45789;7598;65;0;0;0;0;.00nan;0;0
45789;7911;65;82;46;3;43;.935;3565000;0
45789;8367;70;0;0;0;0;.00nan;0;0
45845;7908;64;0;0;0;0;.00nan;0;0
45845;8404;64;100;30;0;30;1.000;3600000;0
45845;8476;63;0;0;0;0;.00nan;0;0
45845;9247;63;33;26;5;21;.808;3600000;0
45780;7271;82;76;19;1;18;.947;3600000;0
45780;7302;82;0;0;0;0;.00nan;0;0
45780;7899;81;0;0;0;0;.00nan;0;0
45780;8450;81;71;39;3;36;.923;3515000;0
45753;7596;79;57;13;1;12;.923;3600000;0
45753;7598;65;52;61;8;53;.869;3600000;0
45753;7904;79;0;0;0;0;.00nan;0;0
45753;7911;65;0;0;0;0;.00nan;0;0
45771;6813;83;0;0;0;0;.00nan;0;0
45771;7325;83;36;16;3;13;.813;3600000;0
45771;8133;76;0;0;0;0;.00nan;0;0
45771;8420;76;88;59;4;55;.932;3600000;0
45754;6821;71;67;6;0;6;1.000;3600000;0
45754;6824;67;11;19;6;13;.684;1091000;0
45754;7269;67;86;41;2;39;.951;2509000;0
45754;8130;71;0;0;0;0;.00nan;0;0
45773;6804;72;51;14;2;12;.857;3600000;0
45773;6879;72;0;0;0;0;.00nan;0;0
45773;7385;84;50;43;6;37;.860;3600000;0
45773;7855;84;0;0;0;0;.00nan;0;0
45815;6905;68;82;41;3;38;.927;3865000;0
45815;7816;68;0;0;0;0;.00nan;0;0
45815;8493;80;0;0;0;0;.00nan;0;0
45815;8685;80;39;17;4;13;.765;3865000;0
45840;6905;68;0;0;0;0;.00nan;0;0
45840;7816;68;53;17;2;15;.882;3600000;0
45840;8499;78;56;27;3;24;.889;2851000;0
45840;8711;78;33;21;4;17;.810;749000;0
45721;7840;66;38;41;6;35;.854;3544000;0
45721;8493;80;46;21;4;17;.810;3600000;0
45721;8685;80;0;0;0;0;.00nan;0;0
45721;8726;66;0;0;0;0;.00nan;0;0
45758;7596;79;0;0;0;0;.00nan;0;0
45758;7904;79;51;21;3;18;.857;3600000;0
45758;8133;76;54;43;5;38;.884;3600000;0
45758;8420;76;0;0;0;0;.00nan;0;0
45748;6821;71;58;19;2;17;.895;3600000;0
45748;8113;77;52;4;0;4;1.000;483000;0
45748;8130;71;0;0;0;0;.00nan;0;0
45748;8132;77;34;37;6;31;.838;3117000;0
45726;6813;83;0;0;0;0;.00nan;0;0
45726;7325;83;68;22;2;20;.909;3600000;0
45726;7899;81;55;44;5;39;.886;3600000;0
45726;8450;81;0;0;0;0;.00nan;0;0
45784;6804;72;88;28;2;26;.929;3600000;0
45784;6879;72;0;0;0;0;.00nan;0;0
45784;7237;75;72;41;4;37;.902;3552000;0
45784;7298;75;0;0;0;0;.00nan;0;0
45794;6939;69;61;49;6;43;.878;3322000;0
45794;7327;69;42;3;1;2;.667;251000;0
45794;7409;70;0;0;0;0;.00nan;0;0
45794;8367;70;43;28;5;23;.821;3600000;0
45858;7385;84;100;23;0;23;1.000;3600000;0
45858;7598;65;0;0;0;0;.00nan;0;0
45858;7855;84;0;0;0;0;.00nan;0;0
45858;7911;65;80;32;3;29;.906;3600000;0
45777;6824;67;18;22;6;16;.727;2394000;0
45777;7269;67;67;13;0;13;1.000;1206000;0
45777;8113;77;85;36;2;34;.944;3600000;0
45777;8132;77;0;0;0;0;.00nan;0;0
45913;7237;75;0;0;0;0;.00nan;0;0
45913;7271;82;95;37;2;35;.946;3600000;0
45913;7298;75;33;32;6;26;.813;3600000;0
45913;7302;82;0;0;0;0;.00nan;0;0
45764;7596;79;66;22;2;20;.909;3600000;0
45764;7904;79;0;0;0;0;.00nan;0;0
45764;8133;76;65;12;0;12;1.000;1408000;0
45764;8420;76;27;25;6;19;.760;2192000;0
45785;6824;67;83;47;4;43;.915;3562000;0
45785;7269;67;0;0;0;0;.00nan;0;0
45785;7598;65;58;14;2;12;.857;3600000;0
45785;7911;65;0;0;0;0;.00nan;0;0
45781;6837;73;17;6;4;2;.333;492000;0
45781;7271;82;61;19;2;17;.895;3600000;0
45781;7302;82;0;0;0;0;.00nan;0;0
45781;8429;73;98;63;3;60;.952;3108000;0
45791;6804;72;0;0;0;0;.00nan;0;0
45791;6879;72;53;25;3;22;.880;3600000;0
45791;8476;63;0;0;0;0;.00nan;0;0
45791;9247;63;52;34;4;30;.882;3600000;0
45765;7409;70;48;21;3;18;.857;3600000;0
45765;7840;66;27;25;5;20;.800;2116000;0
45765;8367;70;0;0;0;0;.00nan;0;0
45765;8726;66;49;8;1;7;.875;1484000;0
45814;7389;74;43;30;5;25;.833;3600000;0
45814;8442;74;0;0;0;0;.00nan;0;0
45814;8499;78;70;30;2;28;.933;2668000;0
45814;8711;78;34;19;4;15;.789;932000;0
45762;6821;71;57;42;5;37;.881;3600000;0
45762;8130;71;0;0;0;0;.00nan;0;0
45762;8493;80;0;0;0;0;.00nan;0;0
45762;8685;80;73;32;2;30;.938;3600000;0
45796;7899;81;0;0;0;0;.00nan;0;0
45796;7908;64;83;36;2;34;.944;3095000;0
45796;8404;64;27;7;3;4;.571;505000;0
45796;8450;81;40;21;4;17;.810;3600000;0
45819;6939;69;34;18;4;14;.778;3600000;0
45819;7327;69;0;0;0;0;.00nan;0;0
45819;7389;74;15;22;6;16;.727;2456000;0
45819;8442;74;41;12;2;10;.833;1144000;0
45803;6837;73;73;55;6;49;.891;3164000;0
45803;8429;73;54;9;1;8;.889;436000;0
45803;8499;78;0;0;0;0;.00nan;0;0
45803;8711;78;57;11;1;10;.909;3600000;0
45844;6905;68;0;0;0;0;.00nan;0;0
45844;7409;70;0;0;0;0;.00nan;0;0
45844;7816;68;68;24;2;22;.917;3600000;0
45844;8367;70;61;38;4;34;.895;3549000;0
45729;7840;66;22;19;5;14;.737;889000;0
45729;7908;64;0;0;0;0;.00nan;0;0
45729;8404;64;40;14;3;11;.786;3600000;0
45729;8726;66;26;36;7;29;.806;2711000;0
45832;7237;75;61;17;1;16;.941;3600000;0
45832;7298;75;0;0;0;0;.00nan;0;0
45832;8113;77;33;11;3;8;.727;425000;0
45832;8132;77;70;59;7;52;.881;3175000;0
45802;6813;83;0;0;0;0;.00nan;0;0
45802;7325;83;44;11;2;9;.818;3600000;0
45802;8476;63;22;47;9;38;.809;2977000;0
45802;9247;63;43;14;2;12;.857;623000;0
45837;6939;69;53;30;4;26;.867;3580000;0
45837;7327;69;0;0;0;0;.00nan;0;0
45837;7389;74;63;19;2;17;.895;3600000;0
45837;8442;74;0;0;0;0;.00nan;0;0
45772;7385;84;31;43;7;36;.837;3307000;0
45772;7596;79;76;12;0;12;1.000;3600000;0
45772;7855;84;48;0;0;0;.00nan;293000;0
45772;7904;79;0;0;0;0;.00nan;0;0
45770;7840;66;0;0;0;0;.00nan;0;0
45770;8476;63;62;17;1;16;.941;2058000;0
45770;8726;66;33;52;8;44;.846;3553000;0
45770;9247;63;11;16;6;10;.625;1542000;0
45824;6824;67;70;51;5;46;.902;3600000;0
45824;6837;73;73;20;1;19;.950;3600000;0
45824;7269;67;0;0;0;0;.00nan;0;0
45824;8429;73;0;0;0;0;.00nan;0;0
45816;7237;75;0;0;0;0;.00nan;0;0
45816;7298;75;68;27;3;24;.889;3854000;0
45816;8133;76;92;60;4;56;.933;3854000;0
45816;8420;76;0;0;0;0;.00nan;0;0
45797;7899;81;0;0;0;0;.00nan;0;0
45797;8450;81;66;39;4;35;.897;3558000;0
45797;8493;80;94;38;2;36;.947;3600000;0
45797;8685;80;0;0;0;0;.00nan;0;0
45798;6905;68;50;24;4;20;.833;3600000;0
45798;7598;65;0;0;0;0;.00nan;0;0
45798;7816;68;0;0;0;0;.00nan;0;0
45798;7911;65;56;53;7;46;.868;3600000;0
45817;7237;75;48;19;3;16;.842;3600000;0
45817;7298;75;0;0;0;0;.00nan;0;0
45817;7596;79;48;45;6;39;.867;3600000;0
45817;7904;79;0;0;0;0;.00nan;0;0
45856;6804;72;0;0;0;0;.00nan;0;0
45856;6879;72;54;27;3;24;.889;3600000;0
45856;7389;74;40;39;7;32;.821;2222000;0
45856;8442;74;50;14;2;12;.857;1378000;0
45822;6821;71;66;33;4;29;.879;3600000;0
45822;8130;71;0;0;0;0;.00nan;0;0
45822;8499;78;68;10;0;10;1.000;1316000;0
45822;8711;78;24;19;5;14;.737;2252000;0
45849;7271;82;66;26;3;23;.885;3900000;0
45849;7302;82;0;0;0;0;.00nan;0;0
45849;7908;64;0;0;0;0;.00nan;0;0
45849;8404;64;75;41;3;38;.927;3900000;0
45788;6939;69;53;27;3;24;.889;3600000;0
45788;7327;69;0;0;0;0;.00nan;0;0
45788;7840;66;47;36;5;31;.861;3536000;0
45788;8726;66;0;0;0;0;.00nan;0;0
45820;6821;71;54;30;4;26;.867;3600000;0
45820;8130;71;0;0;0;0;.00nan;0;0
45820;8493;80;55;30;4;26;.867;3311000;0
45820;8685;80;21;3;3;0;.000;289000;0
45847;6804;72;72;21;2;19;.905;3600000;0
45847;6879;72;0;0;0;0;.00nan;0;0
45847;6905;68;32;4;2;2;.500;460000;0
45847;7816;68;49;38;6;32;.842;3140000;0
45801;6813;83;0;0;0;0;.00nan;0;0
45801;7325;83;76;22;1;21;.955;3600000;0
45801;7899;81;61;46;5;41;.891;3600000;0
45801;8450;81;0;0;0;0;.00nan;0;0
45894;7409;70;70;17;1;16;.941;3600000;0
45894;7908;64;54;5;0;5;1.000;377000;0
45894;8367;70;0;0;0;0;.00nan;0;0
45894;8404;64;37;27;5;22;.815;3223000;0
45812;7598;65;15;21;6;15;.714;1796000;0
45812;7911;65;77;22;1;21;.955;1804000;0
45812;8476;63;0;0;0;0;.00nan;0;0
45812;9247;63;51;10;2;8;.800;3600000;0
45829;6813;83;89;17;0;17;1.000;3600000;0
45829;7325;83;0;0;0;0;.00nan;0;0
45829;7385;84;30;9;3;6;.667;343000;0
45829;7855;84;45;68;9;59;.868;3257000;0
45792;7389;74;0;0;0;0;.00nan;0;0
45792;7840;66;35;35;6;29;.829;3032000;0
45792;8442;74;52;27;4;23;.852;3600000;0
45792;8726;66;50;3;0;3;1.000;568000;0
45853;6837;73;82;33;2;31;.939;3600000;0
45853;6939;69;45;35;5;30;.857;3600000;0
45853;7327;69;0;0;0;0;.00nan;0;0
45853;8429;73;0;0;0;0;.00nan;0;0
45827;6824;67;34;38;7;31;.816;3600000;0
45827;7269;67;0;0;0;0;.00nan;0;0
45827;8476;63;68;23;2;21;.913;3600000;0
45827;9247;63;0;0;0;0;.00nan;0;0
45833;7237;75;0;0;0;0;.00nan;0;0
45833;7298;75;76;14;1;13;.929;3600000;0
45833;8113;77;0;0;0;0;.00nan;0;0
45833;8132;77;76;62;7;55;.887;3600000;0
45835;7409;70;61;28;3;25;.893;3526000;0
45835;7596;79;79;32;1;31;.969;3600000;0
45835;7904;79;0;0;0;0;.00nan;0;0
45835;8367;70;0;0;0;0;.00nan;0;0
45804;6804;72;0;0;0;0;.00nan;0;0
45804;6879;72;70;21;1;20;.952;3600000;0
45804;8493;80;0;0;0;0;.00nan;0;0
45804;8685;80;67;32;3;29;.906;3515000;0
45826;6824;67;85;39;2;37;.949;3544000;0
45826;7269;67;0;0;0;0;.00nan;0;0
45826;7598;65;94;32;1;31;.969;3600000;0
45826;7911;65;0;0;0;0;.00nan;0;0
45807;8133;76;0;0;0;0;.00nan;0;0
45807;8420;76;71;35;4;31;.886;3548000;0
45807;8499;78;0;0;0;0;.00nan;0;0
45807;8711;78;83;36;2;34;.944;3600000;0
45861;6939;69;91;40;3;37;.925;3600000;0
45861;7327;69;0;0;0;0;.00nan;0;0
45861;8499;78;24;32;6;26;.813;3600000;0
45861;8711;78;0;0;0;0;.00nan;0;0
45786;6821;71;51;24;4;20;.833;3581000;0
45786;7899;81;0;0;0;0;.00nan;0;0
45786;8130;71;0;0;0;0;.00nan;0;0
45786;8450;81;71;29;2;27;.931;3600000;0
45903;6905;68;0;0;0;0;.00nan;0;0
45903;7816;68;27;12;4;8;.667;3600000;0
45903;8133;76;71;55;7;48;.873;3600000;0
45903;8420;76;0;0;0;0;.00nan;0;0
45871;7389;74;70;52;5;47;.904;3599000;0
45871;7409;70;0;0;0;0;.00nan;0;0
45871;8367;70;41;16;3;13;.813;3600000;0
45871;8442;74;0;0;0;0;.00nan;0;0
45928;6837;73;41;35;6;29;.829;3600000;0
45928;7908;64;0;0;0;0;.00nan;0;0
45928;8404;64;42;27;4;23;.852;3600000;0
45928;8429;73;0;0;0;0;.00nan;0;0
45841;6813;83;0;0;0;0;.00nan;0;0
45841;7325;83;56;14;1;13;.929;3600000;0
45841;8113;77;46;21;3;18;.857;555000;0
45841;8132;77;97;76;4;72;.947;3045000;0
45879;7385;84;74;54;5;49;.907;3561000;0
45879;7855;84;0;0;0;0;.00nan;0;0
45879;7899;81;69;29;3;26;.897;3600000;0
45879;8450;81;0;0;0;0;.00nan;0;0
45959;6837;73;80;29;2;27;.931;3600000;0
45959;8133;76;0;0;0;0;.00nan;0;0
45959;8420;76;67;39;3;36;.923;3600000;0
45959;8429;73;0;0;0;0;.00nan;0;0
45836;6813;83;0;0;0;0;.00nan;0;0
45836;7325;83;75;19;1;18;.947;3600000;0
45836;8493;80;0;0;0;0;.00nan;0;0
45836;8685;80;89;44;3;41;.932;3581000;0
45862;8113;77;0;0;0;0;.00nan;0;0
45862;8132;77;98;68;5;63;.926;3600000;0
45862;8499;78;0;0;0;0;.00nan;0;0
45862;8711;78;67;16;1;15;.938;3600000;0
45875;6804;72;68;4;0;4;1.000;3600000;0
45875;6879;72;0;0;0;0;.00nan;0;0
45875;7598;65;0;0;0;0;.00nan;0;0
45875;7911;65;98;66;4;62;.939;3600000;0
45867;6939;69;60;45;5;40;.889;3600000;0
45867;7327;69;0;0;0;0;.00nan;0;0
45867;7409;70;57;22;2;20;.909;3600000;0
45867;8367;70;0;0;0;0;.00nan;0;0
45806;6821;71;85;22;1;21;.955;3600000;0
45806;7389;74;76;32;2;30;.938;3547000;0
45806;8130;71;0;0;0;0;.00nan;0;0
45806;8442;74;0;0;0;0;.00nan;0;0
45795;7840;66;0;0;0;0;.00nan;0;0
45795;8499;78;0;0;0;0;.00nan;0;0
45795;8711;78;53;13;2;11;.846;3600000;0
45795;8726;66;90;50;3;47;.940;3579000;0
45809;7385;84;81;43;5;38;.884;3897000;0
45809;7855;84;0;0;0;0;.00nan;0;0
45809;7899;81;0;0;0;0;.00nan;0;0
45809;8450;81;52;28;4;24;.857;3897000;0
45838;6837;73;67;48;5;43;.896;3600000;0
45838;7596;79;98;24;0;24;1.000;3600000;0
45838;7904;79;0;0;0;0;.00nan;0;0
45838;8429;73;0;0;0;0;.00nan;0;0
45870;7237;75;0;0;0;0;.00nan;0;0
45870;7298;75;63;24;2;22;.917;3600000;0
45870;7409;70;0;0;0;0;.00nan;0;0
45870;8367;70;50;28;4;24;.857;3561000;0
45855;6813;83;59;39;4;35;.897;3600000;0
45855;7271;82;42;32;6;26;.813;2447000;0
45855;7302;82;49;15;2;13;.867;1153000;0
45855;7325;83;0;0;0;0;.00nan;0;0
45842;6824;67;74;44;4;40;.909;3584000;0
45842;7269;67;0;0;0;0;.00nan;0;0
45842;8476;63;0;0;0;0;.00nan;0;0
45842;9247;63;58;18;2;16;.889;3600000;0
45830;6824;67;77;26;1;25;.962;3600000;0
45830;7269;67;0;0;0;0;.00nan;0;0
45830;7598;65;0;0;0;0;.00nan;0;0
45830;7911;65;68;37;3;34;.919;3586000;0
45895;6804;72;83;14;0;14;1.000;3600000;0
45895;6879;72;0;0;0;0;.00nan;0;0
45895;7385;84;0;0;0;0;.00nan;0;0
45895;7855;84;80;61;5;56;.918;3600000;0
45823;6821;71;99;42;2;40;.952;3600000;0
45823;6905;68;46;25;4;21;.840;3563000;0
45823;7816;68;0;0;0;0;.00nan;0;0
45823;8130;71;0;0;0;0;.00nan;0;0
45828;6939;69;90;39;2;37;.949;3600000;0
45828;7327;69;0;0;0;0;.00nan;0;0
45828;7899;81;62;31;3;28;.903;3561000;0
45828;8450;81;0;0;0;0;.00nan;0;0
45848;7271;82;68;25;3;22;.880;3600000;0
45848;7302;82;0;0;0;0;.00nan;0;0
45848;8476;63;0;0;0;0;.00nan;0;0
45848;9247;63;42;37;5;32;.865;3555000;0
45902;7389;74;100;34;0;34;1.000;3600000;0
45902;7409;70;61;23;3;20;.870;3600000;0
45902;8367;70;0;0;0;0;.00nan;0;0
45902;8442;74;0;0;0;0;.00nan;0;0
45859;7596;79;58;10;1;9;.900;3600000;0
45859;7904;79;0;0;0;0;.00nan;0;0
45859;8113;77;0;0;0;0;.00nan;0;0
45859;8132;77;85;57;6;51;.895;3600000;0
45869;6804;72;79;11;0;11;1.000;3600000;0
45869;6879;72;0;0;0;0;.00nan;0;0
45869;6939;69;0;0;0;0;.00nan;0;0
45869;7327;69;87;69;6;63;.913;3600000;0
45800;7598;65;21;41;8;33;.805;2692000;0
45800;7840;66;57;27;3;24;.889;3600000;0
45800;7911;65;58;8;0;8;1.000;908000;0
45800;8726;66;0;0;0;0;.00nan;0;0
45839;7237;75;55;33;4;29;.879;3600000;0
45839;7298;75;0;0;0;0;.00nan;0;0
45839;8499;78;40;15;2;13;.867;767000;0
45839;8711;78;42;39;6;33;.846;2833000;0
45936;6837;73;88;46;4;42;.913;3600000;0
45936;6905;68;0;0;0;0;.00nan;0;0
45936;7816;68;65;26;2;24;.923;3600000;0
45936;8429;73;0;0;0;0;.00nan;0;0
45852;8476;63;93;52;3;49;.942;3600000;0
45852;8493;80;14;22;6;16;.727;3600000;0
45852;8685;80;0;0;0;0;.00nan;0;0
45852;9247;63;0;0;0;0;.00nan;0;0
45810;7840;66;45;5;1;4;.800;270000;0
45810;7908;64;0;0;0;0;.00nan;0;0
45810;8404;64;73;21;1;20;.952;3600000;0
45810;8726;66;71;52;6;46;.885;3330000;0
45896;7237;75;0;0;0;0;.00nan;0;0
45896;7298;75;57;12;1;11;.917;3600000;0
45896;8113;77;91;45;3;42;.933;3517000;0
45896;8132;77;0;0;0;0;.00nan;0;0
45843;6813;83;0;0;0;0;.00nan;0;0
45843;6824;67;61;49;6;43;.878;2114000;0
45843;7269;67;58;35;4;31;.886;1486000;0
45843;7325;83;73;5;0;5;1.000;3600000;0
45863;7596;79;54;40;5;35;.875;3600000;0
45863;7899;81;0;0;0;0;.00nan;0;0
45863;7904;79;0;0;0;0;.00nan;0;0
45863;8450;81;77;28;2;26;.929;3600000;0
45831;6821;71;52;30;4;26;.867;3600000;0
45831;8130;71;0;0;0;0;.00nan;0;0
45831;8493;80;0;0;0;0;.00nan;0;0
45831;8685;80;62;49;6;43;.878;3581000;0
45882;7271;82;48;18;3;15;.833;3600000;0
45882;7302;82;0;0;0;0;.00nan;0;0
45882;7389;74;24;13;4;9;.692;873000;0
45882;8442;74;41;42;6;36;.857;2727000;0
45964;7385;84;69;42;4;38;.905;3600000;0
45964;7855;84;0;0;0;0;.00nan;0;0
45964;7908;64;0;0;0;0;.00nan;0;0
45964;8404;64;77;17;1;16;.941;3600000;0
45892;7598;65;0;0;0;0;.00nan;0;0
45892;7908;64;88;17;0;17;1.000;3600000;0
45892;7911;65;97;68;4;64;.941;3600000;0
45892;8404;64;0;0;0;0;.00nan;0;0
45811;6821;71;45;16;3;13;.813;3600000;0
45811;7840;66;0;0;0;0;.00nan;0;0
45811;8130;71;0;0;0;0;.00nan;0;0
45811;8726;66;65;46;5;41;.891;3570000;0
45846;6824;67;24;13;4;9;.692;1015000;0
45846;7237;75;0;0;0;0;.00nan;0;0
45846;7269;67;98;59;3;56;.949;2585000;0
45846;7298;75;60;10;1;9;.900;3600000;0
45893;6804;72;99;42;1;41;.976;3600000;0
45893;6813;83;0;0;0;0;.00nan;0;0
45893;6879;72;0;0;0;0;.00nan;0;0
45893;7325;83;78;29;2;27;.931;3560000;0
45984;7389;74;0;0;0;0;.00nan;0;0
45984;7598;65;0;0;0;0;.00nan;0;0
45984;7911;65;88;44;3;41;.932;3853000;0
45984;8442;74;52;24;2;22;.917;3853000;0
45986;7908;64;0;0;0;0;.00nan;0;0
45986;8113;77;0;0;0;0;.00nan;0;0
45986;8132;77;92;54;4;50;.926;3900000;0
45986;8404;64;26;16;4;12;.750;3900000;0
45988;6837;73;66;49;6;43;.878;2999000;0
45988;7237;75;0;0;0;0;.00nan;0;0
45988;7298;75;48;12;2;10;.833;3600000;0
45988;8429;73;36;6;2;4;.667;601000;0
45990;6939;69;83;42;3;39;.929;3575000;0
45990;7596;69;0;0;0;0;.00nan;0;0
45990;7840;66;0;0;0;0;.00nan;0;0
45990;7864;66;81;32;1;31;.969;3600000;0
45992;6824;67;69;57;6;51;.895;3109000;0
45992;6905;68;0;0;0;0;.00nan;0;0
45992;7269;67;39;11;2;9;.818;491000;0
45992;7816;68;70;9;0;9;1.000;3600000;0
45994;6804;72;58;20;2;18;.900;3572000;0
45994;6879;72;0;0;0;0;.00nan;0;0
45994;7409;70;99;36;1;35;.972;3600000;0
45994;8367;70;0;0;0;0;.00nan;0;0
45996;7271;82;61;20;2;18;.900;3600000;0
45996;7302;82;0;0;0;0;.00nan;0;0
45996;8474;63;0;0;0;0;.00nan;0;0
45996;8476;63;64;33;4;29;.879;3600000;0
45998;6821;71;98;51;2;49;.961;3576000;0
45998;8130;71;0;0;0;0;.00nan;0;0
45998;8499;78;62;18;1;17;.944;3600000;0
45998;8711;78;0;0;0;0;.00nan;0;0
46000;7901;79;78;48;4;44;.917;3600000;0
46000;7904;79;0;0;0;0;.00nan;0;0
46000;8493;80;61;18;2;16;.889;3600000;0
46000;8685;80;0;0;0;0;.00nan;0;0
46002;6813;83;0;0;0;0;.00nan;0;0
46002;7325;83;50;23;3;20;.870;3600000;0
46002;7899;81;68;40;4;36;.900;3566000;0
46002;8450;81;0;0;0;0;.00nan;0;0
46004;7385;84;41;35;6;29;.829;3136000;0
46004;7855;84;31;4;2;2;.500;464000;0
46004;8133;76;0;0;0;0;.00nan;0;0
46004;8420;76;91;15;0;15;1.000;3600000;0
46006;7237;75;45;22;4;18;.818;3600000;0
46006;7298;75;0;0;0;0;.00nan;0;0
46006;7840;66;50;13;1;12;.923;839000;0
46006;7864;66;28;31;6;25;.806;2761000;0
46008;6837;73;65;25;2;23;.920;3600000;0
46008;7385;84;52;56;8;48;.857;3600000;0
46008;7855;84;0;0;0;0;.00nan;0;0
46008;8429;73;0;0;0;0;.00nan;0;0
46010;6813;83;48;4;1;3;.750;3600000;0
46010;6824;67;35;20;4;16;.800;971000;0
46010;7269;67;49;48;7;41;.854;2629000;0
46010;7325;83;0;0;0;0;.00nan;0;0
46012;6939;69;87;39;2;37;.949;3600000;0
46012;7596;69;0;0;0;0;.00nan;0;0
46012;8474;63;35;24;5;19;.792;3600000;0
46012;8476;63;0;0;0;0;.00nan;0;0
46014;6821;71;55;33;4;29;.879;3556000;0
46014;8113;77;70;29;3;26;.897;3600000;0
46014;8130;71;0;0;0;0;.00nan;0;0
46014;8132;77;0;0;0;0;.00nan;0;0
46016;7901;79;0;0;0;0;.00nan;0;0
46016;7904;79;55;21;2;19;.905;3600000;0
46016;8133;76;31;9;3;6;.667;669000;0
46016;8420;76;45;39;6;33;.846;2931000;0
46018;6905;68;0;0;0;0;.00nan;0;0
46018;7389;74;52;33;4;29;.879;3600000;0
46018;7816;68;70;22;1;21;.955;3600000;0
46018;8442;74;0;0;0;0;.00nan;0;0
46020;7899;81;0;0;0;0;.00nan;0;0
46020;7908;64;100;32;0;32;1.000;3600000;0
46020;8404;64;0;0;0;0;.00nan;0;0
46020;8450;81;62;21;2;19;.905;3531000;0
46022;7271;82;25;11;4;7;.636;1036000;0
46022;7302;82;62;43;4;39;.907;2564000;0
46022;8493;80;0;0;0;0;.00nan;0;0
46022;8685;80;31;20;4;16;.800;3600000;0
46024;7409;70;61;36;4;32;.889;3600000;0
46024;8367;70;0;0;0;0;.00nan;0;0
46024;8499;78;52;4;0;4;1.000;658000;0
46024;8711;78;21;26;6;20;.769;2907000;0
46026;6804;72;0;0;0;0;.00nan;0;0
46026;6879;72;44;4;1;3;.750;3600000;0
46026;7598;65;45;45;7;38;.844;2853000;0
46026;7911;65;55;7;0;7;1.000;747000;0
46028;8493;80;51;32;5;27;.844;3734000;0
46028;8499;78;46;28;4;24;.857;3734000;0
46028;8685;80;0;0;0;0;.00nan;0;0
46028;8711;78;0;0;0;0;.00nan;0;0
46030;6837;73;63;15;1;14;.933;1249000;0
46030;6905;68;71;28;2;26;.929;3600000;0
46030;7816;68;0;0;0;0;.00nan;0;0
46030;8429;73;36;37;6;31;.838;2351000;0
46032;6939;69;31;32;6;26;.813;2446000;0
46032;7237;75;0;0;0;0;.00nan;0;0
46032;7298;75;58;10;1;9;.900;3600000;0
46032;7596;69;37;18;4;14;.778;1154000;0
46034;6813;83;0;0;0;0;.00nan;0;0
46034;7325;83;98;22;0;22;1.000;3600000;0
46034;7409;70;0;0;0;0;.00nan;0;0
46034;8367;70;67;31;2;29;.935;3565000;0
46036;7598;65;0;0;0;0;.00nan;0;0
46036;7901;79;33;21;4;17;.810;3671000;0
46036;7904;79;0;0;0;0;.00nan;0;0
46036;7911;65;69;52;5;47;.904;3671000;0
46038;6821;71;0;0;0;0;.00nan;0;0
46038;7840;66;71;34;3;31;.912;3600000;0
46038;7864;66;0;0;0;0;.00nan;0;0
46038;8130;71;52;28;4;24;.857;3574000;0
46040;6824;67;82;71;7;64;.901;3600000;0
46040;7269;67;0;0;0;0;.00nan;0;0
46040;7389;74;0;0;0;0;.00nan;0;0
46040;8442;74;45;8;2;6;.750;3600000;0
46042;7385;84;0;0;0;0;.00nan;0;0
46042;7855;84;99;69;1;68;.986;3600000;0
46042;7899;81;48;13;2;11;.846;3544000;0
46042;8450;81;0;0;0;0;.00nan;0;0
46044;8113;77;32;37;7;30;.811;3365000;0
46044;8132;77;24;6;3;3;.500;235000;0
46044;8133;76;62;22;2;20;.909;3600000;0
46044;8420;76;0;0;0;0;.00nan;0;0
46046;7908;64;69;53;6;47;.887;3600000;0
46046;8404;64;0;0;0;0;.00nan;0;0
46046;8474;63;0;0;0;0;.00nan;0;0
46046;8476;63;45;36;5;31;.861;3600000;0
46048;6804;72;78;21;1;20;.952;3600000;0
46048;6879;72;0;0;0;0;.00nan;0;0
46048;7271;82;86;38;2;36;.947;3600000;0
46048;7302;82;0;0;0;0;.00nan;0;0
46050;6905;68;0;0;0;0;.00nan;0;0
46050;7816;68;70;30;2;28;.933;3600000;0
46050;7840;66;0;0;0;0;.00nan;0;0
46050;7864;66;80;38;3;35;.921;3591000;0
46052;7901;79;0;0;0;0;.00nan;0;0
46052;7904;79;68;20;2;18;.900;3600000;0
46052;8133;76;51;43;6;37;.860;3600000;0
46052;8420;76;0;0;0;0;.00nan;0;0
46054;7271;82;42;7;2;5;.714;3600000;0
46054;7302;82;0;0;0;0;.00nan;0;0
46054;7385;84;52;47;5;42;.894;2451000;0
46054;7855;84;39;24;4;20;.833;1149000;0
46056;6939;69;69;31;3;28;.903;3600000;0
46056;7596;69;0;0;0;0;.00nan;0;0
46056;8113;77;0;0;0;0;.00nan;0;0
46056;8132;77;80;36;4;32;.889;3567000;0
46058;7908;64;21;10;4;6;.600;864000;0
46058;8404;64;36;27;5;22;.815;2736000;0
46058;8474;63;63;28;2;26;.929;3600000;0
46058;8476;63;0;0;0;0;.00nan;0;0
46060;6813;83;0;0;0;0;.00nan;0;0
46060;7325;83;49;7;1;6;.857;3600000;0
46060;7598;65;97;55;2;53;.964;3600000;0
46060;7911;65;0;0;0;0;.00nan;0;0
46062;8493;80;0;0;0;0;.00nan;0;0
46062;8499;78;0;0;0;0;.00nan;0;0
46062;8685;80;64;41;4;37;.902;3600000;0
46062;8711;78;31;25;5;20;.800;3600000;0
46064;6824;67;64;64;8;56;.875;3256000;0
46064;7269;67;52;2;0;2;1.000;344000;0
46064;7389;74;47;6;1;5;.833;3600000;0
46064;8442;74;0;0;0;0;.00nan;0;0
46066;6804;72;0;0;0;0;.00nan;0;0
46066;6879;72;33;16;3;13;.813;3600000;0
46066;7409;70;77;39;2;37;.949;3600000;0
46066;8367;70;0;0;0;0;.00nan;0;0
46068;6837;73;34;12;3;9;.750;323000;0
46068;7237;75;0;0;0;0;.00nan;0;0
46068;7298;75;63;24;2;22;.917;3600000;0
46068;8429;73;81;49;3;46;.939;3277000;0
46070;6821;71;73;47;5;42;.894;3600000;0
46070;7899;81;0;0;0;0;.00nan;0;0
46070;8130;71;0;0;0;0;.00nan;0;0
46070;8450;81;64;30;2;28;.933;3600000;0
46072;6837;73;42;51;8;43;.843;3600000;0
46072;8133;76;0;0;0;0;.00nan;0;0
46072;8420;76;79;23;1;22;.957;3600000;0
46072;8429;73;0;0;0;0;.00nan;0;0
46074;6905;68;44;27;4;23;.852;3675000;0
46074;7816;68;0;0;0;0;.00nan;0;0
46074;8499;78;65;24;3;21;.875;3675000;0
46074;8711;78;0;0;0;0;.00nan;0;0
46076;7389;74;0;0;0;0;.00nan;0;0
46076;7899;81;51;28;3;25;.893;3600000;0
46076;8442;74;75;35;2;33;.943;3600000;0
46076;8450;81;0;0;0;0;.00nan;0;0
46078;7271;82;0;0;0;0;.00nan;0;0
46078;7302;82;54;21;3;18;.857;3630000;0
46078;7901;79;75;40;4;36;.900;3630000;0
46078;7904;79;0;0;0;0;.00nan;0;0
46080;6804;72;93;14;0;14;1.000;3600000;0
46080;6879;72;0;0;0;0;.00nan;0;0
46080;7908;64;69;57;6;51;.895;3183000;0
46080;8404;64;55;5;0;5;1.000;417000;0
46082;6939;69;76;48;4;44;.917;3900000;0
46082;7596;69;0;0;0;0;.00nan;0;0
46082;7840;66;48;32;4;28;.875;3896000;0
46082;7864;66;0;0;0;0;.00nan;0;0
46084;7409;70;0;0;0;0;.00nan;0;0
46084;8367;70;65;35;3;32;.914;3576000;0
46084;8493;80;96;32;1;31;.969;3600000;0
46084;8685;80;0;0;0;0;.00nan;0;0
46086;6821;71;0;0;0;0;.00nan;0;0
46086;7385;84;61;9;0;9;1.000;672000;0
46086;7855;84;32;32;6;26;.813;2928000;0
46086;8130;71;76;21;1;20;.952;3600000;0
46088;7237;75;43;31;5;26;.839;3600000;0
46088;7298;75;0;0;0;0;.00nan;0;0
46088;8474;63;0;0;0;0;.00nan;0;0
46088;8476;63;24;39;7;32;.821;3515000;0
46090;7598;65;0;0;0;0;.00nan;0;0
46090;7911;65;78;33;2;31;.939;3600000;0
46090;8113;77;47;26;3;23;.885;3558000;0
46090;8132;77;0;0;0;0;.00nan;0;0
46092;6813;83;65;4;0;4;1.000;3600000;0
46092;6824;67;64;46;6;40;.870;2068000;0
46092;7269;67;37;35;6;29;.829;1532000;0
46092;7325;83;0;0;0;0;.00nan;0;0
46094;7598;65;27;45;8;37;.822;3303000;0
46094;7901;79;0;0;0;0;.00nan;0;0
46094;7904;79;72;20;2;18;.900;3600000;0
46094;7911;65;42;3;1;2;.667;297000;0
46096;7385;84;89;74;5;69;.932;3600000;0
46096;7855;84;0;0;0;0;.00nan;0;0
46096;8493;80;0;0;0;0;.00nan;0;0
46096;8685;80;77;11;0;11;1.000;3600000;0
46098;7840;66;0;0;0;0;.00nan;0;0
46098;7864;66;63;56;7;49;.875;3600000;0
46098;8499;78;0;0;0;0;.00nan;0;0
46098;8711;78;76;9;0;9;1.000;3600000;0
46100;6905;68;0;0;0;0;.00nan;0;0
46100;7237;75;0;0;0;0;.00nan;0;0
46100;7298;75;73;27;2;25;.926;3890000;0
46100;7816;68;87;45;3;42;.933;3890000;0
46102;6821;71;93;39;1;38;.974;3600000;0
46102;7389;74;50;13;2;11;.846;3546000;0
46102;8130;71;0;0;0;0;.00nan;0;0
46102;8442;74;0;0;0;0;.00nan;0;0
46104;7271;82;65;30;3;27;.900;3600000;0
46104;7302;82;0;0;0;0;.00nan;0;0
46104;7899;81;18;27;7;20;.741;3600000;0
46104;8450;81;0;0;0;0;.00nan;0;0
46106;7908;64;0;0;0;0;.00nan;0;0
46106;8404;64;89;50;4;46;.920;3768000;0
46106;8474;63;0;0;0;0;.00nan;0;0
46106;8476;63;39;19;3;16;.842;3768000;0
46108;6813;83;77;9;0;9;1.000;3600000;0
46108;6837;73;51;42;6;36;.857;1674000;0
46108;7325;83;0;0;0;0;.00nan;0;0
46108;8429;73;25;38;7;31;.816;1926000;0
46110;6804;72;38;24;5;19;.792;3592000;0
46110;6879;72;0;0;0;0;.00nan;0;0
46110;7409;70;73;37;4;33;.892;3600000;0
46110;8367;70;0;0;0;0;.00nan;0;0
46112;8113;77;0;0;0;0;.00nan;0;0
46112;8132;77;68;34;3;31;.912;3629000;0
46112;8133;76;34;15;4;11;.733;3629000;0
46112;8420;76;0;0;0;0;.00nan;0;0
46114;6824;67;71;53;5;48;.906;3600000;0
46114;6939;69;51;11;2;9;.818;3600000;0
46114;7269;67;0;0;0;0;.00nan;0;0
46114;7596;69;0;0;0;0;.00nan;0;0
46116;6837;73;84;27;1;26;.963;3600000;0
46116;7908;64;0;0;0;0;.00nan;0;0
46116;8404;64;59;38;5;33;.868;3600000;0
46116;8429;73;0;0;0;0;.00nan;0;0
46118;6824;67;97;73;5;68;.932;3600000;0
46118;7269;67;0;0;0;0;.00nan;0;0
46118;7409;70;47;7;1;6;.857;3600000;0
46118;8367;70;0;0;0;0;.00nan;0;0
46120;6821;71;60;27;3;24;.889;3600000;0
46120;6939;69;59;42;5;37;.881;3600000;0
46120;7596;69;0;0;0;0;.00nan;0;0
46120;8130;71;0;0;0;0;.00nan;0;0
46122;6804;72;0;0;0;0;.00nan;0;0
46122;6879;72;43;24;4;20;.833;3600000;0
46122;8499;78;44;12;2;10;.833;977000;0
46122;8711;78;54;51;7;44;.863;2623000;0
46124;7598;65;0;0;0;0;.00nan;0;0
46124;7911;65;99;54;3;51;.944;3600000;0
46124;8474;63;0;0;0;0;.00nan;0;0
46124;8476;63;40;26;4;22;.846;3556000;0
46126;6813;83;47;12;2;10;.833;3600000;0
46126;7325;83;0;0;0;0;.00nan;0;0
46126;7389;74;38;40;6;34;.850;2611000;0
46126;8442;74;62;8;0;8;1.000;989000;0
46128;7271;82;97;20;0;20;1.000;3600000;0
46128;7302;82;0;0;0;0;.00nan;0;0
46128;7901;79;0;0;0;0;.00nan;0;0
46128;7904;79;42;32;5;27;.844;3600000;0
46130;7237;75;60;24;3;21;.875;3600000;0
46130;7298;75;0;0;0;0;.00nan;0;0
46130;7840;66;0;0;0;0;.00nan;0;0
46130;7864;66;91;55;4;51;.927;3600000;0
46132;7899;81;72;25;1;24;.960;3600000;0
46132;8133;76;48;7;1;6;.857;885000;0
46132;8420;76;35;33;6;27;.818;2715000;0
46132;8450;81;0;0;0;0;.00nan;0;0
46134;7385;84;44;32;6;26;.813;3123000;0
46134;7855;84;49;7;1;6;.857;464000;0
46134;8113;77;28;22;5;17;.773;3600000;0
46134;8132;77;0;0;0;0;.00nan;0;0
46136;6905;68;59;28;3;25;.893;3600000;0
46136;7816;68;0;0;0;0;.00nan;0;0
46136;8493;80;0;0;0;0;.00nan;0;0
46136;8685;80;39;44;7;37;.841;3600000;0
46137;7512;113;18;9;4;5;.556;700000;0
46137;8037;107;0;0;0;0;.00nan;0;0
46137;8109;107;82;41;3;38;.927;3600000;0
46137;8150;113;44;29;5;24;.828;2900000;0
46138;7435;116;0;0;0;0;.00nan;0;0
46138;7466;119;71;48;4;44;.917;3557000;0
46138;8038;119;0;0;0;0;.00nan;0;0
46138;8108;116;52;16;2;14;.875;3600000;0
46139;6908;111;0;0;0;0;.00nan;0;0
46139;6937;111;51;21;3;18;.857;3600000;0
46139;6968;115;0;0;0;0;.00nan;0;0
46139;7461;115;51;40;5;35;.875;3583000;0
46140;7993;108;0;0;0;0;.00nan;0;0
46140;8037;107;20;26;6;20;.769;3160000;0
46140;8056;108;71;32;3;29;.906;3600000;0
46140;8109;107;54;5;0;5;1.000;440000;0
46141;6967;121;0;0;0;0;.00nan;0;0
46141;6993;120;57;15;2;13;.867;3600000;0
46141;7425;121;53;40;5;35;.875;3600000;0
46141;8057;120;0;0;0;0;.00nan;0;0
46142;7029;105;63;26;3;23;.885;3600000;0
46142;7512;113;86;44;2;42;.955;3600000;0
46142;8014;105;0;0;0;0;.00nan;0;0
46142;8150;113;0;0;0;0;.00nan;0;0
46143;7003;122;0;0;0;0;.00nan;0;0
46143;7538;109;0;0;0;0;.00nan;0;0
46143;7966;122;69;28;2;26;.929;3600000;0
46143;8626;109;44;31;5;26;.839;3600000;0
46144;7562;112;0;0;0;0;.00nan;0;0
46144;8031;106;0;0;0;0;.00nan;0;0
46144;8549;106;38;29;5;24;.828;3600000;0
46144;8614;112;77;26;1;25;.962;3600000;0
46145;8111;118;0;0;0;0;.00nan;0;0
46145;8529;117;57;8;1;7;.875;958000;0
46145;8629;118;72;44;4;40;.909;3600000;0
46145;8658;117;11;21;6;15;.714;2642000;0
46146;6908;111;98;37;1;36;.973;3600000;0
46146;6937;111;0;0;0;0;.00nan;0;0
46146;7993;108;37;28;6;22;.786;3600000;0
46146;8056;108;0;0;0;0;.00nan;0;0
46147;7435;116;44;16;3;13;.813;3600000;0
46147;7466;119;0;0;0;0;.00nan;0;0
46147;8038;119;65;41;5;36;.878;3600000;0
46147;8108;116;0;0;0;0;.00nan;0;0
46148;6373;114;95;23;0;23;1.000;3600000;0
46148;6961;110;54;33;4;29;.879;3600000;0
46148;8564;110;0;0;0;0;.00nan;0;0
46148;8595;114;0;0;0;0;.00nan;0;0
46149;7029;105;0;0;0;0;.00nan;0;0
46149;7538;109;43;30;5;25;.833;3600000;0
46149;8014;105;100;28;0;28;1.000;3600000;0
46149;8626;109;0;0;0;0;.00nan;0;0
46150;7003;122;76;49;5;44;.898;3600000;0
46150;7966;122;0;0;0;0;.00nan;0;0
46150;8031;106;85;43;4;39;.907;3600000;0
46150;8549;106;0;0;0;0;.00nan;0;0
46151;6968;115;89;40;2;38;.950;3742000;0
46151;7461;115;0;0;0;0;.00nan;0;0
46151;7562;112;67;18;1;17;.944;3742000;0
46151;8614;112;0;0;0;0;.00nan;0;0
46152;6967;121;100;40;2;38;.950;3600000;0
46152;6993;120;0;0;0;0;.00nan;0;0
46152;7425;121;0;0;0;0;.00nan;0;0
46152;8057;120;24;38;7;31;.816;3600000;0
46153;6373;114;64;25;2;23;.920;3600000;0
46153;6961;110;0;0;0;0;.00nan;0;0
46153;8564;110;45;43;6;37;.860;3600000;0
46153;8595;114;0;0;0;0;.00nan;0;0
46154;8111;118;83;34;2;32;.941;3551000;0
46154;8529;117;100;44;1;43;.977;3600000;0
46154;8629;118;0;0;0;0;.00nan;0;0
46154;8658;117;0;0;0;0;.00nan;0;0
46155;6967;121;76;25;1;24;.960;3600000;0
46155;7425;121;0;0;0;0;.00nan;0;0
46155;8111;118;0;0;0;0;.00nan;0;0
46155;8629;118;75;33;2;31;.939;3560000;0
46156;7562;112;0;0;0;0;.00nan;0;0
46156;8031;106;60;14;1;13;.929;3600000;0
46156;8549;106;0;0;0;0;.00nan;0;0
46156;8614;112;57;47;5;42;.894;3600000;0
46157;6967;121;46;36;6;30;.833;3207000;0
46157;7425;121;22;4;3;1;.250;393000;0
46157;7435;116;0;0;0;0;.00nan;0;0
46157;8108;116;39;33;5;28;.848;3600000;0
46158;7466;119;54;32;4;28;.875;3542000;0
46158;8038;119;0;0;0;0;.00nan;0;0
46158;8529;117;55;26;3;23;.885;3600000;0
46158;8658;117;0;0;0;0;.00nan;0;0
46159;7003;122;78;32;2;30;.938;3600000;0
46159;7512;113;65;42;5;37;.881;3600000;0
46159;7966;122;0;0;0;0;.00nan;0;0
46159;8150;113;0;0;0;0;.00nan;0;0
46160;7029;105;61;17;1;16;.941;3600000;0
46160;7993;108;0;0;0;0;.00nan;0;0
46160;8014;105;0;0;0;0;.00nan;0;0
46160;8056;108;51;32;4;28;.875;3600000;0
46161;6908;111;81;27;1;26;.963;3600000;0
46161;6937;111;0;0;0;0;.00nan;0;0
46161;6961;110;56;30;4;26;.867;3600000;0
46161;8564;110;0;0;0;0;.00nan;0;0
46162;6373;114;42;17;3;14;.824;3600000;0
46162;6985;114;0;0;0;0;.00nan;0;0
46162;7538;109;47;45;6;39;.867;3600000;0
46162;8626;109;0;0;0;0;.00nan;0;0
46163;6967;121;0;0;0;0;.00nan;0;0
46163;7425;121;36;43;7;36;.837;3600000;0
46163;7435;116;74;22;1;21;.955;3600000;0
46163;8108;116;0;0;0;0;.00nan;0;0
46164;7466;119;50;1;0;1;1.000;357000;0
46164;8038;119;27;29;6;23;.793;3203000;0
46164;8111;118;72;45;5;40;.889;3600000;0
46164;8629;118;0;0;0;0;.00nan;0;0
46165;6993;120;73;44;4;40;.909;3600000;0
46165;8057;120;0;0;0;0;.00nan;0;0
46165;8529;117;0;0;0;0;.00nan;0;0
46165;8658;117;60;33;3;30;.909;3600000;0
46166;6968;115;0;0;0;0;.00nan;0;0
46166;7461;115;66;38;4;34;.895;3564000;0
46166;8037;107;0;0;0;0;.00nan;0;0
46166;8109;107;88;36;2;34;.944;3600000;0
46167;7029;105;59;19;2;17;.895;3600000;0
46167;7512;113;62;44;4;40;.909;3567000;0
46167;8014;105;0;0;0;0;.00nan;0;0
46167;8150;113;0;0;0;0;.00nan;0;0
46168;7003;122;0;0;0;0;.00nan;0;0
46168;7966;122;49;19;3;16;.842;3600000;0
46168;7993;108;37;38;6;32;.842;2994000;0
46168;8056;108;40;11;2;9;.818;606000;0
46169;6993;120;0;0;0;0;.00nan;0;0
46169;8057;120;74;27;2;25;.926;3600000;0
46169;8111;118;50;17;2;15;.882;2733000;0
46169;8629;118;25;12;4;8;.667;867000;0
46170;6961;110;0;0;0;0;.00nan;0;0
46170;7562;112;0;0;0;0;.00nan;0;0
46170;8564;110;24;36;7;29;.806;3600000;0
46170;8614;112;61;24;2;22;.917;3600000;0
46171;6373;114;0;0;0;0;.00nan;0;0
46171;6985;114;76;24;1;23;.958;3600000;0
46171;7538;109;32;27;5;22;.815;3367000;0
46171;8626;109;23;4;3;1;.250;233000;0
46172;6908;111;0;0;0;0;.00nan;0;0
46172;6937;111;63;36;4;32;.889;3900000;0
46172;8031;106;48;22;4;18;.818;3900000;0
46172;8549;106;0;0;0;0;.00nan;0;0
46173;6968;115;98;62;4;58;.935;3600000;0
46173;7461;115;0;0;0;0;.00nan;0;0
46173;8037;107;0;0;0;0;.00nan;0;0
46173;8109;107;54;10;1;9;.900;3600000;0
46174;7003;122;20;28;7;21;.750;3600000;0
46174;7966;122;0;0;0;0;.00nan;0;0
46174;8037;107;0;0;0;0;.00nan;0;0
46174;8109;107;82;40;3;37;.925;3600000;0
46175;7435;116;0;0;0;0;.00nan;0;0
46175;8108;116;31;20;4;16;.800;3600000;0
46175;8111;118;41;17;3;14;.824;1117000;0
46175;8629;118;28;40;8;32;.800;2483000;0
46176;7012;109;80;33;2;31;.939;3600000;0
46176;7029;105;63;31;4;27;.871;3554000;0
46176;7538;109;0;0;0;0;.00nan;0;0
46176;8014;105;0;0;0;0;.00nan;0;0
46177;6967;121;0;0;0;0;.00nan;0;0
46177;7425;121;41;27;5;22;.815;3600000;0
46177;7562;112;0;0;0;0;.00nan;0;0
46177;8614;112;33;31;6;25;.806;3600000;0
46178;7029;105;0;0;0;0;.00nan;0;0
46178;7993;108;100;40;0;40;1.000;3600000;0
46178;8014;105;47;24;4;20;.833;3600000;0
46178;8056;108;0;0;0;0;.00nan;0;0
46179;6967;121;38;17;3;14;.824;3600000;0
46179;7425;121;0;0;0;0;.00nan;0;0
46179;8111;118;42;4;1;3;.750;270000;0
46179;8629;118;61;52;6;46;.885;3330000;0
46180;7466;119;62;32;3;29;.906;3600000;0
46180;8038;119;0;0;0;0;.00nan;0;0
46180;8529;117;33;26;5;21;.808;3515000;0
46180;8658;117;0;0;0;0;.00nan;0;0
46181;6373;114;72;20;0;20;1.000;3900000;0
46181;6908;111;0;0;0;0;.00nan;0;0
46181;6937;111;100;26;0;26;1.000;3900000;0
46181;6985;114;0;0;0;0;.00nan;0;0
46182;6961;110;36;28;5;23;.821;3600000;0
46182;8031;106;0;0;0;0;.00nan;0;0
46182;8549;106;71;32;2;30;.938;3600000;0
46182;8564;110;0;0;0;0;.00nan;0;0
46183;6993;120;80;25;1;24;.960;3600000;0
46183;7512;113;0;0;0;0;.00nan;0;0
46183;8057;120;0;0;0;0;.00nan;0;0
46183;8150;113;66;35;3;32;.914;3567000;0
46184;6968;115;55;16;2;14;.875;1327000;0
46184;7012;109;0;0;0;0;.00nan;0;0
46184;7461;115;12;26;7;19;.731;2273000;0
46184;7538;109;77;22;1;21;.955;3600000;0
46185;7003;122;0;0;0;0;.00nan;0;0
46185;7966;122;65;18;1;17;.944;3600000;0
46185;8037;107;0;0;0;0;.00nan;0;0
46185;8109;107;70;33;3;30;.909;3534000;0
46186;7435;116;0;0;0;0;.00nan;0;0
46186;7562;112;0;0;0;0;.00nan;0;0
46186;8108;116;44;23;4;19;.826;3600000;0
46186;8614;112;49;37;5;32;.865;3600000;0
46187;6967;121;0;0;0;0;.00nan;0;0
46187;7425;121;36;20;4;16;.800;3600000;0
46187;8111;118;98;63;5;58;.921;3575000;0
46187;8629;118;0;0;0;0;.00nan;0;0
46188;7435;116;71;26;2;24;.923;3600000;0
46188;7466;119;0;0;0;0;.00nan;0;0
46188;8038;119;44;44;7;37;.841;3600000;0
46188;8612;116;0;0;0;0;.00nan;0;0
46189;6993;120;52;3;0;3;1.000;320000;0
46189;7993;108;56;33;4;29;.879;3600000;0
46189;8056;108;0;0;0;0;.00nan;0;0
46189;8057;120;11;24;7;17;.708;3280000;0
46190;6373;114;83;15;0;15;1.000;3600000;0
46190;6968;115;46;18;3;15;.833;1336000;0
46190;6985;114;0;0;0;0;.00nan;0;0
46190;7461;115;26;28;6;22;.786;2264000;0
46191;7029;105;60;27;3;24;.889;3578000;0
46191;8014;105;0;0;0;0;.00nan;0;0
46191;8037;107;68;29;2;27;.931;3600000;0
46191;8109;107;0;0;0;0;.00nan;0;0
46192;7003;122;61;28;3;25;.893;3600000;0
46192;7512;113;57;38;5;33;.868;3563000;0
46192;7966;122;0;0;0;0;.00nan;0;0
46192;8150;113;0;0;0;0;.00nan;0;0
46193;7562;112;82;42;3;39;.929;3600000;0
46193;8529;117;0;0;0;0;.00nan;0;0
46193;8614;112;0;0;0;0;.00nan;0;0
46193;8658;117;37;20;4;16;.800;3566000;0
46194;6961;110;80;43;3;40;.930;3600000;0
46194;7993;108;0;0;0;0;.00nan;0;0
46194;8056;108;100;29;0;29;1.000;3600000;0
46194;8564;110;0;0;0;0;.00nan;0;0
46195;6908;111;0;0;0;0;.00nan;0;0
46195;6937;111;52;43;6;37;.860;3900000;0
46195;7012;109;51;2;0;2;1.000;851000;0
46195;7538;109;16;20;6;14;.700;3049000;0
46196;6993;120;53;31;4;27;.871;3600000;0
46196;8031;106;94;25;0;25;1.000;3600000;0
46196;8057;120;0;0;0;0;.00nan;0;0
46196;8549;106;0;0;0;0;.00nan;0;0
46197;7466;119;66;31;3;28;.903;3600000;0
46197;8038;119;0;0;0;0;.00nan;0;0
46197;8111;118;50;1;0;1;1.000;276000;0
46197;8629;118;22;32;7;25;.781;3324000;0
46198;6961;110;0;0;0;0;.00nan;0;0
46198;8031;106;54;28;4;24;.857;3900000;0
46198;8549;106;0;0;0;0;.00nan;0;0
46198;8564;110;96;52;4;48;.923;3900000;0
46199;7003;122;0;0;0;0;.00nan;0;0
46199;7029;105;46;31;5;26;.839;3600000;0
46199;7966;122;74;23;1;22;.957;3600000;0
46199;8014;105;0;0;0;0;.00nan;0;0
46200;7512;113;68;29;2;27;.931;3600000;0
46200;8037;107;0;0;0;0;.00nan;0;0
46200;8109;107;51;21;3;18;.857;3566000;0
46200;8150;113;0;0;0;0;.00nan;0;0
46201;6373;114;34;26;6;20;.769;3600000;0
46201;6985;114;0;0;0;0;.00nan;0;0
46201;7562;112;0;0;0;0;.00nan;0;0
46201;8614;112;72;45;5;40;.889;3600000;0
46202;6908;111;0;0;0;0;.00nan;0;0
46202;6937;111;76;26;1;25;.962;3600000;0
46202;6968;115;0;0;0;0;.00nan;0;0
46202;7461;115;42;28;5;23;.821;3600000;0
46203;7512;113;71;24;2;22;.917;3600000;0
46203;8111;118;0;0;0;0;.00nan;0;0
46203;8150;113;0;0;0;0;.00nan;0;0
46203;8629;118;58;41;5;36;.878;3600000;0
46204;6967;121;31;24;5;19;.792;3247000;0
46204;7425;121;49;6;1;5;.833;345000;0
46204;7466;119;48;32;5;27;.844;3600000;0
46204;8038;119;0;0;0;0;.00nan;0;0
46205;7435;116;0;0;0;0;.00nan;0;0
46205;8031;106;0;0;0;0;.00nan;0;0
46205;8549;106;74;44;3;41;.932;3514000;0
46205;8612;116;81;29;1;28;.966;3600000;0
46206;6968;115;0;0;0;0;.00nan;0;0
46206;7461;115;81;31;2;29;.935;3600000;0
46206;8111;118;29;10;3;7;.700;580000;0
46206;8629;118;66;37;4;33;.892;3020000;0
46207;6908;111;0;0;0;0;.00nan;0;0
46207;6937;111;61;25;3;22;.880;3600000;0
46207;7512;113;0;0;0;0;.00nan;0;0
46207;8150;113;56;20;2;18;.900;3600000;0
46208;6967;121;0;0;0;0;.00nan;0;0
46208;7425;121;89;43;2;41;.953;3600000;0
46208;8031;106;43;19;4;15;.789;3529000;0
46208;8549;106;0;0;0;0;.00nan;0;0
46209;6961;110;67;23;2;21;.913;3600000;0
46209;8037;107;0;0;0;0;.00nan;0;0
46209;8109;107;64;38;5;33;.868;3600000;0
46209;8564;110;0;0;0;0;.00nan;0;0
46210;6373;114;84;31;2;29;.935;3600000;0
46210;6985;114;0;0;0;0;.00nan;0;0
46210;8000;105;53;25;3;22;.880;3575000;0
46210;8014;105;0;0;0;0;.00nan;0;0
46211;7993;108;70;23;2;21;.913;3254000;0
46211;8056;108;30;7;3;4;.571;346000;0
46211;8529;117;31;37;7;30;.811;3555000;0
46211;8658;117;0;0;0;0;.00nan;0;0
46212;7003;122;16;25;6;19;.760;2810000;0
46212;7012;109;75;27;2;25;.926;3600000;0
46212;7538;109;0;0;0;0;.00nan;0;0
46212;7966;122;53;4;0;4;1.000;790000;0
46213;7562;112;0;0;0;0;.00nan;0;0
46213;8111;118;15;33;7;26;.788;1953000;0
46213;8614;112;78;11;0;11;1.000;3600000;0
46213;8629;118;89;33;1;32;.970;1647000;0
46214;6993;120;75;34;3;31;.912;3600000;0
46214;7466;119;65;27;2;25;.926;3600000;0
46214;8038;119;0;0;0;0;.00nan;0;0
46214;8057;120;0;0;0;0;.00nan;0;0
46215;6908;111;32;17;4;13;.765;1072000;0
46215;6937;111;84;27;1;26;.963;2528000;0
46215;7012;109;0;0;0;0;.00nan;0;0
46215;7538;109;40;15;3;12;.800;3600000;0
46216;6961;110;0;0;0;0;.00nan;0;0
46216;8037;107;87;37;1;36;.973;3600000;0
46216;8109;107;0;0;0;0;.00nan;0;0
46216;8564;110;43;29;4;25;.862;3600000;0
46217;6373;114;0;0;0;0;.00nan;0;0
46217;6985;114;61;22;3;19;.864;3600000;0
46217;8000;105;53;3;0;3;1.000;325000;0
46217;8014;105;24;33;8;25;.758;3275000;0
46218;6968;115;67;45;4;41;.911;3588000;0
46218;7461;115;0;0;0;0;.00nan;0;0
46218;8529;117;0;0;0;0;.00nan;0;0
46218;8658;117;58;18;2;16;.889;3600000;0
46219;7512;113;49;26;4;22;.846;3550000;0
46219;7993;108;0;0;0;0;.00nan;0;0
46219;8056;108;55;18;2;16;.889;3600000;0
46219;8150;113;0;0;0;0;.00nan;0;0
46220;7466;119;0;0;0;0;.00nan;0;0
46220;8031;106;0;0;0;0;.00nan;0;0
46220;8038;119;77;48;4;44;.917;3600000;0
46220;8549;106;18;18;5;13;.722;3579000;0
46221;6993;120;0;0;0;0;.00nan;0;0
46221;7435;116;0;0;0;0;.00nan;0;0
46221;8057;120;75;36;3;33;.917;3600000;0
46221;8612;116;44;25;4;21;.840;3568000;0
46222;6373;114;29;30;6;24;.800;3600000;0
46222;6985;114;0;0;0;0;.00nan;0;0
46222;7003;122;75;32;3;29;.906;3600000;0
46222;7966;122;0;0;0;0;.00nan;0;0
46223;7562;112;22;18;5;13;.722;1232000;0
46223;8529;117;65;31;3;28;.903;3600000;0
46223;8614;112;12;18;6;12;.667;2368000;0
46223;8658;117;0;0;0;0;.00nan;0;0
46224;6967;121;60;21;2;19;.905;3600000;0
46224;6993;120;64;33;3;30;.909;3567000;0
46224;7425;121;0;0;0;0;.00nan;0;0
46224;8057;120;0;0;0;0;.00nan;0;0
46225;6908;111;0;0;0;0;.00nan;0;0
46225;6937;111;78;33;2;31;.939;3600000;0
46225;7562;112;0;0;0;0;.00nan;0;0
46225;8614;112;59;27;4;23;.852;3600000;0
46226;6961;110;53;22;3;19;.864;3600000;0
46226;7993;108;28;29;6;23;.793;2318000;0
46226;8056;108;43;15;3;12;.800;1282000;0
46226;8564;110;0;0;0;0;.00nan;0;0
46227;7003;122;62;14;1;13;.929;3600000;0
46227;7966;122;0;0;0;0;.00nan;0;0
46227;8111;118;0;0;0;0;.00nan;0;0
46227;8629;118;61;38;4;34;.895;3600000;0
46228;6968;115;0;0;0;0;.00nan;0;0
46228;7461;115;60;20;2;18;.900;3600000;0
46228;8111;118;57;40;5;35;.875;3600000;0
46228;8629;118;0;0;0;0;.00nan;0;0
46229;6967;121;0;0;0;0;.00nan;0;0
46229;7029;105;44;30;5;25;.833;3600000;0
46229;7425;121;55;22;2;20;.909;3600000;0
46229;8014;105;0;0;0;0;.00nan;0;0
46230;6993;120;69;29;2;27;.931;3600000;0
46230;7003;122;50;31;5;26;.839;3600000;0
46230;7966;122;0;0;0;0;.00nan;0;0
46230;8057;120;0;0;0;0;.00nan;0;0
46231;6373;114;55;35;5;30;.857;3592000;0
46231;6961;110;0;0;0;0;.00nan;0;0
46231;6985;114;0;0;0;0;.00nan;0;0
46231;8564;110;66;32;3;29;.906;3600000;0
46232;7512;113;28;7;3;4;.571;176000;0
46232;8031;106;40;21;4;17;.810;3600000;0
46232;8150;113;86;45;3;42;.933;3357000;0
46232;8549;106;0;0;0;0;.00nan;0;0
46233;6908;111;0;0;0;0;.00nan;0;0
46233;6937;111;72;38;3;35;.921;3900000;0
46233;7993;108;50;25;3;22;.880;3900000;0
46233;8056;108;0;0;0;0;.00nan;0;0
46234;7562;112;0;0;0;0;.00nan;0;0
46234;8037;107;0;0;0;0;.00nan;0;0
46234;8109;107;37;37;6;31;.838;3600000;0
46234;8614;112;100;31;0;31;1.000;3600000;0
46235;6373;114;0;0;0;0;.00nan;0;0
46235;6961;110;81;49;4;45;.918;3795000;0
46235;6985;114;81;31;3;28;.903;3743000;0
46235;8564;110;0;0;0;0;.00nan;0;0
46236;7012;109;43;12;3;9;.750;3600000;0
46236;7538;109;0;0;0;0;.00nan;0;0
46236;8037;107;0;0;0;0;.00nan;0;0
46236;8109;107;73;50;4;46;.920;3544000;0
46237;6993;120;27;21;5;16;.762;803000;0
46237;8057;120;77;40;3;37;.925;2797000;0
46237;8529;117;0;0;0;0;.00nan;0;0
46237;8658;117;65;17;1;16;.941;3600000;0
46238;6968;115;67;33;3;30;.909;3900000;0
46238;7461;115;0;0;0;0;.00nan;0;0
46238;7466;119;49;25;3;22;.880;3900000;0
46238;8038;119;0;0;0;0;.00nan;0;0
46239;7029;105;77;46;5;41;.891;3900000;0
46239;7435;116;38;22;5;17;.773;3900000;0
46239;8014;105;0;0;0;0;.00nan;0;0
46239;8108;116;0;0;0;0;.00nan;0;0
46240;6967;121;33;29;5;24;.828;3600000;0
46240;7003;122;0;0;0;0;.00nan;0;0
46240;7425;121;0;0;0;0;.00nan;0;0
46240;7966;122;33;32;6;26;.813;3600000;0
46241;7435;116;0;0;0;0;.00nan;0;0
46241;8108;116;44;19;3;16;.842;3600000;0
46241;8111;118;0;0;0;0;.00nan;0;0
46241;8629;118;75;59;6;53;.898;3600000;0
46242;7012;109;49;4;1;3;.750;344000;0
46242;7538;109;38;34;6;28;.824;3256000;0
46242;8031;106;0;0;0;0;.00nan;0;0
46242;8549;106;93;27;0;27;1.000;3600000;0
46243;6968;115;0;0;0;0;.00nan;0;0
46243;7461;115;85;45;3;42;.933;3600000;0
46243;8529;117;88;25;1;24;.960;3600000;0
46243;8658;117;0;0;0;0;.00nan;0;0
46244;7029;105;71;32;3;29;.906;3600000;0
46244;7466;119;0;0;0;0;.00nan;0;0
46244;8014;105;0;0;0;0;.00nan;0;0
46244;8038;119;51;31;4;27;.871;3600000;0
46245;6908;111;44;40;6;34;.850;3600000;0
46245;6937;111;0;0;0;0;.00nan;0;0
46245;7512;113;64;30;3;27;.900;3600000;0
46245;8150;113;0;0;0;0;.00nan;0;0
46246;7562;112;0;0;0;0;.00nan;0;0
46246;7993;108;0;0;0;0;.00nan;0;0
46246;8056;108;54;27;3;24;.889;3548000;0
46246;8614;112;76;34;2;32;.941;3600000;0
46247;6908;111;57;14;1;13;.929;944000;0
46247;6937;111;26;33;7;26;.788;2656000;0
46247;6961;110;30;19;5;14;.737;3600000;0
46247;8564;110;0;0;0;0;.00nan;0;0
46248;7012;109;98;45;1;44;.978;3600000;0
46248;7435;116;0;0;0;0;.00nan;0;0
46248;7538;109;0;0;0;0;.00nan;0;0
46248;8108;116;86;23;0;23;1.000;3600000;0
46249;6967;121;69;27;3;24;.889;3600000;0
46249;7425;121;0;0;0;0;.00nan;0;0
46249;7562;112;0;0;0;0;.00nan;0;0
46249;8614;112;64;50;6;44;.880;3600000;0
46250;6908;111;49;22;3;19;.864;3582000;0
46250;6937;111;0;0;0;0;.00nan;0;0
46250;7466;119;60;22;2;20;.909;3600000;0
46250;8038;119;0;0;0;0;.00nan;0;0
46251;8037;107;20;38;7;31;.816;3229000;0
46251;8109;107;29;7;3;4;.571;371000;0
46251;8529;117;64;19;1;18;.947;3600000;0
46251;8658;117;0;0;0;0;.00nan;0;0
46252;6373;114;56;23;3;20;.870;3600000;0
46252;6985;114;0;0;0;0;.00nan;0;0
46252;7512;113;74;54;6;48;.889;3600000;0
46252;8150;113;0;0;0;0;.00nan;0;0
46253;7003;122;52;34;5;29;.853;3836000;0
46253;7029;105;56;44;6;38;.864;3836000;0
46253;7966;122;0;0;0;0;.00nan;0;0
46253;8014;105;0;0;0;0;.00nan;0;0
46254;8111;118;58;7;0;7;1.000;398000;0
46254;8529;117;0;0;0;0;.00nan;0;0
46254;8629;118;55;48;7;41;.854;3202000;0
46254;8658;117;58;26;3;23;.885;3600000;0
46255;6967;121;0;0;0;0;.00nan;0;0
46255;7425;121;51;37;4;33;.892;3532000;0
46255;7993;108;95;41;2;39;.951;3600000;0
46255;8056;108;0;0;0;0;.00nan;0;0
46256;6961;110;0;0;0;0;.00nan;0;0
46256;7466;119;0;0;0;0;.00nan;0;0
46256;8038;119;64;36;5;31;.861;3579000;0
46256;8564;110;47;24;4;20;.833;3600000;0
46257;6993;120;37;12;3;9;.750;3600000;0
46257;8037;107;38;8;2;6;.750;467000;0
46257;8057;120;0;0;0;0;.00nan;0;0
46257;8109;107;47;39;7;32;.821;3133000;0
46258;7003;122;0;0;0;0;.00nan;0;0
46258;7435;116;0;0;0;0;.00nan;0;0
46258;7966;122;96;28;0;28;1.000;3600000;0
46258;8108;116;63;18;2;16;.889;3515000;0
46259;6373;114;0;0;0;0;.00nan;0;0
46259;6985;114;85;44;3;41;.932;3600000;0
46259;8031;106;0;0;0;0;.00nan;0;0
46259;8549;106;76;21;1;20;.952;3600000;0
46260;7012;109;0;0;0;0;.00nan;0;0
46260;7512;113;55;49;7;42;.857;3600000;0
46260;7538;109;51;23;3;20;.870;3600000;0
46260;8150;113;0;0;0;0;.00nan;0;0
46261;6967;121;90;37;2;35;.946;3600000;0
46261;6968;115;64;17;1;16;.941;2538000;0
46261;7425;121;0;0;0;0;.00nan;0;0
46261;7461;115;26;14;4;10;.714;1062000;0
46262;8037;107;0;0;0;0;.00nan;0;0
46262;8109;107;44;32;5;27;.844;3600000;0
46262;8111;118;79;35;2;33;.943;3600000;0
46262;8629;118;0;0;0;0;.00nan;0;0
46263;7029;105;76;38;3;35;.921;3574000;0
46263;7435;116;79;20;1;19;.950;3600000;0
46263;8014;105;0;0;0;0;.00nan;0;0
46263;8108;116;0;0;0;0;.00nan;0;0
46264;6908;111;0;0;0;0;.00nan;0;0
46264;6937;111;93;42;1;41;.976;3600000;0
46264;7562;112;0;0;0;0;.00nan;0;0
46264;8614;112;46;32;5;27;.844;3600000;0
46265;6373;114;73;26;2;24;.923;3600000;0
46265;6985;114;0;0;0;0;.00nan;0;0
46265;7466;119;66;41;4;37;.902;3600000;0
46265;8038;119;0;0;0;0;.00nan;0;0
46266;6968;115;0;0;0;0;.00nan;0;0
46266;7461;115;85;48;3;45;.938;3517000;0
46266;8031;106;80;21;1;20;.952;3600000;0
46266;8549;106;0;0;0;0;.00nan;0;0
46267;7003;122;0;0;0;0;.00nan;0;0
46267;7029;105;72;27;3;24;.889;3900000;0
46267;7966;122;39;15;3;12;.800;3900000;0
46267;8014;105;0;0;0;0;.00nan;0;0
46268;6993;120;81;36;2;34;.944;3600000;0
46268;8057;120;0;0;0;0;.00nan;0;0
46268;8529;117;0;0;0;0;.00nan;0;0
46268;8658;117;36;21;4;17;.810;3514000;0
46269;7012;109;79;42;3;39;.929;3600000;0
46269;7538;109;0;0;0;0;.00nan;0;0
46269;7993;108;0;0;0;0;.00nan;0;0
46269;8056;108;19;27;6;21;.778;3600000;0
46270;6961;110;24;21;6;15;.714;1981000;0
46270;7562;112;15;13;5;8;.615;990000;0
46270;8564;110;57;12;1;11;.917;1619000;0
46270;8614;112;49;43;6;37;.860;2610000;0
46271;6961;110;23;33;7;26;.788;3090000;0
46271;7435;116;0;0;0;0;.00nan;0;0
46271;8108;116;61;22;2;20;.909;3600000;0
46271;8564;110;52;4;0;4;1.000;510000;0
46272;6908;111;0;0;0;0;.00nan;0;0
46272;6937;111;60;39;5;34;.872;3709000;0
46272;6968;115;0;0;0;0;.00nan;0;0
46272;7461;115;17;22;6;16;.727;3709000;0
46273;6993;120;28;27;6;21;.778;2957000;0
46273;8038;119;0;0;0;0;.00nan;0;0
46273;8057;120;56;6;0;6;1.000;643000;0
46273;8703;119;48;12;2;10;.833;3600000;0
46274;6373;114;49;21;3;18;.857;3600000;0
46274;6985;114;0;0;0;0;.00nan;0;0
46274;7512;113;64;37;4;33;.892;3580000;0
46274;8150;113;0;0;0;0;.00nan;0;0
46275;7003;122;26;25;6;19;.760;3600000;0
46275;7966;122;0;0;0;0;.00nan;0;0
46275;7993;108;21;10;4;6;.600;733000;0
46275;8056;108;21;30;7;23;.767;2867000;0
46276;6961;110;51;26;3;23;.885;3290000;0
46276;6993;120;0;0;0;0;.00nan;0;0
46276;8057;120;35;40;6;34;.850;3900000;0
46276;8564;110;31;8;3;5;.625;587000;0
46277;7012;109;0;0;0;0;.00nan;0;0
46277;7538;109;11;25;7;18;.720;3572000;0
46277;8111;118;0;0;0;0;.00nan;0;0
46277;8629;118;59;39;5;34;.872;3600000;0
46278;7993;108;70;40;4;36;.900;3600000;0
46278;8031;106;71;27;2;25;.926;3600000;0
46278;8056;108;0;0;0;0;.00nan;0;0
46278;8549;106;0;0;0;0;.00nan;0;0
46279;6967;121;77;51;5;46;.902;3600000;0
46279;7425;121;0;0;0;0;.00nan;0;0
46279;7435;116;86;39;2;37;.949;3600000;0
46279;8108;116;0;0;0;0;.00nan;0;0
46280;7029;105;33;18;4;14;.778;3854000;0
46280;8014;105;0;0;0;0;.00nan;0;0
46280;8037;107;0;0;0;0;.00nan;0;0
46280;8109;107;56;35;5;30;.857;3854000;0
46281;6968;115;81;37;3;34;.919;3600000;0
46281;7461;115;0;0;0;0;.00nan;0;0
46281;7512;113;66;9;0;9;1.000;1163000;0
46281;8150;113;11;19;6;13;.684;2437000;0
46282;7003;122;0;0;0;0;.00nan;0;0
46282;7466;112;88;51;4;47;.922;3548000;0
46282;7562;112;0;0;0;0;.00nan;0;0
46282;7966;122;67;29;3;26;.897;3600000;0
46283;6961;110;0;0;0;0;.00nan;0;0
46283;8111;118;84;42;4;38;.905;3600000;0
46283;8564;110;77;30;1;29;.967;3600000;0
46283;8629;118;0;0;0;0;.00nan;0;0
46284;7012;109;81;33;2;31;.939;3600000;0
46284;7538;109;0;0;0;0;.00nan;0;0
46284;8038;119;42;16;3;13;.813;3561000;0
46284;8703;119;0;0;0;0;.00nan;0;0
46285;6373;114;80;24;1;23;.958;3600000;0
46285;6908;111;0;0;0;0;.00nan;0;0
46285;6937;111;90;55;2;53;.964;3557000;0
46285;6985;114;0;0;0;0;.00nan;0;0
46286;6967;121;0;0;0;0;.00nan;0;0
46286;7425;121;78;41;4;37;.902;3600000;0
46286;8529;117;50;21;3;18;.857;3600000;0
46286;8658;117;0;0;0;0;.00nan;0;0
46287;6993;120;32;9;3;6;.667;566000;0
46287;7012;109;69;22;1;21;.955;1288000;0
46287;7538;109;24;27;6;21;.778;2284000;0
46287;8057;120;54;21;2;19;.905;3034000;0
46288;6373;114;0;0;0;0;.00nan;0;0
46288;6968;115;0;0;0;0;.00nan;0;0
46288;6985;114;66;14;1;13;.929;3600000;0
46288;7461;115;73;45;4;41;.911;3600000;0
46289;7029;105;81;20;1;19;.950;3600000;0
46289;7466;112;83;39;2;37;.949;3600000;0
46289;7562;112;0;0;0;0;.00nan;0;0
46289;8014;105;0;0;0;0;.00nan;0;0
46290;7435;116;0;0;0;0;.00nan;0;0
46290;8108;116;72;26;2;24;.923;3600000;0
46290;8529;117;0;0;0;0;.00nan;0;0
46290;8658;117;48;37;5;32;.865;3599000;0
46291;7512;113;34;35;6;29;.829;2214000;0
46291;8031;106;12;23;7;16;.696;2160000;0
46291;8150;113;79;23;1;22;.957;1686000;0
46291;8549;106;66;3;0;3;1.000;1740000;0
46292;7003;122;48;9;2;7;.778;3600000;0
46292;7966;122;0;0;0;0;.00nan;0;0
46292;8037;107;20;9;4;5;.556;458000;0
46292;8109;107;47;42;6;36;.857;3142000;0
46293;6373;114;54;20;3;17;.850;3600000;0
46293;6908;111;42;4;1;3;.750;664000;0
46293;6937;111;35;36;6;30;.833;2936000;0
46293;6985;114;0;0;0;0;.00nan;0;0
46294;6993;120;83;38;3;35;.921;3600000;0
46294;7435;116;0;0;0;0;.00nan;0;0
46294;8057;120;0;0;0;0;.00nan;0;0
46294;8108;116;90;22;0;22;1.000;3600000;0
46295;7512;113;81;47;4;43;.915;3600000;0
46295;7993;108;61;28;3;25;.893;3600000;0
46295;8056;108;0;0;0;0;.00nan;0;0
46295;8150;113;0;0;0;0;.00nan;0;0
46296;6967;121;93;41;2;39;.951;3900000;0
46296;7425;121;0;0;0;0;.00nan;0;0
46296;8038;119;0;0;0;0;.00nan;0;0
46296;8703;119;75;25;2;23;.920;3900000;0
46297;6908;111;0;0;0;0;.00nan;0;0
46297;6937;111;95;41;2;39;.951;3599000;0
46297;8529;117;62;14;1;13;.929;3600000;0
46297;8658;117;0;0;0;0;.00nan;0;0
46298;7029;105;74;29;2;27;.931;3600000;0
46298;8014;105;0;0;0;0;.00nan;0;0
46298;8037;107;0;0;0;0;.00nan;0;0
46298;8109;107;41;37;6;31;.838;3600000;0
46299;7012;109;0;0;0;0;.00nan;0;0
46299;7466;112;80;29;1;28;.966;3600000;0
46299;7538;109;30;32;6;26;.813;3600000;0
46299;7562;112;0;0;0;0;.00nan;0;0
46300;7012;109;84;36;3;33;.917;3600000;0
46300;7466;112;0;0;0;0;.00nan;0;0
46300;7538;109;0;0;0;0;.00nan;0;0
46300;7562;112;45;29;4;25;.862;3600000;0
46301;6967;121;42;30;5;25;.833;3600000;0
46301;7425;121;0;0;0;0;.00nan;0;0
46301;8038;119;70;25;2;23;.920;3600000;0
46301;8703;119;0;0;0;0;.00nan;0;0
46302;6908;111;64;39;5;34;.872;3600000;0
46302;6937;111;0;0;0;0;.00nan;0;0
46302;7435;116;0;0;0;0;.00nan;0;0
46302;8108;116;57;12;1;11;.917;3600000;0
46303;6993;120;73;22;1;21;.955;3600000;0
46303;8031;106;82;36;2;34;.944;3582000;0
46303;8057;120;0;0;0;0;.00nan;0;0
46303;8549;106;0;0;0;0;.00nan;0;0
46304;7003;122;59;15;1;14;.933;3600000;0
46304;7966;122;0;0;0;0;.00nan;0;0
46304;8037;107;0;0;0;0;.00nan;0;0
46304;8109;107;84;34;2;32;.941;3590000;0
46305;6961;110;62;28;3;25;.893;3600000;0
46305;6968;115;0;0;0;0;.00nan;0;0
46305;7461;115;78;52;5;47;.904;3587000;0
46305;8564;110;0;0;0;0;.00nan;0;0
46306;7029;105;0;0;0;0;.00nan;0;0
46306;7512;113;36;21;4;17;.810;3555000;0
46306;8014;105;63;23;2;21;.913;3600000;0
46306;8150;113;0;0;0;0;.00nan;0;0
46307;6373;114;94;23;0;23;1.000;3600000;0
46307;6985;114;0;0;0;0;.00nan;0;0
46307;7993;108;67;33;3;30;.909;3600000;0
46307;8056;108;0;0;0;0;.00nan;0;0
46308;6993;120;0;0;0;0;.00nan;0;0
46308;8057;120;46;26;4;22;.846;3600000;0
46308;8111;118;0;0;0;0;.00nan;0;0
46308;8629;118;62;48;5;43;.896;3600000;0
46309;7435;116;100;19;0;19;1.000;3600000;0
46309;8038;119;0;0;0;0;.00nan;0;0
46309;8108;116;0;0;0;0;.00nan;0;0
46309;8703;119;57;34;3;31;.912;3600000;0
46310;8031;106;31;16;4;12;.750;2404000;0
46310;8529;117;53;24;3;21;.875;3012000;0
46310;8549;106;21;11;4;7;.636;1158000;0
46310;8658;117;28;8;3;5;.625;588000;0
46311;7003;122;0;0;0;0;.00nan;0;0
46311;7512;113;0;0;0;0;.00nan;0;0
46311;7966;122;63;23;2;21;.913;3600000;0
46311;8150;113;65;52;6;46;.885;3600000;0
46312;6961;110;0;0;0;0;.00nan;0;0
46312;6968;115;98;61;4;57;.934;3600000;0
46312;7461;115;0;0;0;0;.00nan;0;0
46312;8564;110;79;13;0;13;1.000;3600000;0
46313;7012;109;0;0;0;0;.00nan;0;0
46313;7029;105;81;29;1;28;.966;3600000;0
46313;7538;109;42;31;5;26;.839;3600000;0
46313;8014;105;0;0;0;0;.00nan;0;0
46314;6908;111;0;0;0;0;.00nan;0;0
46314;6937;111;67;42;4;38;.905;3900000;0
46314;6967;121;0;0;0;0;.00nan;0;0
46314;7425;121;79;39;4;35;.897;3886000;0
46315;8031;106;0;0;0;0;.00nan;0;0
46315;8111;118;47;23;4;19;.826;2352000;0
46315;8549;106;48;19;3;16;.842;3600000;0
46315;8629;118;44;13;2;11;.846;1248000;0
46316;6373;114;78;27;1;26;.963;3600000;0
46316;6985;114;0;0;0;0;.00nan;0;0
46316;7993;108;0;0;0;0;.00nan;0;0
46316;8056;108;52;40;5;35;.875;3600000;0
46317;7466;112;43;17;3;14;.824;3600000;0
46317;7562;112;0;0;0;0;.00nan;0;0
46317;8037;107;0;0;0;0;.00nan;0;0
46317;8109;107;74;43;4;39;.907;3600000;0
46318;6373;114;61;21;2;19;.905;3600000;0
46318;6967;121;39;37;6;31;.838;3347000;0
46318;6985;114;0;0;0;0;.00nan;0;0
46318;7425;121;50;1;0;1;1.000;253000;0
46319;8037;107;0;0;0;0;.00nan;0;0
46319;8038;119;0;0;0;0;.00nan;0;0
46319;8109;107;72;46;4;42;.913;3600000;0
46319;8703;119;87;19;0;19;1.000;3600000;0
46320;7435;116;74;23;1;22;.957;3600000;0
46320;8108;116;0;0;0;0;.00nan;0;0
46320;8111;118;32;26;5;21;.808;1445000;0
46320;8629;118;25;29;6;23;.793;2155000;0
46321;6993;120;100;28;0;28;1.000;3600000;0
46321;7012;109;0;0;0;0;.00nan;0;0
46321;7538;109;68;31;3;28;.903;3600000;0
46321;8057;120;0;0;0;0;.00nan;0;0
46322;6968;115;73;56;6;50;.893;3569000;0
46322;7461;115;0;0;0;0;.00nan;0;0
46322;7993;108;18;23;6;17;.739;3600000;0
46322;8056;108;0;0;0;0;.00nan;0;0
46323;6961;110;0;0;0;0;.00nan;0;0
46323;7466;112;61;32;4;28;.875;3900000;0
46323;7562;112;0;0;0;0;.00nan;0;0
46323;8564;110;66;39;4;35;.897;3900000;0
46324;6961;110;64;31;3;28;.903;3664000;0
46324;6967;121;69;27;2;25;.926;3664000;0
46324;7425;121;0;0;0;0;.00nan;0;0
46324;8564;110;0;0;0;0;.00nan;0;0
46325;7003;122;40;15;3;12;.800;3600000;0
46325;7966;122;0;0;0;0;.00nan;0;0
46325;8038;119;0;0;0;0;.00nan;0;0
46325;8703;119;41;44;8;36;.818;3600000;0
46326;8031;106;42;14;3;11;.786;3600000;0
46326;8037;107;0;0;0;0;.00nan;0;0
46326;8109;107;94;50;4;46;.920;3600000;0
46326;8549;106;0;0;0;0;.00nan;0;0
46327;6993;120;44;22;4;18;.818;3593000;0
46327;7029;105;59;32;3;29;.906;3600000;0
46327;8014;105;0;0;0;0;.00nan;0;0
46327;8057;120;0;0;0;0;.00nan;0;0
46328;6373;114;80;11;0;11;1.000;3600000;0
46328;6968;115;20;35;7;28;.800;2884000;0
46328;6985;114;0;0;0;0;.00nan;0;0
46328;7461;115;60;8;0;8;1.000;716000;0
46329;7435;116;0;0;0;0;.00nan;0;0
46329;8108;116;68;35;4;31;.886;3600000;0
46329;8529;117;0;0;0;0;.00nan;0;0
46329;8658;117;20;28;6;22;.786;3600000;0
46330;7012;109;66;7;0;7;1.000;1362000;0
46330;7512;113;39;33;6;27;.818;3600000;0
46330;7538;109;58;8;0;8;1.000;2238000;0
46330;8150;113;0;0;0;0;.00nan;0;0
46331;6908;111;0;0;0;0;.00nan;0;0
46331;6937;111;70;39;4;35;.897;3600000;0
46331;6967;121;53;3;0;3;1.000;298000;0
46331;7425;121;37;34;7;27;.794;3302000;0
46332;7029;105;0;0;0;0;.00nan;0;0
46332;8014;105;57;27;3;24;.889;3600000;0
46332;8038;119;40;29;5;24;.828;3533000;0
46332;8703;119;0;0;0;0;.00nan;0;0
46333;7993;108;0;0;0;0;.00nan;0;0
46333;8031;106;0;0;0;0;.00nan;0;0
46333;8056;108;78;32;2;30;.938;3600000;0
46333;8549;106;56;38;4;34;.895;3521000;0
46334;6993;120;0;0;0;0;.00nan;0;0
46334;7003;122;0;0;0;0;.00nan;0;0
46334;7966;122;57;17;2;15;.882;3600000;0
46334;8057;120;74;35;4;31;.886;3556000;0
46335;6373;114;57;31;4;27;.871;3600000;0
46335;6985;114;0;0;0;0;.00nan;0;0
46335;8111;118;27;17;4;13;.765;595000;0
46335;8629;118;28;31;6;25;.806;3005000;0
46336;7435;116;35;24;5;19;.792;3600000;0
46336;8108;116;0;0;0;0;.00nan;0;0
46336;8529;117;30;32;6;26;.813;2282000;0
46336;8658;117;64;15;1;14;.933;1233000;0
46337;7466;112;50;31;4;27;.871;3551000;0
46337;7512;113;0;0;0;0;.00nan;0;0
46337;7562;112;0;0;0;0;.00nan;0;0
46337;8150;113;81;40;3;37;.925;3600000;0
46338;6908;111;61;42;5;37;.881;3600000;0
46338;6937;111;0;0;0;0;.00nan;0;0
46338;6961;110;58;19;2;17;.895;3600000;0
46338;8564;110;0;0;0;0;.00nan;0;0
46339;7538;109;27;21;5;16;.762;3600000;0
46339;8037;107;0;0;0;0;.00nan;0;0
46339;8109;107;93;41;2;39;.951;3600000;0
46339;8626;109;0;0;0;0;.00nan;0;0
46340;6968;115;23;29;6;23;.793;2360000;0
46340;7461;115;63;12;1;11;.917;1155000;0
46340;7993;108;30;16;5;11;.688;3600000;0
46340;8056;108;0;0;0;0;.00nan;0;0
46341;7538;109;66;41;5;36;.878;3574000;0
46341;8031;106;60;21;3;18;.857;3600000;0
46341;8549;106;0;0;0;0;.00nan;0;0
46341;8626;109;0;0;0;0;.00nan;0;0
46342;6968;115;68;47;5;42;.894;3553000;0
46342;7461;115;0;0;0;0;.00nan;0;0
46342;7466;112;42;23;4;19;.826;3600000;0
46342;7562;112;0;0;0;0;.00nan;0;0
46343;6961;110;0;0;0;0;.00nan;0;0
46343;7512;113;36;37;6;31;.838;3087000;0
46343;8150;113;34;4;2;2;.500;513000;0
46343;8564;110;53;25;3;22;.880;3600000;0
46344;7993;108;32;19;4;15;.789;1631000;0
46344;8037;107;39;37;6;31;.838;3054000;0
46344;8056;108;36;15;3;12;.800;1969000;0
46344;8109;107;28;10;3;7;.700;546000;0
46345;8038;119;0;0;0;0;.00nan;0;0
46345;8111;118;0;0;0;0;.00nan;0;0
46345;8629;118;59;37;4;33;.892;3600000;0
46345;8703;119;85;34;1;33;.971;3600000;0
46346;6967;121;72;30;2;28;.933;3600000;0
46346;7425;121;0;0;0;0;.00nan;0;0
46346;8529;117;46;35;4;31;.886;3542000;0
46346;8658;117;0;0;0;0;.00nan;0;0
46347;7003;122;0;0;0;0;.00nan;0;0
46347;7435;116;0;0;0;0;.00nan;0;0
46347;7966;122;27;21;5;16;.762;3600000;0
46347;8108;116;88;30;1;29;.967;3600000;0
46348;6961;110;58;13;1;12;.923;3600000;0
46348;6968;115;70;44;4;40;.909;3600000;0
46348;7461;115;0;0;0;0;.00nan;0;0
46348;8564;110;0;0;0;0;.00nan;0;0
46349;6908;111;0;0;0;0;.00nan;0;0
46349;6937;111;51;26;4;22;.846;3600000;0
46349;7538;109;20;36;8;28;.778;3600000;0
46349;8626;109;0;0;0;0;.00nan;0;0
46350;7466;112;38;24;4;20;.833;3550000;0
46350;7562;112;0;0;0;0;.00nan;0;0
46350;8037;107;0;0;0;0;.00nan;0;0
46350;8109;107;60;31;3;28;.903;3600000;0
46351;6967;121;0;0;0;0;.00nan;0;0
46351;7425;121;60;33;3;30;.909;3529000;0
46351;7435;116;0;0;0;0;.00nan;0;0
46351;8108;116;70;18;1;17;.944;3600000;0
46352;6373;114;79;17;1;16;.941;3600000;0
46352;6985;114;0;0;0;0;.00nan;0;0
46352;7512;113;85;57;4;53;.930;3600000;0
46352;8150;113;0;0;0;0;.00nan;0;0
46353;6993;120;60;16;2;14;.875;3600000;0
46353;7029;105;37;35;6;29;.829;2678000;0
46353;8014;105;59;14;1;13;.929;922000;0
46353;8057;120;0;0;0;0;.00nan;0;0
46354;7993;108;49;37;5;32;.865;3600000;0
46354;8031;106;88;32;2;30;.938;3600000;0
46354;8056;108;0;0;0;0;.00nan;0;0
46354;8549;106;0;0;0;0;.00nan;0;0
46355;7003;122;75;22;1;21;.955;3600000;0
46355;7966;122;0;0;0;0;.00nan;0;0
46355;8038;119;74;42;3;39;.929;3513000;0
46355;8703;119;0;0;0;0;.00nan;0;0
46356;6961;110;0;0;0;0;.00nan;0;0
46356;7512;113;0;0;0;0;.00nan;0;0
46356;8150;113;72;38;3;35;.921;3564000;0
46356;8564;110;80;26;2;24;.923;3600000;0
46357;6908;111;45;6;1;5;.833;821000;0
46357;6937;111;33;45;8;37;.822;2779000;0
46357;7466;112;0;0;0;0;.00nan;0;0
46357;7562;112;70;30;2;28;.933;3600000;0
46358;6968;115;0;0;0;0;.00nan;0;0
46358;7461;115;31;36;7;29;.806;3600000;0
46358;8037;107;0;0;0;0;.00nan;0;0
46358;8109;107;69;23;3;20;.870;3600000;0
46359;7029;105;100;27;0;27;1.000;3600000;0
46359;8014;105;0;0;0;0;.00nan;0;0
46359;8111;118;26;28;6;22;.786;2315000;0
46359;8629;118;44;12;2;10;.833;1285000;0
46360;7003;122;61;19;1;18;.947;2457000;0
46360;7966;122;13;13;5;8;.615;1104000;0
46360;8529;117;0;0;0;0;.00nan;0;0
46360;8658;117;60;35;4;31;.886;3600000;0
46361;6373;114;0;0;0;0;.00nan;0;0
46361;6985;114;59;25;3;22;.880;3600000;0
46361;8111;118;54;43;6;37;.860;3600000;0
46361;8629;118;0;0;0;0;.00nan;0;0
46362;7538;109;48;32;5;27;.844;2034000;0
46362;7993;108;40;3;1;2;.667;588000;0
46362;8056;108;27;28;6;22;.786;2958000;0
46362;8626;109;54;14;1;13;.929;1566000;0
46363;6967;121;86;35;2;33;.943;3900000;0
46363;7425;121;0;0;0;0;.00nan;0;0
46363;8038;119;0;0;0;0;.00nan;0;0
46363;8703;119;70;35;2;33;.943;3900000;0
46364;6908;111;0;0;0;0;.00nan;0;0
46364;6937;111;66;50;5;45;.900;3600000;0
46364;8031;106;0;0;0;0;.00nan;0;0
46364;8549;106;71;10;0;10;1.000;3600000;0
46365;6993;120;89;45;3;42;.933;3600000;0
46365;7435;116;0;0;0;0;.00nan;0;0
46365;8057;120;0;0;0;0;.00nan;0;0
46365;8108;116;30;26;5;21;.808;3565000;0
46366;7029;105;51;41;6;35;.854;3600000;0
46366;8014;105;0;0;0;0;.00nan;0;0
46366;8529;117;77;25;1;24;.960;3600000;0
46366;8658;117;0;0;0;0;.00nan;0;0
46367;7512;113;82;31;2;29;.935;3600000;0
46367;8031;106;0;0;0;0;.00nan;0;0
46367;8150;113;0;0;0;0;.00nan;0;0
46367;8549;106;40;26;4;22;.846;3569000;0
46368;6908;111;0;0;0;0;.00nan;0;0
46368;6937;111;68;45;5;40;.889;3669000;0
46368;8111;118;0;0;0;0;.00nan;0;0
46368;8629;118;53;26;4;22;.846;3669000;0
46369;6373;114;44;27;5;22;.815;3600000;0
46369;6985;114;0;0;0;0;.00nan;0;0
46369;7435;116;0;0;0;0;.00nan;0;0
46369;8108;116;25;36;7;29;.806;3600000;0
46370;7003;122;61;41;5;36;.878;3612000;0
46370;7966;122;0;0;0;0;.00nan;0;0
46370;7993;108;39;32;6;26;.813;3612000;0
46370;8056;108;0;0;0;0;.00nan;0;0
46371;6961;110;67;17;1;16;.941;3600000;0
46371;8111;118;31;8;3;5;.625;473000;0
46371;8564;110;0;0;0;0;.00nan;0;0
46371;8629;118;80;40;3;37;.925;3127000;0
46372;7029;105;36;29;5;24;.828;3568000;0
46372;7993;108;0;0;0;0;.00nan;0;0
46372;8014;105;0;0;0;0;.00nan;0;0
46372;8056;108;47;24;4;20;.833;3600000;0
46373;7538;109;0;0;0;0;.00nan;0;0
46373;8031;106;37;20;4;16;.800;3900000;0
46373;8549;106;0;0;0;0;.00nan;0;0
46373;8626;109;80;42;4;38;.905;3900000;0
46374;6908;111;0;0;0;0;.00nan;0;0
46374;6937;111;67;50;6;44;.880;3600000;0
46374;7435;116;0;0;0;0;.00nan;0;0
46374;8108;116;51;16;2;14;.875;3600000;0
46375;6968;115;0;0;0;0;.00nan;0;0
46375;7003;122;79;14;0;14;1.000;3600000;0
46375;7461;115;59;52;7;45;.865;3600000;0
46375;7966;122;0;0;0;0;.00nan;0;0
46376;6373;114;85;24;1;23;.958;3600000;0
46376;6985;114;0;0;0;0;.00nan;0;0
46376;8037;107;0;0;0;0;.00nan;0;0
46376;8109;107;34;45;7;38;.844;3600000;0
46377;7512;113;6;12;6;6;.500;872000;0
46377;8150;113;41;25;4;21;.840;2728000;0
46377;8529;117;63;21;2;19;.905;3600000;0
46377;8658;117;0;0;0;0;.00nan;0;0
46378;7466;112;54;20;3;17;.850;3600000;0
46378;7562;112;0;0;0;0;.00nan;0;0
46378;8038;119;0;0;0;0;.00nan;0;0
46378;8703;119;45;31;5;26;.839;3579000;0
46379;6967;121;29;26;6;20;.769;3090000;0
46379;7425;121;40;2;1;1;.500;510000;0
46379;8038;119;69;31;3;28;.903;3600000;0
46379;8703;119;0;0;0;0;.00nan;0;0
46380;6961;110;63;32;3;29;.906;3600000;0
46380;7435;116;33;32;6;26;.813;3600000;0
46380;8108;116;0;0;0;0;.00nan;0;0
46380;8564;110;0;0;0;0;.00nan;0;0
46381;6968;115;63;30;3;27;.900;3600000;0
46381;7029;105;51;30;4;26;.867;3567000;0
46381;7461;115;0;0;0;0;.00nan;0;0
46381;8014;105;0;0;0;0;.00nan;0;0
46382;6373;114;0;0;0;0;.00nan;0;0
46382;6985;114;59;11;1;10;.909;3600000;0
46382;8037;107;23;44;8;36;.818;3600000;0
46382;8109;107;0;0;0;0;.00nan;0;0
46383;8031;106;0;0;0;0;.00nan;0;0
46383;8529;117;0;0;0;0;.00nan;0;0
46383;8549;106;75;33;2;31;.939;3600000;0
46383;8658;117;39;32;5;27;.844;3600000;0
46384;7512;113;67;26;2;24;.923;3600000;0
46384;7993;108;72;37;3;34;.919;3600000;0
46384;8056;108;0;0;0;0;.00nan;0;0
46384;8150;113;0;0;0;0;.00nan;0;0
46385;7466;112;57;14;1;13;.929;3036000;0
46385;7562;112;28;6;3;3;.500;564000;0
46385;8057;120;0;0;0;0;.00nan;0;0
46385;8590;120;54;38;5;33;.868;3580000;0
46386;6967;121;0;0;0;0;.00nan;0;0
46386;7425;121;62;37;3;34;.919;3600000;0
46386;8057;120;0;0;0;0;.00nan;0;0
46386;8590;120;40;31;5;26;.839;3574000;0
46387;6908;111;64;43;5;38;.884;3588000;0
46387;6937;111;0;0;0;0;.00nan;0;0
46387;6961;110;0;0;0;0;.00nan;0;0
46387;8564;110;64;28;3;25;.893;3600000;0
46388;8031;106;73;19;1;18;.947;3600000;0
46388;8037;107;0;0;0;0;.00nan;0;0
46388;8109;107;70;36;4;32;.889;3600000;0
46388;8549;106;0;0;0;0;.00nan;0;0
46389;6968;115;0;0;0;0;.00nan;0;0
46389;7003;122;59;15;2;13;.867;3600000;0
46389;7461;115;75;39;3;36;.923;3600000;0
46389;7966;122;0;0;0;0;.00nan;0;0
46390;7538;109;54;50;6;44;.880;3600000;0
46390;8529;117;50;31;4;27;.871;3600000;0
46390;8626;109;0;0;0;0;.00nan;0;0
46390;8658;117;0;0;0;0;.00nan;0;0
46391;7466;112;0;0;0;0;.00nan;0;0
46391;7562;112;55;24;3;21;.875;3600000;0
46391;8111;118;0;0;0;0;.00nan;0;0
46391;8629;118;62;47;5;42;.894;3544000;0
46392;7538;109;57;35;5;30;.857;3600000;0
46392;8529;117;16;28;6;22;.786;2823000;0
46392;8626;109;0;0;0;0;.00nan;0;0
46392;8658;117;56;7;0;7;1.000;721000;0
46393;7466;112;67;35;4;31;.886;3600000;0
46393;7512;113;75;43;3;40;.930;3600000;0
46393;7562;112;0;0;0;0;.00nan;0;0
46393;8150;113;0;0;0;0;.00nan;0;0
46394;8057;120;0;0;0;0;.00nan;0;0
46394;8111;118;0;0;0;0;.00nan;0;0
46394;8590;120;84;38;3;35;.921;3600000;0
46394;8629;118;36;37;7;30;.811;3600000;0
46395;7435;116;0;0;0;0;.00nan;0;0
46395;7538;109;72;35;2;33;.943;2490000;0
46395;8108;116;49;19;3;16;.842;3600000;0
46395;8626;109;26;16;4;12;.750;1110000;0
46396;6967;121;32;26;5;21;.808;3545000;0
46396;7425;121;0;0;0;0;.00nan;0;0
46396;8037;107;0;0;0;0;.00nan;0;0
46396;8109;107;59;37;4;33;.892;3600000;0
46397;7029;105;13;20;6;14;.700;1450000;0
46397;8014;105;97;30;0;30;1.000;2150000;0
46397;8031;106;0;0;0;0;.00nan;0;0
46397;8549;106;69;20;1;19;.950;3600000;0
46398;6373;114;53;20;3;17;.850;3600000;0
46398;6985;114;0;0;0;0;.00nan;0;0
46398;7993;108;56;39;6;33;.846;3174000;0
46398;8056;108;43;4;1;3;.750;426000;0
46399;8038;119;0;0;0;0;.00nan;0;0
46399;8111;118;0;0;0;0;.00nan;0;0
46399;8629;118;69;49;5;44;.898;3900000;0
46399;8703;119;54;40;5;35;.875;3900000;0
46400;8057;120;100;34;0;34;1.000;3600000;0
46400;8529;117;0;0;0;0;.00nan;0;0
46400;8590;120;0;0;0;0;.00nan;0;0
46400;8658;117;70;37;3;34;.919;3600000;0
46401;6968;115;0;0;0;0;.00nan;0;0
46401;7003;122;0;0;0;0;.00nan;0;0
46401;7461;115;88;55;5;50;.909;3600000;0
46401;7966;122;50;13;2;11;.846;3600000;0
46402;6967;121;0;0;0;0;.00nan;0;0
46402;7425;121;67;41;4;37;.902;3900000;0
46402;7538;109;55;35;4;31;.886;3900000;0
46402;8626;109;0;0;0;0;.00nan;0;0
46403;6908;111;40;17;3;14;.824;1442000;0
46403;6937;111;17;27;7;20;.741;2158000;0
46403;8031;106;0;0;0;0;.00nan;0;0
46403;8549;106;38;15;3;12;.800;3600000;0
46404;7435;116;61;21;2;19;.905;3600000;0
46404;8037;107;51;8;1;7;.875;435000;0
46404;8108;116;0;0;0;0;.00nan;0;0
46404;8109;107;58;44;6;38;.864;3165000;0
46405;7029;105;35;27;6;21;.778;1716000;0
46405;7466;112;61;25;3;22;.880;3600000;0
46405;7562;112;0;0;0;0;.00nan;0;0
46405;8014;105;55;12;1;11;.917;1884000;0
46406;6968;115;82;40;3;37;.925;3900000;0
46406;7461;115;0;0;0;0;.00nan;0;0
46406;7512;113;70;32;3;29;.906;3900000;0
46406;8150;113;0;0;0;0;.00nan;0;0
46407;6961;110;53;35;5;30;.857;3600000;0
46407;7993;108;55;7;0;7;1.000;1102000;0
46407;8056;108;11;26;7;19;.731;2498000;0
46407;8564;110;0;0;0;0;.00nan;0;0
46408;6373;114;64;35;5;30;.857;3900000;0
46408;6985;114;0;0;0;0;.00nan;0;0
46408;7003;122;57;39;5;34;.872;3900000;0
46408;7966;122;0;0;0;0;.00nan;0;0
46409;8111;118;49;16;2;14;.875;1447000;0
46409;8529;117;57;23;2;21;.913;3600000;0
46409;8629;118;28;32;6;26;.813;2153000;0
46409;8658;117;0;0;0;0;.00nan;0;0
46410;6961;110;0;0;0;0;.00nan;0;0
46410;8031;106;38;31;5;26;.839;3600000;0
46410;8549;106;0;0;0;0;.00nan;0;0
46410;8564;110;79;32;2;30;.938;3600000;0
46411;8037;107;38;50;8;42;.840;3600000;0
46411;8038;119;0;0;0;0;.00nan;0;0
46411;8109;107;0;0;0;0;.00nan;0;0
46411;8703;119;66;16;2;14;.875;3600000;0
46412;6967;121;27;36;7;29;.806;3600000;0
46412;7425;121;0;0;0;0;.00nan;0;0
46412;8057;120;0;0;0;0;.00nan;0;0
46412;8590;120;34;24;4;20;.833;3600000;0
46413;7029;105;96;47;2;45;.957;3900000;0
46413;7512;113;0;0;0;0;.00nan;0;0
46413;8014;105;0;0;0;0;.00nan;0;0
46413;8150;113;57;20;2;18;.900;3900000;0
46414;6908;111;0;0;0;0;.00nan;0;0
46414;6937;111;56;38;5;33;.868;3563000;0
46414;7993;108;35;21;4;17;.810;3600000;0
46414;8056;108;0;0;0;0;.00nan;0;0
46415;6373;114;70;30;3;27;.900;3600000;0
46415;6985;114;0;0;0;0;.00nan;0;0
46415;7003;122;0;0;0;0;.00nan;0;0
46415;7966;122;42;35;5;30;.857;3574000;0
46416;6961;110;83;33;2;31;.939;3600000;0
46416;7512;113;77;37;3;34;.919;3600000;0
46416;8150;113;0;0;0;0;.00nan;0;0
46416;8564;110;0;0;0;0;.00nan;0;0
46417;7435;116;0;0;0;0;.00nan;0;0
46417;8057;120;72;17;0;17;1.000;631000;0
46417;8108;116;46;18;3;15;.833;3600000;0
46417;8590;120;18;26;7;19;.731;2969000;0
46418;6967;121;26;29;6;23;.793;1873000;0
46418;7425;121;61;11;0;11;1.000;1995000;0
46418;8529;117;30;32;6;26;.813;3900000;0
46418;8658;117;0;0;0;0;.00nan;0;0
46419;8057;120;43;17;3;14;.824;1141000;0
46419;8111;118;72;17;1;16;.941;1649000;0
46419;8590;120;33;30;6;24;.800;2454000;0
46419;8629;118;4;13;6;7;.538;1951000;0
46420;6961;110;0;0;0;0;.00nan;0;0
46420;8037;107;0;0;0;0;.00nan;0;0
46420;8109;107;92;57;2;55;.965;3707000;0
46420;8564;110;53;21;3;18;.857;3707000;0
46421;6967;121;91;41;2;39;.951;3600000;0
46421;7425;121;0;0;0;0;.00nan;0;0
46421;8529;117;71;20;0;20;1.000;3239000;0
46421;8658;117;24;5;3;2;.400;358000;0
46422;7435;116;64;35;3;32;.914;3600000;0
46422;8038;119;0;0;0;0;.00nan;0;0
46422;8108;116;0;0;0;0;.00nan;0;0
46422;8703;119;52;37;5;32;.865;3593000;0
46423;6908;111;0;0;0;0;.00nan;0;0
46423;6937;111;57;25;3;22;.880;3600000;0
46423;6968;115;0;0;0;0;.00nan;0;0
46423;7461;115;38;21;4;17;.810;3555000;0
46424;7003;122;77;34;2;32;.941;3900000;0
46424;7966;122;0;0;0;0;.00nan;0;0
46424;8031;106;0;0;0;0;.00nan;0;0
46424;8549;106;75;35;2;33;.943;3900000;0
46425;6373;114;65;17;1;16;.941;3600000;0
46425;6985;114;0;0;0;0;.00nan;0;0
46425;7538;109;95;54;3;51;.944;3584000;0
46425;8626;109;0;0;0;0;.00nan;0;0
46426;7029;105;0;0;0;0;.00nan;0;0
46426;7512;113;59;27;3;24;.889;3900000;0
46426;8014;105;79;39;3;36;.923;3900000;0
46426;8150;113;0;0;0;0;.00nan;0;0
46427;7466;112;40;24;4;20;.833;3600000;0
46427;7562;112;0;0;0;0;.00nan;0;0
46427;7993;108;60;7;0;7;1.000;386000;0
46427;8056;108;26;29;7;22;.759;3214000;0
46428;6961;110;62;20;1;19;.950;3600000;0
46428;8037;107;79;38;2;36;.947;3600000;0
46428;8109;107;0;0;0;0;.00nan;0;0
46428;8564;110;0;0;0;0;.00nan;0;0
46429;6967;121;45;5;1;4;.800;307000;0
46429;7425;121;38;38;6;32;.842;3293000;0
46429;8529;117;0;0;0;0;.00nan;0;0
46429;8658;117;67;35;3;32;.914;3600000;0
46430;7029;105;71;40;4;36;.900;3600000;0
46430;8014;105;0;0;0;0;.00nan;0;0
46430;8031;106;60;22;2;20;.909;3600000;0
46430;8549;106;0;0;0;0;.00nan;0;0
46431;7435;116;0;0;0;0;.00nan;0;0
46431;8038;119;0;0;0;0;.00nan;0;0
46431;8108;116;50;26;4;22;.846;3552000;0
46431;8703;119;64;28;2;26;.929;3600000;0
46432;8057;120;48;16;3;13;.813;3600000;0
46432;8111;118;0;0;0;0;.00nan;0;0
46432;8590;120;0;0;0;0;.00nan;0;0
46432;8629;118;58;34;4;30;.882;3579000;0
46433;6908;111;53;19;2;17;.895;3600000;0
46433;6937;111;0;0;0;0;.00nan;0;0
46433;6968;115;49;40;6;34;.850;3600000;0
46433;7461;115;0;0;0;0;.00nan;0;0
46434;6373;114;55;18;2;16;.889;3600000;0
46434;6985;114;0;0;0;0;.00nan;0;0
46434;7538;109;0;0;0;0;.00nan;0;0
46434;8626;109;79;47;4;43;.915;3600000;0
46435;7003;122;0;0;0;0;.00nan;0;0
46435;7512;113;0;0;0;0;.00nan;0;0
46435;7966;122;69;35;3;32;.914;3600000;0
46435;8150;113;45;34;5;29;.853;3600000;0
46436;7466;112;0;0;0;0;.00nan;0;0
46436;7562;112;69;26;2;24;.923;3600000;0
46436;7993;108;51;32;4;28;.875;3580000;0
46436;8056;108;0;0;0;0;.00nan;0;0
46437;7003;122;98;20;0;20;1.000;3600000;0
46437;7538;109;55;38;4;34;.895;3600000;0
46437;7966;122;0;0;0;0;.00nan;0;0
46437;8626;109;0;0;0;0;.00nan;0;0
46438;8529;117;62;17;1;16;.941;3600000;0
46438;8658;117;0;0;0;0;.00nan;0;0
46438;8703;119;46;40;6;34;.850;3147000;0
46438;8717;119;52;3;0;3;1.000;453000;0
46439;6908;111;0;0;0;0;.00nan;0;0
46439;6937;111;58;37;5;32;.865;3900000;0
46439;7993;108;68;34;5;29;.853;3900000;0
46439;8056;108;0;0;0;0;.00nan;0;0
46440;7029;105;68;18;1;17;.944;3600000;0
46440;8014;105;0;0;0;0;.00nan;0;0
46440;8037;107;0;0;0;0;.00nan;0;0
46440;8109;107;75;40;4;36;.900;3600000;0
46441;7435;116;16;7;4;3;.429;1031000;0
46441;8108;116;39;8;2;6;.750;2569000;0
46441;8111;118;0;0;0;0;.00nan;0;0
46441;8629;118;91;47;3;44;.936;3600000;0
46442;6967;121;55;35;5;30;.857;3900000;0
46442;7425;121;0;0;0;0;.00nan;0;0
46442;8057;120;0;0;0;0;.00nan;0;0
46442;8590;120;53;45;5;40;.889;3900000;0
46443;6961;110;56;23;2;21;.913;3600000;0
46443;6968;115;0;0;0;0;.00nan;0;0
46443;7461;115;90;57;3;54;.947;3598000;0
46443;8564;110;0;0;0;0;.00nan;0;0
46444;6373;114;59;14;1;13;.929;3600000;0
46444;6985;114;0;0;0;0;.00nan;0;0
46444;7512;113;51;44;6;38;.864;2844000;0
46444;8150;113;15;12;5;7;.583;756000;0
46445;7466;112;39;36;6;30;.833;2809000;0
46445;7562;112;44;4;1;3;.750;791000;0
46445;8031;106;0;0;0;0;.00nan;0;0
46445;8549;106;41;18;3;15;.833;3600000;0
46446;6908;111;82;60;5;55;.917;3533000;0
46446;6937;111;0;0;0;0;.00nan;0;0
46446;8031;106;46;19;3;16;.842;3600000;0
46446;8549;106;0;0;0;0;.00nan;0;0
46447;6961;110;0;0;0;0;.00nan;0;0
46447;6968;115;76;49;5;44;.898;3587000;0
46447;7461;115;0;0;0;0;.00nan;0;0
46447;8564;110;66;33;4;29;.879;3600000;0
46448;6373;114;61;33;4;29;.879;3600000;0
46448;6985;114;0;0;0;0;.00nan;0;0
46448;7466;112;94;38;1;37;.974;2603000;0
46448;7562;112;22;18;5;13;.722;923000;0
46449;7538;109;54;16;2;14;.875;3600000;0
46449;8037;107;0;0;0;0;.00nan;0;0
46449;8109;107;65;30;3;27;.900;3583000;0
46449;8626;109;0;0;0;0;.00nan;0;0
46450;6967;121;0;0;0;0;.00nan;0;0
46450;7425;121;51;44;6;38;.864;3600000;0
46450;7435;116;69;31;3;28;.903;3600000;0
46450;8108;116;0;0;0;0;.00nan;0;0
46451;8057;120;0;0;0;0;.00nan;0;0
46451;8590;120;41;21;3;18;.857;3546000;0
46451;8703;119;0;0;0;0;.00nan;0;0
46451;8717;119;72;25;2;23;.920;3600000;0
46452;7003;122;66;17;1;16;.941;3600000;0
46452;7029;105;36;32;6;26;.813;2577000;0
46452;7966;122;0;0;0;0;.00nan;0;0
46452;8014;105;51;9;1;8;.889;1023000;0
46453;8111;118;0;0;0;0;.00nan;0;0
46453;8529;117;0;0;0;0;.00nan;0;0
46453;8629;118;66;48;4;44;.917;3900000;0
46453;8658;117;42;26;4;22;.846;3850000;0
46454;7512;113;83;38;2;36;.947;3555000;0
46454;7993;108;0;0;0;0;.00nan;0;0
46454;8056;108;83;19;1;18;.947;3600000;0
46454;8150;113;0;0;0;0;.00nan;0;0
46455;8111;118;0;0;0;0;.00nan;0;0
46455;8629;118;44;37;6;31;.838;3600000;0
46455;8703;119;55;17;2;15;.882;3600000;0
46455;8717;119;0;0;0;0;.00nan;0;0
46456;6908;111;0;0;0;0;.00nan;0;0
46456;6937;111;84;45;4;41;.911;3526000;0
46456;6961;110;58;19;2;17;.895;3600000;0
46456;8564;110;0;0;0;0;.00nan;0;0
46457;6373;114;76;35;3;32;.914;3600000;0
46457;6985;114;0;0;0;0;.00nan;0;0
46457;8031;106;59;6;0;6;1.000;1437000;0
46457;8549;106;26;15;5;10;.667;2100000;0
46458;7538;109;0;0;0;0;.00nan;0;0
46458;8037;107;100;41;0;41;1.000;3600000;0
46458;8109;107;0;0;0;0;.00nan;0;0
46458;8626;109;77;23;1;22;.957;3558000;0
46459;6993;120;46;39;6;33;.846;3195000;0
46459;8057;120;41;4;1;3;.750;339000;0
46459;8529;117;37;30;5;25;.833;3600000;0
46459;8658;117;0;0;0;0;.00nan;0;0
46460;7466;112;47;24;3;21;.875;3600000;0
46460;7512;113;53;3;0;3;1.000;794000;0
46460;7562;112;0;0;0;0;.00nan;0;0
46460;8150;113;30;31;6;25;.806;2806000;0
46461;6968;115;0;0;0;0;.00nan;0;0
46461;7461;115;92;42;3;39;.929;3560000;0
46461;7993;108;62;21;2;19;.905;3600000;0
46461;8056;108;0;0;0;0;.00nan;0;0
46462;7003;122;0;0;0;0;.00nan;0;0
46462;7029;105;49;8;1;7;.875;566000;0
46462;7966;122;36;21;4;17;.810;3600000;0
46462;8014;105;54;47;7;40;.851;3034000;0
46463;6373;114;53;14;2;12;.857;3748000;0
46463;6908;111;0;0;0;0;.00nan;0;0
46463;6937;111;87;47;3;44;.936;3748000;0
46463;6985;114;0;0;0;0;.00nan;0;0
46464;7029;105;28;8;3;5;.625;575000;0
46464;7466;112;75;27;1;26;.963;3600000;0
46464;7562;112;0;0;0;0;.00nan;0;0
46464;8014;105;82;26;1;25;.962;3025000;0
46465;7003;122;42;20;4;16;.800;3730000;0
46465;7538;109;78;53;5;48;.906;3730000;0
46465;7966;122;0;0;0;0;.00nan;0;0
46465;8626;109;0;0;0;0;.00nan;0;0
46466;8037;107;51;1;0;1;1.000;112000;0
46466;8109;107;49;30;4;26;.867;3488000;0
46466;8111;118;25;30;6;24;.800;3524000;0
46466;8629;118;0;0;0;0;.00nan;0;0
46467;6961;110;64;30;4;26;.867;3600000;0
46467;8529;117;19;25;6;19;.760;2207000;0
46467;8564;110;0;0;0;0;.00nan;0;0
46467;8658;117;12;18;6;12;.667;1393000;0
46468;6968;115;0;0;0;0;.00nan;0;0
46468;7461;115;73;48;5;43;.896;3600000;0
46468;8031;106;48;27;4;23;.852;3600000;0
46468;8549;106;0;0;0;0;.00nan;0;0
46469;7029;105;79;53;4;49;.925;3600000;0
46469;7993;108;49;14;2;12;.857;3600000;0
46469;8014;105;0;0;0;0;.00nan;0;0
46469;8056;108;0;0;0;0;.00nan;0;0
46470;6961;110;0;0;0;0;.00nan;0;0
46470;8564;110;63;27;3;24;.889;3600000;0
46470;8703;119;51;2;0;2;1.000;349000;0
46470;8717;119;32;29;6;23;.793;3251000;0
46471;7512;113;93;39;2;37;.949;3900000;0
46471;7538;109;98;50;2;48;.960;3900000;0
46471;8150;113;0;0;0;0;.00nan;0;0
46471;8626;109;0;0;0;0;.00nan;0;0
46472;7003;122;0;0;0;0;.00nan;0;0
46472;7966;122;51;23;3;20;.870;3600000;0
46472;8111;118;47;47;6;41;.872;3600000;0
46472;8629;118;0;0;0;0;.00nan;0;0
46473;6908;111;100;41;0;41;1.000;3600000;0
46473;6937;111;0;0;0;0;.00nan;0;0
46473;7512;113;0;0;0;0;.00nan;0;0
46473;8150;113;48;24;4;20;.833;3600000;0
46474;6968;115;59;26;3;23;.885;3900000;0
46474;7461;115;0;0;0;0;.00nan;0;0
46474;7999;107;0;0;0;0;.00nan;0;0
46474;8109;107;60;30;3;27;.900;3900000;0
46475;7435;116;0;0;0;0;.00nan;0;0
46475;8108;116;49;45;6;39;.867;3600000;0
46475;8529;117;25;36;7;29;.806;2771000;0
46475;8658;117;60;7;0;7;1.000;775000;0
46476;6373;114;30;21;6;15;.714;3600000;0
46476;6985;114;0;0;0;0;.00nan;0;0
46476;8703;119;96;39;1;38;.974;3600000;0
46476;8717;119;0;0;0;0;.00nan;0;0
46477;7466;112;24;12;4;8;.667;938000;0
46477;7562;112;34;42;8;34;.810;2662000;0
46477;8031;106;41;29;5;24;.828;3600000;0
46477;8549;106;0;0;0;0;.00nan;0;0
46478;7029;105;44;33;5;28;.848;3600000;0
46478;8014;105;0;0;0;0;.00nan;0;0
46478;8111;118;0;0;0;0;.00nan;0;0
46478;8629;118;85;27;1;26;.963;3600000;0
46479;6961;110;31;26;5;21;.808;3567000;0
46479;6967;121;78;31;2;29;.935;3600000;0
46479;7425;121;0;0;0;0;.00nan;0;0
46479;8564;110;0;0;0;0;.00nan;0;0
46480;7003;122;97;29;1;28;.966;3600000;0
46480;7538;109;40;34;6;28;.824;2203000;0
46480;7966;122;0;0;0;0;.00nan;0;0
46480;8626;109;79;19;0;19;1.000;1397000;0
46481;7993;108;77;38;3;35;.921;3600000;0
46481;8031;106;59;10;1;9;.900;1472000;0
46481;8056;108;0;0;0;0;.00nan;0;0
46481;8549;106;16;20;6;14;.700;2128000;0
46482;6968;115;0;0;0;0;.00nan;0;0
46482;7461;115;72;37;4;33;.892;3582000;0
46482;7999;107;44;17;3;14;.824;3600000;0
46482;8109;107;0;0;0;0;.00nan;0;0
46483;6373;114;100;33;0;33;1.000;3600000;0
46483;6985;114;0;0;0;0;.00nan;0;0
46483;6993;120;62;41;5;36;.878;3600000;0
46483;8057;120;0;0;0;0;.00nan;0;0
46484;7029;105;0;0;0;0;.00nan;0;0
46484;7538;109;69;32;4;28;.875;3600000;0
46484;8014;105;40;30;5;25;.833;3540000;0
46484;8626;109;0;0;0;0;.00nan;0;0
46485;6967;121;0;0;0;0;.00nan;0;0
46485;7425;121;66;56;5;51;.911;3900000;0
46485;7435;116;0;0;0;0;.00nan;0;0
46485;8108;116;37;24;5;19;.792;3900000;0
46486;6993;120;0;0;0;0;.00nan;0;0
46486;8057;120;62;47;6;41;.872;3675000;0
46486;8703;119;45;40;5;35;.875;3675000;0
46486;8717;119;0;0;0;0;.00nan;0;0
46487;6373;114;46;27;4;23;.852;3569000;0
46487;6985;114;0;0;0;0;.00nan;0;0
46487;8529;117;64;34;3;31;.912;3600000;0
46487;8658;117;0;0;0;0;.00nan;0;0
46488;7512;113;100;31;0;31;1.000;3600000;0
46488;7993;108;0;0;0;0;.00nan;0;0
46488;8056;108;75;25;1;24;.960;3556000;0
46488;8150;113;0;0;0;0;.00nan;0;0
46489;6908;111;55;47;6;41;.872;3900000;0
46489;6937;111;0;0;0;0;.00nan;0;0
46489;7466;112;38;19;4;15;.789;2126000;0
46489;7562;112;50;18;2;16;.889;1774000;0
46490;6968;115;0;0;0;0;.00nan;0;0
46490;6993;120;71;28;2;26;.929;3600000;0
46490;7461;115;68;34;3;31;.912;3542000;0
46490;8057;120;0;0;0;0;.00nan;0;0
46491;6908;111;0;0;0;0;.00nan;0;0
46491;6937;111;100;45;0;45;1.000;3600000;0
46491;8658;117;0;0;0;0;.00nan;0;0
46491;8729;117;67;33;4;29;.879;3600000;0
46492;7003;122;28;14;4;10;.714;667000;0
46492;7512;113;29;26;6;20;.769;2962000;0
46492;7966;122;61;24;3;21;.875;3012000;0
46492;8150;113;56;5;0;5;1.000;717000;0
46493;7538;109;23;31;6;25;.806;3600000;0
46493;7999;107;0;0;0;0;.00nan;0;0
46493;8109;107;95;32;1;31;.969;3600000;0
46493;8626;109;0;0;0;0;.00nan;0;0
46494;6968;115;31;22;5;17;.773;1657000;0
46494;7435;116;0;0;0;0;.00nan;0;0
46494;7461;115;63;24;2;22;.917;1943000;0
46494;8108;116;63;22;2;20;.909;3600000;0
46495;6961;110;0;0;0;0;.00nan;0;0
46495;8564;110;49;28;4;24;.857;3600000;0
46495;8658;117;0;0;0;0;.00nan;0;0
46495;8729;117;93;36;1;35;.972;3600000;0
46496;6967;121;48;27;4;23;.852;3900000;0
46496;7425;121;0;0;0;0;.00nan;0;0
46496;7993;108;57;39;4;35;.897;3900000;0
46496;8056;108;0;0;0;0;.00nan;0;0
46497;6993;120;96;17;0;17;1.000;3600000;0
46497;7562;118;0;0;0;0;.00nan;0;0
46497;8057;120;0;0;0;0;.00nan;0;0
46497;8629;118;88;54;5;49;.907;3600000;0
46498;7999;107;36;34;6;28;.824;2174000;0
46498;8031;106;93;26;1;25;.962;3600000;0
46498;8109;107;58;33;3;30;.909;1426000;0
46498;8549;106;0;0;0;0;.00nan;0;0
46499;6908;111;0;0;0;0;.00nan;0;0
46499;6937;111;62;42;5;37;.881;3600000;0
46499;7029;105;4;29;8;21;.724;3600000;0
46499;8014;105;0;0;0;0;.00nan;0;0
46500;6373;114;82;26;2;24;.923;3600000;0
46500;6985;114;0;0;0;0;.00nan;0;0
46500;7512;113;78;40;3;37;.925;3577000;0
46500;8150;113;0;0;0;0;.00nan;0;0
46501;7003;122;24;41;8;33;.805;3044000;0
46501;7466;112;0;0;0;0;.00nan;0;0
46501;7966;122;56;7;0;7;1.000;556000;0
46501;8111;112;64;27;3;24;.889;3600000;0
46502;7562;118;33;31;6;25;.806;2233000;0
46502;8629;118;66;15;1;14;.933;1367000;0
46502;8703;119;53;31;4;27;.871;3600000;0
46502;8717;119;0;0;0;0;.00nan;0;0
46503;7538;109;23;9;4;5;.556;787000;0
46503;7999;107;0;0;0;0;.00nan;0;0
46503;8109;107;77;25;2;23;.920;3600000;0
46503;8626;109;13;19;6;13;.684;2813000;0
46504;6967;121;0;0;0;0;.00nan;0;0
46504;6968;115;0;0;0;0;.00nan;0;0
46504;7425;121;34;20;4;16;.800;3900000;0
46504;7461;115;99;61;4;57;.934;3900000;0
46505;6908;111;63;34;4;30;.882;3600000;0
46505;6937;111;0;0;0;0;.00nan;0;0
46505;7029;105;37;8;2;6;.750;853000;0
46505;8014;105;43;33;6;27;.818;2747000;0
46506;6373;114;97;35;2;33;.943;3900000;0
46506;6985;114;0;0;0;0;.00nan;0;0
46506;8658;117;0;0;0;0;.00nan;0;0
46506;8729;117;61;19;2;17;.895;3900000;0
46507;7435;116;44;27;5;22;.815;3600000;0
46507;7993;108;35;40;7;33;.825;2937000;0
46507;8056;108;50;1;0;1;1.000;629000;0
46507;8108;116;0;0;0;0;.00nan;0;0
46508;7003;122;0;0;0;0;.00nan;0;0
46508;7966;122;60;37;4;33;.892;3600000;0
46508;8031;106;0;0;0;0;.00nan;0;0
46508;8549;106;27;34;7;27;.794;3600000;0
46509;6993;120;45;42;7;35;.833;3600000;0
46509;7435;116;0;0;0;0;.00nan;0;0
46509;8057;120;0;0;0;0;.00nan;0;0
46509;8108;116;42;18;3;15;.833;3600000;0
46510;6961;110;97;25;0;25;1.000;3600000;0
46510;7029;105;86;39;2;37;.949;3597000;0
46510;8014;105;0;0;0;0;.00nan;0;0
46510;8564;110;0;0;0;0;.00nan;0;0
46511;7993;108;0;0;0;0;.00nan;0;0
46511;8056;108;27;25;5;20;.800;3558000;0
46511;8703;119;52;9;1;8;.889;783000;0
46511;8717;119;84;34;2;32;.941;2817000;0
46512;6961;110;72;14;1;13;.929;3600000;0
46512;6968;115;0;0;0;0;.00nan;0;0
46512;7461;115;77;41;3;38;.927;3564000;0
46512;8564;110;0;0;0;0;.00nan;0;0
46513;6967;121;35;24;4;20;.833;3541000;0
46513;7425;121;0;0;0;0;.00nan;0;0
46513;7562;118;0;0;0;0;.00nan;0;0
46513;8629;118;96;38;2;36;.947;3600000;0
46514;6373;114;73;16;1;15;.938;3600000;0
46514;6908;111;0;0;0;0;.00nan;0;0
46514;6937;111;77;57;6;51;.895;3600000;0
46514;6985;114;0;0;0;0;.00nan;0;0
46515;7466;112;0;0;0;0;.00nan;0;0
46515;7999;107;0;0;0;0;.00nan;0;0
46515;8109;107;71;47;5;42;.894;3640000;0
46515;8111;112;57;30;4;26;.867;3640000;0
46516;6993;120;79;32;2;30;.938;3600000;0
46516;8057;120;0;0;0;0;.00nan;0;0
46516;8689;119;13;35;8;27;.771;3298000;0
46516;8703;119;39;1;1;0;.000;302000;0
46517;7512;113;42;35;6;29;.829;3600000;0
46517;8150;113;0;0;0;0;.00nan;0;0
46517;8658;117;32;35;6;29;.829;3169000;0
46517;8729;117;37;7;2;5;.714;344000;0
46518;7435;116;0;0;0;0;.00nan;0;0
46518;7512;113;53;3;0;3;1.000;453000;0
46518;8108;116;58;22;2;20;.909;3600000;0
46518;8150;113;71;57;6;51;.895;3147000;0
46519;6961;110;72;22;1;21;.955;3600000;0
46519;7538;109;57;39;5;34;.872;3600000;0
46519;8564;110;0;0;0;0;.00nan;0;0
46519;8626;109;0;0;0;0;.00nan;0;0
46520;6908;111;0;0;0;0;.00nan;0;0
46520;6937;111;82;30;1;29;.967;3600000;0
46520;7562;118;53;3;0;3;1.000;381000;0
46520;8629;118;40;37;6;31;.838;3219000;0
46521;7029;105;28;41;8;33;.805;3138000;0
46521;8014;105;57;7;0;7;1.000;462000;0
46521;8031;106;75;19;1;18;.947;3600000;0
46521;8549;106;0;0;0;0;.00nan;0;0
46522;7435;116;90;40;2;38;.950;3240000;0
46522;8108;116;30;11;3;8;.727;307000;0
46522;8658;117;0;0;0;0;.00nan;0;0
46522;8729;117;51;25;4;21;.840;3600000;0
46523;6967;121;0;0;0;0;.00nan;0;0
46523;6993;120;54;34;4;30;.882;3560000;0
46523;7425;121;65;36;3;33;.917;3600000;0
46523;8057;120;0;0;0;0;.00nan;0;0
46524;6373;114;55;22;3;19;.864;3600000;0
46524;6968;115;55;32;4;28;.875;2612000;0
46524;6985;114;0;0;0;0;.00nan;0;0
46524;7461;115;36;18;4;14;.778;988000;0
46525;7466;112;44;27;5;22;.815;3600000;0
46525;7993;108;57;51;7;44;.863;3600000;0
46525;8056;108;0;0;0;0;.00nan;0;0
46525;8111;112;0;0;0;0;.00nan;0;0
46526;6961;110;0;0;0;0;.00nan;0;0
46526;7538;109;79;33;3;30;.909;3246000;0
46526;8564;110;63;30;3;27;.900;3600000;0
46526;8626;109;25;8;3;5;.625;354000;0
46527;6908;111;98;46;2;44;.957;3600000;0
46527;6937;111;0;0;0;0;.00nan;0;0
46527;8689;119;63;7;0;7;1.000;1630000;0
46527;8703;119;7;15;6;9;.600;1970000;0
46528;7003;122;74;42;3;39;.929;3600000;0
46528;7966;122;0;0;0;0;.00nan;0;0
46528;8031;106;0;0;0;0;.00nan;0;0
46528;8549;106;38;24;4;20;.833;3600000;0
46529;7029;105;0;0;0;0;.00nan;0;0
46529;7999;107;0;0;0;0;.00nan;0;0
46529;8014;105;78;39;3;36;.923;3900000;0
46529;8109;107;73;33;3;30;.909;3900000;0
46530;7435;116;72;12;0;12;1.000;1508000;0
46530;8108;116;12;18;6;12;.667;2092000;0
46530;8658;117;17;30;7;23;.767;3357000;0
46530;8729;117;51;3;0;3;1.000;197000;0
46531;6967;121;63;33;4;29;.879;3301000;0
46531;7425;121;58;8;0;8;1.000;248000;0
46531;7512;113;72;27;2;25;.926;3600000;0
46531;8150;113;0;0;0;0;.00nan;0;0
46532;7466;112;0;0;0;0;.00nan;0;0
46532;7993;108;0;0;0;0;.00nan;0;0
46532;8056;108;62;37;5;32;.865;3600000;0
46532;8111;112;76;31;2;29;.935;3600000;0
46533;7562;118;0;0;0;0;.00nan;0;0
46533;8629;118;41;28;5;23;.821;3600000;0
46533;8689;119;0;0;0;0;.00nan;0;0
46533;8703;119;72;25;2;23;.920;3600000;0
46534;6908;111;0;0;0;0;.00nan;0;0
46534;6937;111;71;48;5;43;.896;3600000;0
46534;6993;120;69;21;1;20;.952;3600000;0
46534;8057;120;0;0;0;0;.00nan;0;0
46535;7003;122;0;0;0;0;.00nan;0;0
46535;7966;122;56;22;2;20;.909;3600000;0
46535;7999;107;20;21;6;15;.714;2303000;0
46535;8109;107;57;19;2;17;.895;1297000;0
46536;6373;114;70;15;1;14;.933;3600000;0
46536;6968;115;68;11;0;11;1.000;841000;0
46536;6985;114;0;0;0;0;.00nan;0;0
46536;7461;115;51;49;7;42;.857;2759000;0
46537;6961;110;40;17;3;14;.824;3561000;0
46537;7029;105;100;47;1;46;.979;3600000;0
46537;8014;105;0;0;0;0;.00nan;0;0
46537;8564;110;0;0;0;0;.00nan;0;0
46538;7538;109;33;37;6;31;.838;3600000;0
46538;8626;109;0;0;0;0;.00nan;0;0
46538;8689;119;0;0;0;0;.00nan;0;0
46538;8703;119;60;24;2;22;.917;3600000;0
46539;6373;114;74;37;4;33;.892;3600000;0
46539;6985;114;0;0;0;0;.00nan;0;0
46539;8031;106;25;42;8;34;.810;3600000;0
46539;8549;106;0;0;0;0;.00nan;0;0
46540;6908;111;0;0;0;0;.00nan;0;0
46540;6937;111;78;25;2;23;.920;3550000;0
46540;6968;115;0;0;0;0;.00nan;0;0
46540;7461;115;94;33;1;32;.970;3600000;0
46541;7562;118;88;34;1;33;.971;3021000;0
46541;8629;118;28;12;4;8;.667;533000;0
46541;8658;117;0;0;0;0;.00nan;0;0
46541;8729;117;74;30;3;27;.900;3600000;0
46542;7512;113;44;25;4;21;.840;3596000;0
46542;7993;108;69;34;3;31;.912;3600000;0
46542;8056;108;0;0;0;0;.00nan;0;0
46542;8150;113;0;0;0;0;.00nan;0;0
46543;7003;122;73;45;4;41;.911;3900000;0
46543;7966;122;0;0;0;0;.00nan;0;0
46543;7999;107;0;0;0;0;.00nan;0;0
46543;8109;107;68;38;4;34;.895;3900000;0
46544;6961;110;52;19;3;16;.842;3564000;0
46544;7029;105;0;0;0;0;.00nan;0;0
46544;8014;105;100;50;2;48;.960;3600000;0
46544;8564;110;0;0;0;0;.00nan;0;0
46545;7538;109;0;0;0;0;.00nan;0;0
46545;7993;108;0;0;0;0;.00nan;0;0
46545;8056;108;63;22;2;20;.909;3600000;0
46545;8626;109;70;41;3;38;.927;3596000;0
46546;6967;121;0;0;0;0;.00nan;0;0
46546;7425;121;35;44;7;37;.841;3562000;0
46546;7435;116;0;0;0;0;.00nan;0;0
46546;8108;116;38;27;5;22;.815;3600000;0
46547;7466;112;47;34;5;29;.853;3600000;0
46547;8111;112;0;0;0;0;.00nan;0;0
46547;8689;119;20;24;6;18;.750;1462000;0
46547;8703;119;56;22;2;20;.909;2138000;0
46548;6993;120;45;25;3;22;.880;3600000;0
46548;8057;120;0;0;0;0;.00nan;0;0
46548;8658;117;0;0;0;0;.00nan;0;0
46548;8729;117;81;47;4;43;.915;3600000;0
46549;7435;116;66;23;2;21;.913;3600000;0
46549;7562;118;37;55;9;46;.836;3139000;0
46549;8108;116;0;0;0;0;.00nan;0;0
46549;8629;118;22;11;4;7;.636;461000;0
46550;6961;110;53;47;6;41;.872;3295000;0
46550;7003;122;72;17;0;17;1.000;3023000;0
46550;7966;122;31;10;3;7;.700;577000;0
46550;8564;110;40;2;1;1;.500;305000;0
46551;6967;121;61;30;3;27;.900;3600000;0
46551;6993;120;0;0;0;0;.00nan;0;0
46551;7425;121;0;0;0;0;.00nan;0;0
46551;8057;120;45;35;5;30;.857;3522000;0
46552;6968;115;84;38;2;36;.947;3600000;0
46552;7461;115;0;0;0;0;.00nan;0;0
46552;8689;119;47;19;3;16;.842;3588000;0
46552;8703;119;0;0;0;0;.00nan;0;0
46553;6373;114;58;28;3;25;.893;3600000;0
46553;6908;111;23;34;8;26;.765;2741000;0
46553;6937;111;44;12;2;10;.833;859000;0
46553;6985;114;0;0;0;0;.00nan;0;0
46554;7993;108;8;16;6;10;.625;2130000;0
46554;8031;106;58;40;5;35;.875;3600000;0
46554;8056;108;56;14;1;13;.929;1470000;0
46554;8549;106;0;0;0;0;.00nan;0;0
46555;7466;112;0;0;0;0;.00nan;0;0
46555;7512;113;25;7;3;4;.571;162000;0
46555;8111;112;53;29;4;25;.862;3900000;0
46555;8150;113;77;25;1;24;.960;3738000;0
46556;6967;121;86;31;2;29;.935;3600000;0
46556;7425;121;0;0;0;0;.00nan;0;0
46556;7562;118;0;0;0;0;.00nan;0;0
46556;8629;118;37;39;7;32;.821;3600000;0
46557;7512;113;29;10;3;7;.700;577000;0
46557;8031;106;0;0;0;0;.00nan;0;0
46557;8150;113;58;45;6;39;.867;3023000;0
46557;8549;106;64;26;3;23;.885;3600000;0
46558;6993;120;69;29;2;27;.931;3581000;0
46558;7999;107;0;0;0;0;.00nan;0;0
46558;8057;120;0;0;0;0;.00nan;0;0
46558;8109;107;99;40;1;39;.975;3600000;0
46559;7003;122;65;39;4;35;.897;3600000;0
46559;7966;122;0;0;0;0;.00nan;0;0
46559;8658;117;75;30;2;28;.933;3196000;0
46559;8729;117;23;4;3;1;.250;404000;0
46560;6908;111;61;13;0;13;1.000;1072000;0
46560;6937;111;39;38;7;31;.816;2528000;0
46560;6961;110;67;21;2;19;.905;3600000;0
46560;8564;110;0;0;0;0;.00nan;0;0
46561;7435;116;49;7;1;6;.857;1028000;0
46561;8108;116;20;27;6;21;.778;2572000;0
46561;8689;119;0;0;0;0;.00nan;0;0
46561;8703;119;81;29;2;27;.931;3600000;0
46562;6968;115;0;0;0;0;.00nan;0;0
46562;7461;115;56;38;5;33;.868;3566000;0
46562;7993;108;31;23;4;19;.826;3600000;0
46562;8056;108;0;0;0;0;.00nan;0;0
46563;7029;105;57;36;5;31;.861;2373000;0
46563;8014;105;48;12;2;10;.833;1227000;0
46563;8658;117;0;0;0;0;.00nan;0;0
46563;8729;117;89;17;0;17;1.000;3600000;0
46564;7562;118;46;3;1;2;.667;394000;0
46564;7993;108;0;0;0;0;.00nan;0;0
46564;8056;108;58;34;5;29;.853;3658000;0
46564;8629;118;64;35;5;30;.857;3264000;0
46565;6968;115;72;41;4;37;.902;3600000;0
46565;7461;115;0;0;0;0;.00nan;0;0
46565;7538;109;78;23;1;22;.957;3600000;0
46565;8626;109;0;0;0;0;.00nan;0;0
46566;7435;116;0;0;0;0;.00nan;0;0
46566;8108;116;92;24;0;24;1.000;3600000;0
46566;8689;119;53;38;5;33;.868;3600000;0
46566;8703;119;0;0;0;0;.00nan;0;0
46567;6993;120;65;42;4;38;.905;3600000;0
46567;7466;112;55;19;2;17;.895;3600000;0
46567;8057;120;0;0;0;0;.00nan;0;0
46567;8111;112;0;0;0;0;.00nan;0;0
46568;6373;114;37;28;6;22;.786;2437000;0
46568;6967;121;44;3;1;2;.667;733000;0
46568;6985;114;48;9;2;7;.778;1108000;0
46568;7425;121;33;33;6;27;.818;2867000;0
46569;6908;111;0;0;0;0;.00nan;0;0
46569;6937;111;98;45;2;43;.956;3600000;0
46569;7512;113;58;21;3;18;.857;3553000;0
46569;8150;113;0;0;0;0;.00nan;0;0
46570;7538;109;0;0;0;0;.00nan;0;0
46570;7562;118;50;43;6;37;.860;2595000;0
46570;8626;109;42;25;4;21;.840;3600000;0
46570;8629;118;30;2;2;0;.000;1005000;0
46571;6968;115;0;0;0;0;.00nan;0;0
46571;6993;120;0;0;0;0;.00nan;0;0
46571;7461;115;33;36;6;30;.833;3600000;0
46571;8057;120;85;29;1;28;.966;3600000;0
46572;7029;105;55;40;5;35;.875;2394000;0
46572;8014;105;30;13;3;10;.769;1206000;0
46572;8031;106;57;21;2;19;.905;3600000;0
46572;8549;106;0;0;0;0;.00nan;0;0
46573;7999;107;0;0;0;0;.00nan;0;0
46573;8109;107;71;35;3;32;.914;3600000;0
46573;8658;117;0;0;0;0;.00nan;0;0
46573;8729;117;57;30;4;26;.867;3551000;0
46574;6961;110;0;0;0;0;.00nan;0;0
46574;7512;113;89;38;1;37;.974;3600000;0
46574;8150;113;0;0;0;0;.00nan;0;0
46574;8564;110;43;18;3;15;.833;3560000;0
46575;7003;122;0;0;0;0;.00nan;0;0
46575;7466;112;0;0;0;0;.00nan;0;0
46575;7966;122;97;43;2;41;.953;3600000;0
46575;8111;112;56;36;4;32;.889;3512000;0
46576;7562;118;66;33;3;30;.909;1693000;0
46576;8031;106;71;16;1;15;.938;3600000;0
46576;8549;106;0;0;0;0;.00nan;0;0
46576;8629;118;34;34;6;28;.824;1907000;0
46577;6908;111;49;43;5;38;.884;3852000;0
46577;6937;111;0;0;0;0;.00nan;0;0
46577;6961;110;60;31;4;27;.871;3852000;0
46577;8564;110;0;0;0;0;.00nan;0;0
46578;6967;121;46;26;4;22;.846;3637000;0
46578;7425;121;0;0;0;0;.00nan;0;0
46578;8689;119;48;5;1;4;.800;351000;0
46578;8703;119;60;35;4;31;.886;3286000;0
46579;6373;114;81;27;2;25;.926;3600000;0
46579;6985;114;0;0;0;0;.00nan;0;0
46579;7435;116;39;1;1;0;.000;623000;0
46579;8108;116;58;48;6;42;.875;2977000;0
46580;7029;105;44;38;6;32;.842;3600000;0
46580;7993;108;58;28;4;24;.857;3600000;0
46580;8014;105;0;0;0;0;.00nan;0;0
46580;8056;108;0;0;0;0;.00nan;0;0
46581;7003;122;97;21;0;21;1.000;3600000;0
46581;7538;109;79;32;3;29;.906;3600000;0
46581;7966;122;0;0;0;0;.00nan;0;0
46581;8626;109;0;0;0;0;.00nan;0;0
46582;6908;111;0;0;0;0;.00nan;0;0
46582;6937;111;82;29;1;28;.966;3600000;0
46582;7538;109;13;22;6;16;.727;3600000;0
46582;8626;109;0;0;0;0;.00nan;0;0
46583;7435;116;0;0;0;0;.00nan;0;0
46583;7999;107;0;0;0;0;.00nan;0;0
46583;8108;116;67;23;2;21;.913;3600000;0
46583;8109;107;82;43;3;40;.930;3563000;0
46584;6993;120;67;44;5;39;.886;3577000;0
46584;8057;120;0;0;0;0;.00nan;0;0
46584;8658;117;0;0;0;0;.00nan;0;0
46584;8729;117;69;33;3;30;.909;3600000;0
46585;6961;110;56;12;1;11;.917;3600000;0
46585;6968;115;65;11;0;11;1.000;1014000;0
46585;7461;115;50;39;6;33;.846;2586000;0
46585;8564;110;0;0;0;0;.00nan;0;0
46586;7029;105;27;33;7;26;.788;3600000;0
46586;7466;112;60;22;2;20;.909;3600000;0
46586;8014;105;0;0;0;0;.00nan;0;0
46586;8111;112;0;0;0;0;.00nan;0;0
46587;6967;121;81;45;4;41;.911;3600000;0
46587;7425;121;0;0;0;0;.00nan;0;0
46587;8031;106;0;0;0;0;.00nan;0;0
46587;8549;106;54;42;5;37;.881;3543000;0
46588;7562;118;55;21;3;18;.857;1888000;0
46588;8629;118;24;26;6;20;.769;1712000;0
46588;8689;119;0;0;0;0;.00nan;0;0
46588;8703;119;58;29;4;25;.862;3600000;0
46589;7003;122;69;30;3;27;.900;3609000;0
46589;7466;112;0;0;0;0;.00nan;0;0
46589;7966;122;0;0;0;0;.00nan;0;0
46589;8111;112;54;33;4;29;.879;3668000;0
46590;7466;112;43;38;6;32;.842;3086000;0
46590;7999;107;97;27;0;27;1.000;3600000;0
46590;8109;107;0;0;0;0;.00nan;0;0
46590;8111;112;60;7;0;7;1.000;514000;0
46591;6967;121;66;19;1;18;.947;2425000;0
46591;7425;121;31;16;4;12;.750;1158000;0
46591;7512;113;73;41;4;37;.902;3600000;0
46591;8150;113;0;0;0;0;.00nan;0;0
46592;7435;116;0;0;0;0;.00nan;0;0
46592;8031;106;97;42;2;40;.952;3600000;0
46592;8108;116;48;22;3;19;.864;3563000;0
46592;8549;106;0;0;0;0;.00nan;0;0
46593;6993;120;51;22;3;19;.864;3600000;0
46593;7562;118;0;0;0;0;.00nan;0;0
46593;8057;120;0;0;0;0;.00nan;0;0
46593;8629;118;77;57;5;52;.912;3548000;0
46594;6908;111;39;25;5;20;.800;3600000;0
46594;6937;111;0;0;0;0;.00nan;0;0
46594;6968;115;54;30;3;27;.900;3044000;0
46594;7461;115;35;12;3;9;.750;527000;0
46595;8658;117;0;0;0;0;.00nan;0;0
46595;8689;119;64;37;4;33;.892;3593000;0
46595;8703;119;0;0;0;0;.00nan;0;0
46595;8729;117;56;29;3;26;.897;3600000;0
46596;7538;109;63;44;4;40;.909;3600000;0
46596;7993;108;48;21;3;18;.857;3600000;0
46596;8056;108;0;0;0;0;.00nan;0;0
46596;8626;109;0;0;0;0;.00nan;0;0
46597;6373;114;88;37;3;34;.919;3600000;0
46597;6961;110;47;25;4;21;.840;3594000;0
46597;6985;114;0;0;0;0;.00nan;0;0
46597;8564;110;0;0;0;0;.00nan;0;0
46598;6967;121;84;36;3;33;.917;3684000;0
46598;7425;121;0;0;0;0;.00nan;0;0
46598;7538;109;0;0;0;0;.00nan;0;0
46598;8626;109;55;28;4;24;.857;3684000;0
46599;7435;116;46;19;3;16;.842;3900000;0
46599;7512;113;96;48;3;45;.938;3900000;0
46599;8108;116;0;0;0;0;.00nan;0;0
46599;8150;113;0;0;0;0;.00nan;0;0
46600;6993;120;18;27;6;21;.778;3086000;0
46600;8057;120;54;7;0;7;1.000;471000;0
46600;8689;119;0;0;0;0;.00nan;0;0
46600;8703;119;51;28;4;24;.857;3600000;0
46601;7466;112;0;0;0;0;.00nan;0;0
46601;7993;108;0;0;0;0;.00nan;0;0
46601;8056;108;58;28;4;24;.857;3600000;0
46601;8111;112;64;50;5;45;.900;3551000;0
46602;7538;109;36;28;5;23;.821;2137000;0
46602;7999;107;51;22;3;19;.864;3600000;0
46602;8109;107;0;0;0;0;.00nan;0;0
46602;8626;109;55;14;1;13;.929;1463000;0
46603;6373;114;0;0;0;0;.00nan;0;0
46603;6961;110;0;0;0;0;.00nan;0;0
46603;6985;114;88;33;2;31;.939;3600000;0
46603;8564;110;44;29;4;25;.862;3528000;0
46604;7003;122;0;0;0;0;.00nan;0;0
46604;7029;105;56;31;3;28;.903;3708000;0
46604;7966;122;52;26;4;22;.846;3708000;0
46604;8014;105;0;0;0;0;.00nan;0;0
46605;6968;115;0;0;0;0;.00nan;0;0
46605;7461;115;94;43;2;41;.953;3600000;0
46605;8031;106;64;28;3;25;.893;3544000;0
46605;8549;106;0;0;0;0;.00nan;0;0
46606;6967;121;24;25;6;19;.760;2147000;0
46606;7003;122;31;36;7;29;.806;2698000;0
46606;7425;121;62;9;0;9;1.000;1453000;0
46606;7966;122;69;14;0;14;1.000;902000;0
46607;6967;121;63;34;4;30;.882;3814000;0
46607;7029;105;0;0;0;0;.00nan;0;0
46607;7425;121;0;0;0;0;.00nan;0;0
46607;8014;105;66;32;3;29;.906;3814000;0
46608;6993;120;88;38;2;36;.947;3600000;0
46608;8057;120;0;0;0;0;.00nan;0;0
46608;8689;119;0;0;0;0;.00nan;0;0
46608;8703;119;61;39;4;35;.897;3600000;0
46609;6373;114;58;13;1;12;.923;3900000;0
46609;6968;115;0;0;0;0;.00nan;0;0
46609;6985;114;0;0;0;0;.00nan;0;0
46609;7461;115;97;51;1;50;.980;3900000;0
46610;7435;116;0;0;0;0;.00nan;0;0
46610;7562;118;0;0;0;0;.00nan;0;0
46610;8108;116;42;14;3;11;.786;3600000;0
46610;8629;118;63;39;4;35;.897;3549000;0
46611;6961;110;43;35;5;30;.857;3600000;0
46611;7466;112;32;39;7;32;.821;2850000;0
46611;8111;112;37;7;2;5;.714;750000;0
46611;8564;110;0;0;0;0;.00nan;0;0
46612;6373;114;53;20;2;18;.900;3900000;0
46612;6985;114;0;0;0;0;.00nan;0;0
46612;7538;109;64;22;2;20;.909;3900000;0
46612;8626;109;0;0;0;0;.00nan;0;0
46613;6908;111;0;0;0;0;.00nan;0;0
46613;6937;111;81;32;2;30;.938;3600000;0
46613;7029;105;54;32;4;28;.875;3533000;0
46613;8014;105;0;0;0;0;.00nan;0;0
46614;7512;113;54;30;4;26;.867;2359000;0
46614;8031;106;25;18;5;13;.722;3900000;0
46614;8150;113;75;19;1;18;.947;1541000;0
46614;8549;106;0;0;0;0;.00nan;0;0
46615;7993;108;40;32;5;27;.844;3600000;0
46615;8056;108;0;0;0;0;.00nan;0;0
46615;8658;117;35;11;3;8;.727;3600000;0
46615;8729;117;0;0;0;0;.00nan;0;0
46616;6961;110;0;0;0;0;.00nan;0;0
46616;8031;106;0;0;0;0;.00nan;0;0
46616;8549;106;88;37;2;35;.946;3600000;0
46616;8564;110;48;44;6;38;.864;3600000;0
46617;6967;121;52;19;3;16;.842;3639000;0
46617;7425;121;0;0;0;0;.00nan;0;0
46617;7999;107;0;0;0;0;.00nan;0;0
46617;8109;107;86;44;4;40;.909;3639000;0
46618;8658;117;0;0;0;0;.00nan;0;0
46618;8689;119;0;0;0;0;.00nan;0;0
46618;8703;119;92;48;2;46;.958;3876000;0
46618;8729;117;83;29;1;28;.966;3876000;0
46619;6908;111;54;35;5;30;.857;3600000;0
46619;6937;111;0;0;0;0;.00nan;0;0
46619;7003;122;67;23;1;22;.957;3600000;0
46619;7966;122;0;0;0;0;.00nan;0;0
46620;6993;120;66;27;2;25;.926;3600000;0
46620;7993;108;0;0;0;0;.00nan;0;0
46620;8056;108;88;45;3;42;.933;3561000;0
46620;8057;120;0;0;0;0;.00nan;0;0
46621;7466;112;0;0;0;0;.00nan;0;0
46621;7512;113;82;29;1;28;.966;3600000;0
46621;8111;112;70;44;4;40;.909;3600000;0
46621;8150;113;0;0;0;0;.00nan;0;0
46622;6908;111;0;0;0;0;.00nan;0;0
46622;6937;111;42;32;5;27;.844;3600000;0
46622;7003;122;0;0;0;0;.00nan;0;0
46622;7966;122;69;22;1;21;.955;3600000;0
46623;6993;120;0;0;0;0;.00nan;0;0
46623;7435;116;0;0;0;0;.00nan;0;0
46623;8057;120;37;34;6;28;.824;3523000;0
46623;8108;116;72;40;4;36;.900;3600000;0
46624;6968;115;0;0;0;0;.00nan;0;0
46624;7461;115;41;35;6;29;.829;3600000;0
46624;7538;109;0;0;0;0;.00nan;0;0
46624;8626;109;82;30;1;29;.967;3600000;0
46625;6373;114;72;28;2;26;.929;3600000;0
46625;6985;114;0;0;0;0;.00nan;0;0
46625;7466;112;21;27;7;20;.741;2743000;0
46625;8111;112;43;4;1;3;.750;857000;0
46626;7029;105;63;35;4;31;.886;3804000;0
46626;7999;107;55;28;3;25;.893;3804000;0
46626;8014;105;0;0;0;0;.00nan;0;0
46626;8109;107;0;0;0;0;.00nan;0;0
46627;7562;118;57;31;4;27;.871;2438000;0
46627;7993;108;91;36;1;35;.972;3600000;0
46627;8056;108;0;0;0;0;.00nan;0;0
46627;8629;118;42;21;4;17;.810;1162000;0
46628;8658;117;0;0;0;0;.00nan;0;0
46628;8689;119;0;0;0;0;.00nan;0;0
46628;8703;119;84;36;2;34;.944;3600000;0
46628;8729;117;80;17;0;17;1.000;3600000;0
46629;6993;120;54;32;4;28;.875;3600000;0
46629;7435;116;58;23;3;20;.870;3600000;0
46629;8057;120;0;0;0;0;.00nan;0;0
46629;8108;116;0;0;0;0;.00nan;0;0
46630;7029;105;57;44;5;39;.886;3600000;0
46630;7538;109;73;25;2;23;.920;3600000;0
46630;8014;105;0;0;0;0;.00nan;0;0
46630;8626;109;0;0;0;0;.00nan;0;0
46631;7003;122;59;23;3;20;.870;3600000;0
46631;7538;109;0;0;0;0;.00nan;0;0
46631;7966;122;0;0;0;0;.00nan;0;0
46631;8626;109;34;22;5;17;.773;3571000;0
46632;6908;111;61;44;5;39;.886;3829000;0
46632;6937;111;0;0;0;0;.00nan;0;0
46632;7999;107;0;0;0;0;.00nan;0;0
46632;8109;107;80;39;4;35;.897;3829000;0
46633;6968;115;74;41;3;38;.927;3600000;0
46633;7461;115;0;0;0;0;.00nan;0;0
46633;7466;112;0;0;0;0;.00nan;0;0
46633;8111;112;38;25;4;21;.840;3565000;0
46750;7029;105;69;25;2;23;.920;3600000;0
46750;7512;113;68;40;3;37;.925;3600000;0
46750;8014;105;0;0;0;0;.00nan;0;0
46750;8150;113;0;0;0;0;.00nan;0;0
46752;6993;120;36;34;5;29;.853;3900000;0
46752;7012;109;0;0;0;0;.00nan;0;0
46752;7538;109;56;40;5;35;.875;3900000;0
46752;8057;120;0;0;0;0;.00nan;0;0
46754;7466;119;0;0;0;0;.00nan;0;0
46754;8031;106;0;0;0;0;.00nan;0;0
46754;8038;119;41;38;6;32;.842;3578000;0
46754;8549;106;33;17;4;13;.765;3600000;0
46756;6373;114;47;14;2;12;.857;3600000;0
46756;6968;115;0;0;0;0;.00nan;0;0
46756;7461;115;69;52;5;47;.904;3600000;0
46756;8595;114;0;0;0;0;.00nan;0;0
46758;7562;112;27;27;6;21;.778;2040000;0
46758;8529;117;0;0;0;0;.00nan;0;0
46758;8614;112;50;18;2;16;.889;1560000;0
46758;8658;117;51;38;5;33;.868;3600000;0
46760;6908;111;87;32;1;31;.969;3600000;0
46760;6937;111;0;0;0;0;.00nan;0;0
46760;7966;122;0;0;0;0;.00nan;0;0
46760;8607;122;53;37;5;32;.865;3600000;0
46762;6967;121;55;25;3;22;.880;3600000;0
46762;7425;121;0;0;0;0;.00nan;0;0
46762;8037;107;30;27;5;22;.815;3544000;0
46762;8109;107;0;0;0;0;.00nan;0;0
46764;6961;110;95;34;1;33;.971;3600000;0
46764;8111;118;0;0;0;0;.00nan;0;0
46764;8564;110;0;0;0;0;.00nan;0;0
46764;8629;118;60;25;3;22;.880;3514000;0
46766;7435;116;0;0;0;0;.00nan;0;0
46766;7993;108;82;13;0;13;1.000;3600000;0
46766;8056;108;0;0;0;0;.00nan;0;0
46766;8108;116;28;29;6;23;.793;3600000;0
46768;7029;105;82;28;1;27;.964;3600000;0
46768;8014;105;0;0;0;0;.00nan;0;0
46768;8037;107;0;0;0;0;.00nan;0;0
46768;8109;107;74;39;3;36;.923;3515000;0
46770;7003;122;0;0;0;0;.00nan;0;0
46770;7562;112;0;0;0;0;.00nan;0;0
46770;7966;122;61;18;2;16;.889;3600000;0
46770;8614;112;69;38;3;35;.921;3592000;0
46772;6968;115;0;0;0;0;.00nan;0;0
46772;7461;115;89;26;2;24;.923;3900000;0
46772;7512;113;75;31;2;29;.935;3900000;0
46772;8150;113;0;0;0;0;.00nan;0;0
46774;6961;110;0;0;0;0;.00nan;0;0
46774;6967;121;65;39;5;34;.872;3590000;0
46774;7425;121;0;0;0;0;.00nan;0;0
46774;8564;110;65;33;4;29;.879;3600000;0
46776;7466;119;25;35;7;28;.800;2661000;0
46776;8031;106;67;20;1;19;.950;3600000;0
46776;8038;119;49;21;4;17;.810;939000;0
46776;8549;106;0;0;0;0;.00nan;0;0
46778;7993;108;61;33;3;30;.909;3600000;0
46778;8056;108;0;0;0;0;.00nan;0;0
46778;8529;117;56;34;4;30;.882;3592000;0
46778;8658;117;0;0;0;0;.00nan;0;0
46780;6373;114;74;32;2;30;.938;3600000;0
46780;7435;116;36;30;5;25;.833;3600000;0
46780;8108;116;0;0;0;0;.00nan;0;0
46780;8595;114;0;0;0;0;.00nan;0;0
46782;6993;120;43;5;1;4;.800;832000;0
46782;7012;109;95;21;0;21;1.000;3600000;0
46782;7538;109;0;0;0;0;.00nan;0;0
46782;8057;120;12;36;9;27;.750;2768000;0
46784;6908;111;0;0;0;0;.00nan;0;0
46784;6937;111;54;28;4;24;.857;3600000;0
46784;8111;118;0;0;0;0;.00nan;0;0
46784;8629;118;51;43;6;37;.860;3533000;0
46786;6373;114;50;25;4;21;.840;3600000;0
46786;7029;105;0;0;0;0;.00nan;0;0
46786;8014;105;59;42;5;37;.881;3572000;0
46786;8595;114;0;0;0;0;.00nan;0;0
46788;6968;115;49;38;6;32;.842;3321000;0
46788;6993;120;37;14;3;11;.786;3600000;0
46788;7461;115;48;0;0;0;.00nan;279000;0
46788;8057;120;0;0;0;0;.00nan;0;0
46790;7003;122;87;38;1;37;.974;3600000;0
46790;7966;122;0;0;0;0;.00nan;0;0
46790;8529;117;77;27;1;26;.963;3124000;0
46790;8658;117;32;10;3;7;.700;476000;0
46792;7562;112;69;30;2;28;.933;3600000;0
46792;8031;106;0;0;0;0;.00nan;0;0
46792;8549;106;53;28;3;25;.893;3565000;0
46792;8614;112;0;0;0;0;.00nan;0;0
46794;7435;116;0;0;0;0;.00nan;0;0
46794;7466;119;47;15;2;13;.867;916000;0
46794;8038;119;49;36;6;30;.833;2684000;0
46794;8108;116;41;10;3;7;.700;3600000;0
46796;7012;109;61;19;1;18;.947;3600000;0
46796;7538;109;0;0;0;0;.00nan;0;0
46796;8111;118;39;33;6;27;.818;2806000;0
46796;8629;118;34;12;3;9;.750;794000;0
46798;6908;111;58;29;4;25;.862;3600000;0
46798;6937;111;0;0;0;0;.00nan;0;0
46798;6961;110;57;39;6;33;.846;3536000;0
46798;8564;110;0;0;0;0;.00nan;0;0
46800;6967;121;0;0;0;0;.00nan;0;0
46800;7425;121;63;22;2;20;.909;3695000;0
46800;7512;113;0;0;0;0;.00nan;0;0
46800;8150;113;68;27;3;24;.889;3695000;0
46802;7993;108;0;0;0;0;.00nan;0;0
46802;8037;107;56;44;5;39;.886;3600000;0
46802;8056;108;79;28;1;27;.964;3600000;0
46802;8109;107;0;0;0;0;.00nan;0;0
46804;6908;111;0;0;0;0;.00nan;0;0
46804;6937;111;59;47;6;41;.872;3600000;0
46804;6993;120;0;0;0;0;.00nan;0;0
46804;8057;120;68;33;3;30;.909;3600000;0
46806;7012;109;0;0;0;0;.00nan;0;0
46806;7538;109;63;25;2;23;.920;3600000;0
46806;7562;112;0;0;0;0;.00nan;0;0
46806;8614;112;43;22;4;18;.818;3596000;0
46808;7435;116;0;0;0;0;.00nan;0;0
46808;7993;108;68;38;4;34;.895;3600000;0
46808;8056;108;0;0;0;0;.00nan;0;0
46808;8108;116;59;22;2;20;.909;3600000;0
46810;7512;113;76;26;2;24;.923;3600000;0
46810;8111;118;73;35;3;32;.914;3546000;0
46810;8150;113;0;0;0;0;.00nan;0;0
46810;8629;118;0;0;0;0;.00nan;0;0
46812;6967;121;70;47;5;42;.894;3557000;0
46812;7425;121;0;0;0;0;.00nan;0;0
46812;8529;117;0;0;0;0;.00nan;0;0
46812;8658;117;53;28;4;24;.857;3600000;0
46814;6961;110;53;3;0;3;1.000;352000;0
46814;7466;119;20;24;6;18;.750;2627000;0
46814;8038;119;61;6;0;6;1.000;973000;0
46814;8564;110;33;27;5;22;.815;3248000;0
46816;7003;122;0;0;0;0;.00nan;0;0
46816;7966;122;46;30;4;26;.867;3600000;0
46816;8037;107;0;0;0;0;.00nan;0;0
46816;8109;107;47;36;5;31;.861;3600000;0
46818;6968;115;0;0;0;0;.00nan;0;0
46818;7461;115;94;59;4;55;.932;3717000;0
46818;8031;106;43;14;3;11;.786;3717000;0
46818;8549;106;0;0;0;0;.00nan;0;0
46820;6373;114;87;16;0;16;1.000;3600000;0
46820;7029;105;88;44;2;42;.955;3584000;0
46820;8014;105;0;0;0;0;.00nan;0;0
46820;8595;114;0;0;0;0;.00nan;0;0
46822;6968;115;51;49;7;42;.857;3600000;0
46822;7461;115;0;0;0;0;.00nan;0;0
46822;7993;108;0;0;0;0;.00nan;0;0
46822;8056;108;76;26;1;25;.962;3600000;0
46824;6967;121;0;0;0;0;.00nan;0;0
46824;7003;122;58;27;3;24;.889;3769000;0
46824;7425;121;45;27;4;23;.852;3769000;0
46824;7966;122;0;0;0;0;.00nan;0;0
46826;6961;110;25;26;6;20;.769;2915000;0
46826;6993;120;29;23;5;18;.783;3600000;0
46826;8057;120;0;0;0;0;.00nan;0;0
46826;8564;110;61;6;0;6;1.000;685000;0
46828;7466;119;0;0;0;0;.00nan;0;0
46828;8038;119;44;32;5;27;.844;3600000;0
46828;8529;117;55;20;2;18;.900;3600000;0
46828;8658;117;0;0;0;0;.00nan;0;0
46830;6373;114;47;29;5;24;.828;3600000;0
46830;7562;112;45;42;6;36;.857;3576000;0
46830;8595;114;0;0;0;0;.00nan;0;0
46830;8614;112;0;0;0;0;.00nan;0;0
46832;7435;116;68;15;1;14;.933;3600000;0
46832;8108;116;0;0;0;0;.00nan;0;0
46832;8111;118;59;15;1;14;.933;927000;0
46832;8629;118;51;45;6;39;.867;2673000;0
46834;7029;105;0;0;0;0;.00nan;0;0
46834;7512;113;0;0;0;0;.00nan;0;0
46834;8014;105;76;21;1;20;.952;3600000;0
46834;8150;113;61;40;4;36;.900;3600000;0
46836;7012;109;72;55;5;50;.909;3600000;0
46836;7538;109;0;0;0;0;.00nan;0;0
46836;8031;106;0;0;0;0;.00nan;0;0
46836;8549;106;44;28;4;24;.857;3600000;0
46838;6908;111;88;43;2;41;.953;3900000;0
46838;6937;111;0;0;0;0;.00nan;0;0
46838;8037;107;0;0;0;0;.00nan;0;0
46838;8109;107;86;37;2;35;.946;3900000;0
46840;6961;110;0;0;0;0;.00nan;0;0
46840;7466;119;73;32;2;30;.938;3600000;0
46840;8038;119;0;0;0;0;.00nan;0;0
46840;8564;110;69;38;4;34;.895;3522000;0
46842;6967;121;49;35;4;31;.886;3546000;0
46842;7425;121;0;0;0;0;.00nan;0;0
46842;8111;118;51;23;3;20;.870;3600000;0
46842;8629;118;0;0;0;0;.00nan;0;0
46844;6968;115;0;0;0;0;.00nan;0;0
46844;7461;115;100;41;1;40;.976;3600000;0
46844;7993;108;25;23;6;17;.739;3600000;0
46844;8056;108;0;0;0;0;.00nan;0;0
46846;7435;116;60;29;4;25;.862;3709000;0
46846;7562;112;0;0;0;0;.00nan;0;0
46846;8108;116;0;0;0;0;.00nan;0;0
46846;8614;112;48;38;5;33;.868;3709000;0
46848;6993;120;73;33;2;31;.939;3600000;0
46848;7512;113;35;34;6;28;.824;3600000;0
46848;8057;120;0;0;0;0;.00nan;0;0
46848;8150;113;0;0;0;0;.00nan;0;0
46850;7029;105;68;32;3;29;.906;3600000;0
46850;8014;105;0;0;0;0;.00nan;0;0
46850;8529;117;0;0;0;0;.00nan;0;0
46850;8658;117;60;41;5;36;.878;3558000;0
46852;6908;111;0;0;0;0;.00nan;0;0
46852;6937;111;66;40;4;36;.900;3600000;0
46852;8031;106;77;28;3;25;.893;3600000;0
46852;8549;106;0;0;0;0;.00nan;0;0
46854;6373;114;73;26;2;24;.923;3900000;0
46854;7012;109;0;0;0;0;.00nan;0;0
46854;7538;109;94;42;2;40;.952;3900000;0
46854;8595;114;0;0;0;0;.00nan;0;0
46856;7003;122;0;0;0;0;.00nan;0;0
46856;7966;122;68;30;3;27;.900;3600000;0
46856;8037;107;0;0;0;0;.00nan;0;0
46856;8109;107;67;36;4;32;.889;3600000;0
46858;6967;121;62;52;6;46;.885;2742000;0
46858;7425;121;37;25;4;21;.840;858000;0
46858;8031;106;46;12;2;10;.833;3600000;0
46858;8549;106;0;0;0;0;.00nan;0;0
46860;6968;115;0;0;0;0;.00nan;0;0
46860;7461;115;53;53;8;45;.849;3600000;0
46860;8529;117;63;24;3;21;.875;3600000;0
46860;8658;117;0;0;0;0;.00nan;0;0
46862;6373;114;38;15;3;12;.800;3600000;0
46862;6993;120;34;45;8;37;.822;3600000;0
46862;8057;120;0;0;0;0;.00nan;0;0
46862;8595;114;0;0;0;0;.00nan;0;0
46864;6908;111;58;7;0;7;1.000;765000;0
46864;6937;111;25;23;6;17;.739;2835000;0
46864;7512;113;59;29;3;26;.897;3600000;0
46864;8150;113;0;0;0;0;.00nan;0;0
46866;7466;119;0;0;0;0;.00nan;0;0
46866;7562;112;0;0;0;0;.00nan;0;0
46866;8038;119;79;34;2;32;.941;3600000;0
46866;8614;112;58;33;3;30;.909;3574000;0
46868;7029;105;61;29;3;26;.897;3600000;0
46868;8014;105;0;0;0;0;.00nan;0;0
46868;8111;118;0;0;0;0;.00nan;0;0
46868;8629;118;62;39;4;35;.897;3600000;0
46870;7435;116;0;0;0;0;.00nan;0;0
46870;8037;107;0;0;0;0;.00nan;0;0
46870;8108;116;43;10;2;8;.800;3600000;0
46870;8109;107;56;34;5;29;.853;3600000;0
46872;7012;109;0;0;0;0;.00nan;0;0
46872;7538;109;33;27;5;22;.815;3544000;0
46872;7993;108;68;39;4;35;.897;3600000;0
46872;8056;108;0;0;0;0;.00nan;0;0
46874;6961;110;93;36;2;34;.944;3600000;0
46874;7003;122;37;14;3;11;.786;3600000;0
46874;7966;122;0;0;0;0;.00nan;0;0
46874;8564;110;0;0;0;0;.00nan;0;0
48074;5451;151;0;0;0;0;.00nan;0;0
48074;5483;151;58;29;3;26;.897;3518000;0
48074;5810;126;96;30;1;29;.967;3600000;0
48074;6495;126;0;0;0;0;.00nan;0;0
48073;3904;140;0;0;0;0;.00nan;0;0
48073;5455;140;58;20;2;18;.900;3896000;0
48073;5732;146;95;36;2;34;.944;3900000;0
48073;6870;146;0;0;0;0;.00nan;0;0
48384;2896;133;78;30;3;27;.900;3600000;0
48384;5398;143;55;36;5;31;.861;3535000;0
48384;5541;133;0;0;0;0;.00nan;0;0
48384;5974;143;0;0;0;0;.00nan;0;0
48136;2756;131;71;5;0;5;1.000;3600000;0
48136;5536;131;0;0;0;0;.00nan;0;0
48136;5576;138;98;52;2;50;.962;3530000;0
48136;5631;138;0;0;0;0;.00nan;0;0
48077;3109;129;0;0;0;0;.00nan;0;0
48077;5385;129;77;54;5;49;.907;3566000;0
48077;5405;145;0;0;0;0;.00nan;0;0
48077;5673;145;34;19;4;15;.789;3600000;0
48086;3894;147;67;36;4;32;.889;3600000;0
48086;5423;144;24;31;7;24;.774;3600000;0
48086;5430;144;0;0;0;0;.00nan;0;0
48086;5931;147;0;0;0;0;.00nan;0;0
48070;5409;136;0;0;0;0;.00nan;0;0
48070;5426;149;54;32;5;27;.844;3600000;0
48070;5739;149;0;0;0;0;.00nan;0;0
48070;6180;136;56;23;3;20;.870;3600000;0
48090;3220;130;0;0;0;0;.00nan;0;0
48090;5693;130;51;20;3;17;.850;3600000;0
48090;5701;132;0;0;0;0;.00nan;0;0
48090;6491;132;62;36;5;31;.861;3587000;0
48103;5454;141;53;52;7;45;.865;3275000;0
48103;5462;141;52;3;0;3;1.000;325000;0
48103;5970;150;0;0;0;0;.00nan;0;0
48103;6161;150;62;16;1;15;.938;3600000;0
48218;2756;131;84;24;1;23;.958;3600000;0
48218;5536;131;0;0;0;0;.00nan;0;0
48218;5556;137;98;55;4;51;.927;3600000;0
48218;5723;137;0;0;0;0;.00nan;0;0
48085;3894;147;0;0;0;0;.00nan;0;0
48085;5398;143;0;0;0;0;.00nan;0;0
48085;5931;147;100;40;2;38;.950;3600000;0
48085;5974;143;61;34;4;30;.882;3595000;0
48905;5539;142;0;0;0;0;.00nan;0;0
48905;5711;142;97;32;1;31;.969;3600000;0
48905;5810;126;58;25;3;22;.880;3347000;0
48905;6495;126;25;6;3;3;.500;253000;0
48088;3220;130;53;13;2;11;.846;3600000;0
48088;5693;130;0;0;0;0;.00nan;0;0
48088;5732;146;47;6;1;5;.833;243000;0
48088;6870;146;37;37;6;31;.838;3357000;0
48087;3109;129;48;30;5;25;.833;3600000;0
48087;5385;129;0;0;0;0;.00nan;0;0
48087;5481;128;86;27;1;26;.963;3600000;0
48087;6936;128;0;0;0;0;.00nan;0;0
48079;2896;133;0;0;0;0;.00nan;0;0
48079;5497;135;0;0;0;0;.00nan;0;0
48079;5541;133;70;25;2;23;.920;3600000;0
48079;6545;135;32;15;4;11;.733;3584000;0
48076;3904;140;68;27;2;25;.926;3900000;0
48076;5405;145;74;29;2;27;.931;3900000;0
48076;5455;140;0;0;0;0;.00nan;0;0
48076;5673;145;0;0;0;0;.00nan;0;0
48071;3318;148;56;30;4;26;.867;3541000;0
48071;5970;150;93;40;3;37;.925;3600000;0
48071;6161;150;0;0;0;0;.00nan;0;0
48071;6184;148;0;0;0;0;.00nan;0;0
48099;5423;144;0;0;0;0;.00nan;0;0
48099;5430;144;73;9;0;9;1.000;3600000;0
48099;5454;141;0;0;0;0;.00nan;0;0
48099;5462;141;94;59;5;54;.915;3600000;0
48106;5367;127;0;0;0;0;.00nan;0;0
48106;5576;138;0;0;0;0;.00nan;0;0
48106;5631;138;64;39;5;34;.872;3600000;0
48106;6539;127;98;25;0;25;1.000;3600000;0
48348;5451;151;0;0;0;0;.00nan;0;0
48348;5483;151;77;32;2;30;.938;3600000;0
48348;5556;137;0;0;0;0;.00nan;0;0
48348;5723;137;79;12;0;12;1.000;3600000;0
48069;5426;149;0;0;0;0;.00nan;0;0
48069;5621;139;0;0;0;0;.00nan;0;0
48069;5739;149;64;36;4;32;.889;3900000;0
48069;5821;139;52;31;4;27;.871;3900000;0
48081;5409;136;48;39;5;34;.872;3600000;0
48081;5497;135;100;25;0;25;1.000;3600000;0
48081;6180;136;0;0;0;0;.00nan;0;0
48081;6545;135;0;0;0;0;.00nan;0;0
48965;3904;140;0;0;0;0;.00nan;0;0
48965;5455;140;84;39;2;37;.949;3600000;0
48965;5970;150;0;0;0;0;.00nan;0;0
48965;6161;150;45;35;6;29;.829;3600000;0
48084;5426;149;98;42;2;40;.952;3580000;0
48084;5701;132;0;0;0;0;.00nan;0;0
48084;5739;149;0;0;0;0;.00nan;0;0
48084;6491;132;94;19;0;19;1.000;3600000;0
48121;2756;131;64;15;1;14;.933;3600000;0
48121;5398;143;68;45;5;40;.889;2845000;0
48121;5536;131;0;0;0;0;.00nan;0;0
48121;5974;143;15;9;4;5;.556;755000;0
48117;5481;128;0;0;0;0;.00nan;0;0
48117;5810;126;47;18;3;15;.833;3567000;0
48117;6495;126;0;0;0;0;.00nan;0;0
48117;6936;128;79;35;2;33;.943;3600000;0
48072;3318;148;0;0;0;0;.00nan;0;0
48072;5539;142;0;0;0;0;.00nan;0;0
48072;5711;142;53;27;4;23;.852;3554000;0
48072;6184;148;74;42;3;39;.929;3600000;0
48068;5409;136;0;0;0;0;.00nan;0;0
48068;5434;134;0;0;0;0;.00nan;0;0
48068;6180;136;69;36;3;33;.917;3600000;0
48068;6187;134;79;22;2;20;.909;3600000;0
48108;5367;127;0;0;0;0;.00nan;0;0
48108;5701;132;0;0;0;0;.00nan;0;0
48108;6491;132;90;34;1;33;.971;3600000;0
48108;6539;127;100;25;0;25;1.000;3600000;0
48162;5451;151;55;30;4;26;.867;3538000;0
48162;5483;151;0;0;0;0;.00nan;0;0
48162;5556;137;0;0;0;0;.00nan;0;0
48162;5723;137;71;27;2;25;.926;3600000;0
48116;5481;128;53;43;6;37;.860;3600000;0
48116;5539;142;40;15;3;12;.800;3600000;0
48116;5711;142;0;0;0;0;.00nan;0;0
48116;6936;128;0;0;0;0;.00nan;0;0
48113;5576;138;0;0;0;0;.00nan;0;0
48113;5631;138;20;19;5;14;.737;3600000;0
48113;5732;146;89;35;2;33;.943;3600000;0
48113;6870;146;0;0;0;0;.00nan;0;0
48096;3109;129;0;0;0;0;.00nan;0;0
48096;5385;129;72;41;4;37;.902;3900000;0
48096;5810;126;0;0;0;0;.00nan;0;0
48096;6495;126;51;27;4;23;.852;3900000;0
48947;3318;148;68;30;4;26;.867;3545000;0
48947;3894;147;0;0;0;0;.00nan;0;0
48947;5931;147;74;32;3;29;.906;3600000;0
48947;6184;148;0;0;0;0;.00nan;0;0
48080;5423;144;0;0;0;0;.00nan;0;0
48080;5430;144;73;18;1;17;.944;3600000;0
48080;5497;135;38;33;6;27;.818;2467000;0
48080;6545;135;69;14;0;14;1.000;1133000;0
48075;5454;141;92;42;2;40;.952;3600000;0
48075;5462;141;0;0;0;0;.00nan;0;0
48075;5621;139;55;26;3;23;.885;3570000;0
48075;5821;139;0;0;0;0;.00nan;0;0
48089;5434;134;58;27;3;24;.889;3600000;0
48089;5970;150;58;42;5;37;.881;3514000;0
48089;6161;150;0;0;0;0;.00nan;0;0
48089;6187;134;0;0;0;0;.00nan;0;0
48920;2756;131;61;19;2;17;.895;3600000;0
48920;5409;136;61;46;5;41;.891;3600000;0
48920;5536;131;0;0;0;0;.00nan;0;0
48920;6180;136;0;0;0;0;.00nan;0;0
48095;3220;130;0;0;0;0;.00nan;0;0
48095;5367;127;0;0;0;0;.00nan;0;0
48095;5693;130;69;37;4;33;.892;3600000;0
48095;6539;127;67;16;1;15;.938;3600000;0
48189;2896;133;73;21;1;20;.952;3600000;0
48189;3904;140;0;0;0;0;.00nan;0;0
48189;5455;140;93;44;2;42;.955;3582000;0
48189;5541;133;0;0;0;0;.00nan;0;0
48938;5398;143;71;48;5;43;.896;3577000;0
48938;5556;137;50;24;3;21;.875;3600000;0
48938;5723;137;0;0;0;0;.00nan;0;0
48938;5974;143;0;0;0;0;.00nan;0;0
48875;5423;144;74;10;0;10;1.000;3600000;0
48875;5426;149;0;0;0;0;.00nan;0;0
48875;5430;144;0;0;0;0;.00nan;0;0
48875;5739;149;92;62;5;57;.919;3600000;0
48930;3109;129;66;37;4;33;.892;3600000;0
48930;5385;129;0;0;0;0;.00nan;0;0
48930;5497;135;0;0;0;0;.00nan;0;0
48930;6545;135;87;29;1;28;.966;3600000;0
48091;3894;147;0;0;0;0;.00nan;0;0
48091;5434;134;0;0;0;0;.00nan;0;0
48091;5931;147;78;29;2;27;.931;3600000;0
48091;6187;134;29;29;6;23;.793;3600000;0
48078;5405;145;0;0;0;0;.00nan;0;0
48078;5621;139;0;0;0;0;.00nan;0;0
48078;5673;145;76;20;1;19;.950;3600000;0
48078;5821;139;64;36;5;31;.861;3600000;0
48153;3318;148;77;26;1;25;.962;3600000;0
48153;5666;142;0;0;0;0;.00nan;0;0
48153;5711;142;65;38;4;34;.895;3600000;0
48153;6184;148;0;0;0;0;.00nan;0;0
48909;2896;133;0;0;0;0;.00nan;0;0
48909;5451;151;0;0;0;0;.00nan;0;0
48909;5483;151;51;38;5;33;.868;3600000;0
48909;5541;133;64;19;1;18;.947;3600000;0
48083;3894;147;58;24;3;21;.875;3900000;0
48083;5621;139;61;35;3;32;.914;3900000;0
48083;5821;139;0;0;0;0;.00nan;0;0
48083;5931;147;0;0;0;0;.00nan;0;0
48229;3904;140;0;0;0;0;.00nan;0;0
48229;5455;140;97;66;4;62;.939;3600000;0
48229;5666;142;54;10;1;9;.900;3600000;0
48229;5711;142;0;0;0;0;.00nan;0;0
48219;3109;129;62;32;3;29;.906;3900000;0
48219;5385;129;0;0;0;0;.00nan;0;0
48219;5481;128;0;0;0;0;.00nan;0;0
48219;6936;128;55;31;3;28;.903;3900000;0
48114;3220;130;43;26;4;22;.846;3596000;0
48114;5367;127;72;33;3;30;.909;3600000;0
48114;5693;130;0;0;0;0;.00nan;0;0
48114;6539;127;0;0;0;0;.00nan;0;0
48124;5556;137;66;18;1;17;.944;3600000;0
48124;5723;137;0;0;0;0;.00nan;0;0
48124;5732;146;97;60;3;57;.950;3582000;0
48124;6870;146;0;0;0;0;.00nan;0;0
48097;5398;143;0;0;0;0;.00nan;0;0
48097;5497;135;0;0;0;0;.00nan;0;0
48097;5974;143;59;34;4;30;.882;3600000;0
48097;6545;135;70;16;1;15;.938;3600000;0
48111;2756;131;81;12;0;12;1.000;3600000;0
48111;5423;144;79;47;4;43;.915;3600000;0
48111;5430;144;0;0;0;0;.00nan;0;0
48111;5536;131;0;0;0;0;.00nan;0;0
48945;5409;136;94;17;0;17;1.000;3600000;0
48945;5434;134;87;41;3;38;.927;3600000;0
48945;6180;136;0;0;0;0;.00nan;0;0
48945;6187;134;0;0;0;0;.00nan;0;0
48230;3109;129;0;0;0;0;.00nan;0;0
48230;5385;129;89;46;2;44;.957;3900000;0
48230;5970;150;0;0;0;0;.00nan;0;0
48230;6161;150;71;24;2;22;.917;3900000;0
48148;3318;148;0;0;0;0;.00nan;0;0
48148;5409;136;0;0;0;0;.00nan;0;0
48148;6180;136;91;47;3;44;.936;3600000;0
48148;6184;148;36;21;4;17;.810;3540000;0
48191;5556;137;0;0;0;0;.00nan;0;0
48191;5701;132;0;0;0;0;.00nan;0;0
48191;5723;137;90;55;3;52;.945;3530000;0
48191;6491;132;56;12;1;11;.917;3600000;0
48094;5405;145;0;0;0;0;.00nan;0;0
48094;5673;145;51;29;4;25;.862;3600000;0
48094;5810;126;87;22;0;22;1.000;3600000;0
48094;6495;126;0;0;0;0;.00nan;0;0
48098;2896;133;87;27;1;26;.963;3732000;0
48098;5497;135;74;28;2;26;.929;3732000;0
48098;5541;133;0;0;0;0;.00nan;0;0
48098;6545;135;0;0;0;0;.00nan;0;0
48102;5426;149;0;0;0;0;.00nan;0;0
48102;5732;146;0;0;0;0;.00nan;0;0
48102;5739;149;65;22;2;20;.909;3600000;0
48102;6870;146;54;32;5;27;.844;3600000;0
48119;5481;128;86;50;4;46;.920;3600000;0
48119;5576;138;66;23;3;20;.870;3600000;0
48119;5631;138;0;0;0;0;.00nan;0;0
48119;6936;128;0;0;0;0;.00nan;0;0
48115;5398;143;59;16;2;14;.875;3600000;0
48115;5454;141;48;37;5;32;.865;3600000;0
48115;5462;141;0;0;0;0;.00nan;0;0
48115;5974;143;0;0;0;0;.00nan;0;0
48101;5434;134;76;62;7;55;.887;3600000;0
48101;5666;142;0;0;0;0;.00nan;0;0
48101;5711;142;84;12;0;12;1.000;3600000;0
48101;6187;134;0;0;0;0;.00nan;0;0
48143;5454;141;0;0;0;0;.00nan;0;0
48143;5462;141;89;57;5;52;.912;3600000;0
48143;5970;150;51;11;2;9;.818;3600000;0
48143;6161;150;0;0;0;0;.00nan;0;0
48092;5423;144;55;14;1;13;.929;3600000;0
48092;5430;144;0;0;0;0;.00nan;0;0
48092;5621;139;0;0;0;0;.00nan;0;0
48092;5821;139;63;42;5;37;.881;3600000;0
48131;3220;130;94;23;0;23;1.000;3600000;0
48131;5576;138;0;0;0;0;.00nan;0;0
48131;5631;138;63;29;3;26;.897;3600000;0
48131;5693;130;0;0;0;0;.00nan;0;0
48118;3904;140;0;0;0;0;.00nan;0;0
48118;5455;140;75;42;3;39;.929;3900000;0
48118;5701;132;69;30;3;27;.900;3900000;0
48118;6491;132;0;0;0;0;.00nan;0;0
48926;5481;128;94;48;3;45;.938;3495000;0
48926;5497;135;0;0;0;0;.00nan;0;0
48926;6545;135;60;17;2;15;.882;3600000;0
48926;6936;128;23;5;3;2;.400;105000;0
48178;5409;136;45;42;6;36;.857;3600000;0
48178;5666;142;0;0;0;0;.00nan;0;0
48178;5711;142;77;9;0;9;1.000;3600000;0
48178;6180;136;0;0;0;0;.00nan;0;0
48082;3318;148;97;22;0;22;1.000;3600000;0
48082;5405;145;18;25;6;19;.760;2045000;0
48082;5673;145;60;20;2;18;.900;1555000;0
48082;6184;148;0;0;0;0;.00nan;0;0
48104;2896;133;33;26;5;21;.808;3600000;0
48104;5434;134;0;0;0;0;.00nan;0;0
48104;5541;133;0;0;0;0;.00nan;0;0
48104;6187;134;43;36;6;30;.833;3571000;0
48949;3894;147;50;0;0;0;.00nan;82000;0
48949;5732;146;96;49;2;47;.959;3550000;0
48949;5931;147;63;12;1;11;.917;3518000;0
48949;6870;146;0;0;0;0;.00nan;0;0
48125;5398;143;65;25;2;23;.920;3600000;0
48125;5426;149;33;32;6;26;.813;2444000;0
48125;5739;149;51;5;1;4;.800;1156000;0
48125;5974;143;0;0;0;0;.00nan;0;0
48126;5367;127;0;0;0;0;.00nan;0;0
48126;5423;144;0;0;0;0;.00nan;0;0
48126;5430;144;99;24;0;24;1.000;3600000;0
48126;6539;127;64;29;3;26;.897;3600000;0
48184;5481;128;0;0;0;0;.00nan;0;0
48184;5810;126;61;11;1;10;.909;3600000;0
48184;6495;126;0;0;0;0;.00nan;0;0
48184;6936;128;87;64;5;59;.922;3600000;0
48157;3318;148;33;19;4;15;.789;3514000;0
48157;3904;140;80;34;2;32;.941;3600000;0
48157;5455;140;0;0;0;0;.00nan;0;0
48157;6184;148;0;0;0;0;.00nan;0;0
48093;3894;147;62;21;2;19;.905;3600000;0
48093;5405;145;0;0;0;0;.00nan;0;0
48093;5542;147;0;0;0;0;.00nan;0;0
48093;5673;145;57;38;5;33;.868;3600000;0
48110;5497;135;77;23;2;21;.913;3600000;0
48110;5576;138;46;32;5;27;.844;3108000;0
48110;5631;138;26;7;3;4;.571;492000;0
48110;6545;135;0;0;0;0;.00nan;0;0
48100;5409;136;72;14;0;14;1.000;1341000;0
48100;5621;139;0;0;0;0;.00nan;0;0
48100;5821;139;79;24;1;23;.958;3600000;0
48100;6180;136;32;31;6;25;.806;2259000;0
48133;5426;149;0;0;0;0;.00nan;0;0
48133;5556;137;0;0;0;0;.00nan;0;0
48133;5723;137;65;15;1;14;.933;3600000;0
48133;5739;149;74;32;3;29;.906;3565000;0
48290;5451;151;0;0;0;0;.00nan;0;0
48290;5483;151;76;33;3;30;.909;3819000;0
48290;5970;150;64;33;4;29;.879;3819000;0
48290;6161;150;0;0;0;0;.00nan;0;0
48123;2896;133;0;0;0;0;.00nan;0;0
48123;3220;130;44;13;2;11;.846;3600000;0
48123;5541;133;52;38;5;33;.868;3600000;0
48123;5693;130;0;0;0;0;.00nan;0;0
48167;2756;131;62;14;1;13;.929;3600000;0
48167;5367;127;90;43;2;41;.953;3593000;0
48167;5536;131;0;0;0;0;.00nan;0;0
48167;6539;127;0;0;0;0;.00nan;0;0
48149;5454;141;62;37;4;33;.892;3600000;0
48149;5462;141;0;0;0;0;.00nan;0;0
48149;5732;146;0;0;0;0;.00nan;0;0
48149;6870;146;57;43;6;37;.860;3541000;0
48882;3220;130;0;0;0;0;.00nan;0;0
48882;5556;137;60;25;3;22;.880;3597000;0
48882;5693;130;75;28;2;26;.929;3600000;0
48882;5723;137;0;0;0;0;.00nan;0;0
48566;5576;138;0;0;0;0;.00nan;0;0
48566;5631;138;91;36;1;35;.972;3600000;0
48566;5970;150;0;0;0;0;.00nan;0;0
48566;6161;150;66;22;2;20;.909;3555000;0
48941;5398;143;43;40;6;34;.850;3600000;0
48941;5423;144;0;0;0;0;.00nan;0;0
48941;5430;144;84;25;1;24;.960;3600000;0
48941;5974;143;0;0;0;0;.00nan;0;0
48220;5701;132;0;0;0;0;.00nan;0;0
48220;5810;126;0;0;0;0;.00nan;0;0
48220;6491;132;31;22;5;17;.773;3600000;0
48220;6495;126;81;45;4;41;.911;3600000;0
48107;3109;129;63;29;3;26;.897;3600000;0
48107;5385;129;0;0;0;0;.00nan;0;0
48107;5434;134;61;35;5;30;.857;3572000;0
48107;6187;134;0;0;0;0;.00nan;0;0
48109;2756;131;68;16;1;15;.938;3600000;0
48109;3894;147;59;33;4;29;.879;3600000;0
48109;5536;131;0;0;0;0;.00nan;0;0
48109;5542;147;0;0;0;0;.00nan;0;0
48932;5481;128;64;41;4;37;.902;3289000;0
48932;5810;126;64;14;1;13;.929;3600000;0
48932;6495;126;0;0;0;0;.00nan;0;0
48932;6936;128;25;5;3;2;.400;311000;0
48954;3220;130;74;43;4;39;.907;3564000;0
48954;3318;148;59;22;2;20;.909;3600000;0
48954;5693;130;0;0;0;0;.00nan;0;0
48954;6184;148;0;0;0;0;.00nan;0;0
48120;3894;147;0;0;0;0;.00nan;0;0
48120;5542;147;91;48;3;45;.938;3600000;0
48120;5666;142;0;0;0;0;.00nan;0;0
48120;5711;142;94;27;0;27;1.000;3600000;0
48152;2896;133;58;19;2;17;.895;3600000;0
48152;5409;136;44;38;6;32;.842;3600000;0
48152;5541;133;0;0;0;0;.00nan;0;0
48152;6180;136;0;0;0;0;.00nan;0;0
48139;3109;129;0;0;0;0;.00nan;0;0
48139;5385;129;74;44;4;40;.909;3600000;0
48139;5576;138;0;0;0;0;.00nan;0;0
48139;5631;138;46;31;5;26;.839;3572000;0
48128;5398;143;0;0;0;0;.00nan;0;0
48128;5732;146;46;51;7;44;.863;3600000;0
48128;5974;143;37;13;3;10;.769;3600000;0
48128;6870;146;0;0;0;0;.00nan;0;0
48725;2756;131;0;0;0;0;.00nan;0;0
48725;5451;151;0;0;0;0;.00nan;0;0
48725;5483;151;62;51;6;45;.882;3600000;0
48725;5536;131;66;15;1;14;.933;3600000;0
48181;5426;149;43;18;3;15;.833;3600000;0
48181;5454;141;70;41;5;36;.878;3578000;0
48181;5462;141;0;0;0;0;.00nan;0;0
48181;5739;149;0;0;0;0;.00nan;0;0
48112;5556;137;0;0;0;0;.00nan;0;0
48112;5621;139;64;24;2;22;.917;3600000;0
48112;5723;137;53;43;6;37;.860;3600000;0
48112;5821;139;0;0;0;0;.00nan;0;0
48129;3318;148;48;33;5;28;.848;3599000;0
48129;5423;144;0;0;0;0;.00nan;0;0
48129;5430;144;67;36;4;32;.889;3600000;0
48129;6184;148;0;0;0;0;.00nan;0;0
48303;5367;127;64;33;4;29;.879;3574000;0
48303;5666;142;0;0;0;0;.00nan;0;0
48303;5711;142;60;22;2;20;.909;3600000;0
48303;6539;127;0;0;0;0;.00nan;0;0
48127;5497;135;0;0;0;0;.00nan;0;0
48127;5701;132;0;0;0;0;.00nan;0;0
48127;6491;132;59;35;5;30;.857;3600000;0
48127;6545;135;75;24;1;23;.958;3600000;0
48142;5434;134;45;20;3;17;.850;3600000;0
48142;5556;137;56;40;5;35;.875;3578000;0
48142;5723;137;0;0;0;0;.00nan;0;0
48142;6187;134;0;0;0;0;.00nan;0;0
48138;3220;130;94;30;1;29;.967;3600000;0
48138;3904;140;0;0;0;0;.00nan;0;0
48138;5455;140;65;23;2;21;.913;3568000;0
48138;5693;130;0;0;0;0;.00nan;0;0
48620;5451;151;55;46;6;40;.870;3600000;0
48620;5483;151;0;0;0;0;.00nan;0;0
48620;5576;138;74;22;2;20;.909;3600000;0
48620;5631;138;0;0;0;0;.00nan;0;0
48140;5426;149;0;0;0;0;.00nan;0;0
48140;5739;149;83;37;2;35;.946;3600000;0
48140;5970;150;37;17;4;13;.765;3600000;0
48140;6161;150;0;0;0;0;.00nan;0;0
48144;2896;133;0;0;0;0;.00nan;0;0
48144;5541;133;43;34;5;29;.853;3600000;0
48144;5810;126;0;0;0;0;.00nan;0;0
48144;6495;126;88;42;3;39;.929;3600000;0
48105;5405;145;61;17;1;16;.941;3600000;0
48105;5673;145;0;0;0;0;.00nan;0;0
48105;5732;146;0;0;0;0;.00nan;0;0
48105;6870;146;93;45;2;43;.956;3600000;0
48141;5398;143;75;21;1;20;.952;3600000;0
48141;5454;141;0;0;0;0;.00nan;0;0
48141;5462;141;49;40;6;34;.850;3600000;0
48141;5974;143;0;0;0;0;.00nan;0;0
48944;5409;136;86;39;2;37;.949;3562000;0
48944;5970;150;0;0;0;0;.00nan;0;0
48944;6161;150;100;38;1;37;.974;3600000;0
48944;6180;136;0;0;0;0;.00nan;0;0
48130;5434;134;71;29;2;27;.931;2902000;0
48130;5497;135;31;27;6;21;.778;2575000;0
48130;6187;134;44;23;4;19;.826;998000;0
48130;6545;135;62;6;0;6;1.000;1325000;0
48145;5423;144;13;20;6;14;.700;3600000;0
48145;5430;144;0;0;0;0;.00nan;0;0
48145;5621;139;47;46;7;39;.848;3600000;0
48145;5821;139;0;0;0;0;.00nan;0;0
48122;5405;145;90;17;0;17;1.000;3600000;0
48122;5576;138;21;23;6;17;.739;2518000;0
48122;5631;138;74;14;0;14;1.000;1082000;0
48122;5673;145;0;0;0;0;.00nan;0;0
48166;3904;140;0;0;0;0;.00nan;0;0
48166;5426;149;0;0;0;0;.00nan;0;0
48166;5455;140;64;18;2;16;.889;3600000;0
48166;5739;149;75;33;3;30;.909;3565000;0
48151;5398;143;67;25;3;22;.880;3528000;0
48151;5810;126;0;0;0;0;.00nan;0;0
48151;5974;143;0;0;0;0;.00nan;0;0
48151;6495;126;93;27;1;26;.963;3600000;0
48177;3109;129;0;0;0;0;.00nan;0;0
48177;5385;129;81;46;3;43;.935;3543000;0
48177;5701;132;0;0;0;0;.00nan;0;0
48177;6491;132;62;20;2;18;.900;3600000;0
48159;3220;130;58;24;3;21;.875;3900000;0
48159;5481;128;0;0;0;0;.00nan;0;0
48159;5693;130;0;0;0;0;.00nan;0;0
48159;6936;128;71;38;3;35;.921;3900000;0
48155;3318;148;52;29;4;25;.862;3600000;0
48155;3894;147;51;36;6;30;.833;3600000;0
48155;5542;147;0;0;0;0;.00nan;0;0
48155;6184;148;0;0;0;0;.00nan;0;0
48363;5367;127;0;0;0;0;.00nan;0;0
48363;5451;151;98;50;3;47;.940;3600000;0
48363;5483;151;0;0;0;0;.00nan;0;0
48363;6539;127;57;17;2;15;.882;3600000;0
48197;3894;147;0;0;0;0;.00nan;0;0
48197;5542;147;67;19;1;18;.947;3600000;0
48197;5970;150;71;26;2;24;.923;3597000;0
48197;6161;150;0;0;0;0;.00nan;0;0
48209;5481;128;73;48;5;43;.896;3600000;0
48209;5556;137;0;0;0;0;.00nan;0;0
48209;5723;137;64;16;1;15;.938;3600000;0
48209;6936;128;0;0;0;0;.00nan;0;0
48925;5426;149;63;30;3;27;.900;3600000;0
48925;5454;141;89;36;2;34;.944;3600000;0
48925;5462;141;0;0;0;0;.00nan;0;0
48925;5739;149;0;0;0;0;.00nan;0;0
48228;3109;129;35;18;4;14;.778;991000;0
48228;5385;129;80;48;4;44;.917;2609000;0
48228;5666;142;0;0;0;0;.00nan;0;0
48228;5711;142;64;15;1;14;.933;3600000;0
48168;5409;136;93;56;3;53;.946;3600000;0
48168;5497;135;0;0;0;0;.00nan;0;0
48168;6180;136;0;0;0;0;.00nan;0;0
48168;6545;135;99;19;0;19;1.000;3600000;0
48132;5405;145;73;25;1;24;.960;3600000;0
48132;5673;145;0;0;0;0;.00nan;0;0
48132;5732;146;84;51;5;46;.902;3600000;0
48132;6870;146;0;0;0;0;.00nan;0;0
48161;2896;133;66;34;4;30;.882;3600000;0
48161;5541;133;0;0;0;0;.00nan;0;0
48161;5701;132;26;6;3;3;.500;225000;0
48161;6491;132;54;19;2;17;.895;3375000;0
48160;3220;130;76;24;1;23;.958;3600000;0
48160;5693;130;0;0;0;0;.00nan;0;0
48160;5810;126;37;29;6;23;.793;3047000;0
48160;6495;126;48;8;1;7;.875;553000;0
48163;5367;127;86;33;2;31;.939;3550000;0
48163;5423;144;73;20;1;19;.950;3600000;0
48163;5430;144;0;0;0;0;.00nan;0;0
48163;6539;127;0;0;0;0;.00nan;0;0
48134;2756;131;53;16;2;14;.875;3600000;0
48134;5434;134;38;29;5;24;.828;2225000;0
48134;5536;131;0;0;0;0;.00nan;0;0
48134;6187;134;63;26;2;24;.923;1375000;0
48173;3904;140;62;24;2;22;.917;3600000;0
48173;5455;140;0;0;0;0;.00nan;0;0
48173;5621;139;0;0;0;0;.00nan;0;0
48173;5821;139;49;27;4;23;.852;3564000;0
48931;2896;133;0;0;0;0;.00nan;0;0
48931;5541;133;69;23;2;21;.913;3600000;0
48931;5576;138;89;46;3;43;.935;3550000;0
48931;5631;138;0;0;0;0;.00nan;0;0
48182;2756;131;0;0;0;0;.00nan;0;0
48182;5454;141;51;43;6;37;.860;2202000;0
48182;5462;141;91;32;1;31;.969;1398000;0
48182;5536;131;48;9;2;7;.778;3600000;0
48943;5398;143;0;0;0;0;.00nan;0;0
48943;5556;137;88;52;4;48;.923;3600000;0
48943;5723;137;0;0;0;0;.00nan;0;0
48943;5974;143;78;21;1;20;.952;3600000;0
48921;3904;140;67;25;2;23;.920;1422000;0
48921;5455;140;31;30;6;24;.800;2178000;0
48921;5666;142;0;0;0;0;.00nan;0;0
48921;5711;142;51;16;2;14;.875;3600000;0
48195;3318;148;52;21;3;18;.857;3600000;0
48195;5970;150;55;11;1;10;.909;800000;0
48195;6161;150;30;41;7;34;.829;2800000;0
48195;6184;148;0;0;0;0;.00nan;0;0
48194;5409;136;53;27;3;24;.889;3900000;0
48194;5481;128;0;0;0;0;.00nan;0;0
48194;6180;136;0;0;0;0;.00nan;0;0
48194;6936;128;82;34;3;31;.912;3900000;0
48946;5405;145;67;20;2;18;.900;3600000;0
48946;5451;151;53;3;0;3;1.000;288000;0
48946;5483;151;31;36;7;29;.806;3312000;0
48946;5673;145;0;0;0;0;.00nan;0;0
48948;5497;135;0;0;0;0;.00nan;0;0
48948;5556;137;0;0;0;0;.00nan;0;0
48948;5723;137;82;40;3;37;.925;3548000;0
48948;6545;135;57;17;2;15;.882;3600000;0
48170;3109;129;49;32;5;27;.844;3549000;0
48170;5385;129;0;0;0;0;.00nan;0;0
48170;5423;144;51;18;3;15;.833;3600000;0
48170;5602;144;0;0;0;0;.00nan;0;0
48970;3894;147;57;12;1;11;.917;3600000;0
48970;5451;151;55;44;5;39;.886;3600000;0
48970;5483;151;0;0;0;0;.00nan;0;0
48970;5542;147;0;0;0;0;.00nan;0;0
48154;3220;130;88;27;1;26;.963;3600000;0
48154;5405;145;75;27;2;25;.926;3566000;0
48154;5673;145;0;0;0;0;.00nan;0;0
48154;5693;130;0;0;0;0;.00nan;0;0
48362;5481;128;71;34;3;31;.912;3600000;0
48362;5576;138;55;29;4;25;.862;3559000;0
48362;5631;138;0;0;0;0;.00nan;0;0
48362;6936;128;0;0;0;0;.00nan;0;0
48204;2896;133;86;27;1;26;.963;3600000;0
48204;5541;133;0;0;0;0;.00nan;0;0
48204;5810;126;0;0;0;0;.00nan;0;0
48204;6495;126;72;32;4;28;.875;3600000;0
48137;5426;149;0;0;0;0;.00nan;0;0
48137;5732;146;78;38;3;35;.921;3600000;0
48137;5739;149;73;30;2;28;.933;3600000;0
48137;6870;146;0;0;0;0;.00nan;0;0
48924;2756;131;100;27;0;27;1.000;3600000;0
48924;5398;143;81;41;3;38;.927;3600000;0
48924;5536;131;0;0;0;0;.00nan;0;0
48924;5974;143;0;0;0;0;.00nan;0;0
48221;5367;127;72;33;3;30;.909;3600000;0
48221;5970;150;0;0;0;0;.00nan;0;0
48221;6161;150;61;32;4;28;.875;3600000;0
48221;6539;127;0;0;0;0;.00nan;0;0
48169;3220;130;63;15;1;14;.933;3600000;0
48169;5454;141;72;42;3;39;.929;3545000;0
48169;5462;141;0;0;0;0;.00nan;0;0
48169;5693;130;0;0;0;0;.00nan;0;0
48158;3109;129;0;0;0;0;.00nan;0;0
48158;5385;129;29;39;7;32;.821;3600000;0
48158;5434;134;82;26;1;25;.962;3600000;0
48158;6187;134;0;0;0;0;.00nan;0;0
48147;3894;147;0;0;0;0;.00nan;0;0
48147;5542;147;61;21;2;19;.905;3600000;0
48147;5732;146;0;0;0;0;.00nan;0;0
48147;6870;146;69;54;6;48;.889;3600000;0
48171;2896;133;0;0;0;0;.00nan;0;0
48171;5409;136;0;0;0;0;.00nan;0;0
48171;5541;133;57;25;3;22;.880;3600000;0
48171;6180;136;66;38;4;34;.895;3565000;0
48193;5426;149;70;26;3;23;.885;3552000;0
48193;5739;149;0;0;0;0;.00nan;0;0
48193;5810;126;62;26;2;24;.923;3600000;0
48193;6495;126;0;0;0;0;.00nan;0;0
48190;5398;143;68;60;6;54;.900;3568000;0
48190;5666;142;0;0;0;0;.00nan;0;0
48190;5711;142;22;10;4;6;.600;3600000;0
48190;5974;143;0;0;0;0;.00nan;0;0
48196;5423;144;85;31;2;29;.935;3585000;0
48196;5602;144;0;0;0;0;.00nan;0;0
48196;5701;132;0;0;0;0;.00nan;0;0
48196;6491;132;100;25;0;25;1.000;3600000;0
48200;3904;140;0;0;0;0;.00nan;0;0
48200;5455;140;78;34;3;31;.912;3569000;0
48200;5621;139;49;17;2;15;.882;3600000;0
48200;5821;139;0;0;0;0;.00nan;0;0
48345;5556;137;78;22;1;21;.955;3600000;0
48345;5576;138;0;0;0;0;.00nan;0;0
48345;5631;138;38;23;4;19;.826;3600000;0
48345;5723;137;0;0;0;0;.00nan;0;0
48206;3318;148;62;22;2;20;.909;3600000;0
48206;5621;139;0;0;0;0;.00nan;0;0
48206;5821;139;91;49;3;46;.939;3600000;0
48206;6184;148;0;0;0;0;.00nan;0;0
48461;5367;127;0;0;0;0;.00nan;0;0
48461;5451;151;91;49;3;46;.939;3600000;0
48461;5483;151;0;0;0;0;.00nan;0;0
48461;6539;127;80;11;0;11;1.000;3600000;0
48405;5409;136;78;38;4;34;.895;3884000;0
48405;5576;138;0;0;0;0;.00nan;0;0
48405;5631;138;78;34;3;31;.912;3884000;0
48405;6180;136;0;0;0;0;.00nan;0;0
48164;5405;145;52;38;5;33;.868;3549000;0
48164;5434;134;53;23;4;19;.826;3600000;0
48164;5673;145;0;0;0;0;.00nan;0;0
48164;6187;134;0;0;0;0;.00nan;0;0
48187;3318;148;62;22;2;20;.909;3600000;0
48187;5398;143;0;0;0;0;.00nan;0;0
48187;5974;143;79;38;3;35;.921;3556000;0
48187;6184;148;0;0;0;0;.00nan;0;0
48199;5423;144;65;16;1;15;.938;3900000;0
48199;5602;144;0;0;0;0;.00nan;0;0
48199;5810;126;100;48;1;47;.979;3900000;0
48199;6495;126;0;0;0;0;.00nan;0;0
48180;3109;129;98;27;1;26;.963;3600000;0
48180;5385;129;0;0;0;0;.00nan;0;0
48180;5556;137;75;37;3;34;.919;3586000;0
48180;5723;137;0;0;0;0;.00nan;0;0
48175;3220;130;100;39;0;39;1.000;3600000;0
48175;5693;130;0;0;0;0;.00nan;0;0
48175;5701;132;0;0;0;0;.00nan;0;0
48175;6491;132;69;21;2;19;.905;3600000;0
48174;5454;141;86;51;3;48;.941;3539000;0
48174;5462;141;0;0;0;0;.00nan;0;0
48174;5497;135;0;0;0;0;.00nan;0;0
48174;6545;135;56;10;1;9;.900;3600000;0
48347;5451;151;61;7;0;7;1.000;485000;0
48347;5483;151;52;42;6;36;.857;3115000;0
48347;5970;150;53;17;2;15;.882;3600000;0
48347;6161;150;0;0;0;0;.00nan;0;0
48146;3894;147;72;8;0;8;1.000;3600000;0
48146;5542;147;0;0;0;0;.00nan;0;0
48146;5732;146;67;44;5;39;.886;3600000;0
48146;6870;146;0;0;0;0;.00nan;0;0
48179;2896;133;0;0;0;0;.00nan;0;0
48179;5541;133;85;30;2;28;.933;3600000;0
48179;5666;142;100;24;0;24;1.000;3600000;0
48179;5711;142;0;0;0;0;.00nan;0;0
48186;5454;141;24;12;4;8;.667;774000;0
48186;5462;141;65;54;6;48;.889;2826000;0
48186;5666;142;50;8;1;7;.875;3600000;0
48186;5711;142;0;0;0;0;.00nan;0;0
48201;3894;147;49;16;3;13;.813;3600000;0
48201;5398;143;53;29;4;25;.862;3590000;0
48201;5542;147;0;0;0;0;.00nan;0;0
48201;5974;143;0;0;0;0;.00nan;0;0
48904;3220;130;71;38;4;34;.895;3724000;0
48904;5621;139;53;24;3;21;.875;3724000;0
48904;5693;130;0;0;0;0;.00nan;0;0
48904;5821;139;0;0;0;0;.00nan;0;0
48227;3904;140;0;0;0;0;.00nan;0;0
48227;5455;140;42;25;4;21;.840;3600000;0
48227;5556;137;0;0;0;0;.00nan;0;0
48227;5723;137;100;33;1;32;.970;3600000;0
48150;5434;134;0;0;0;0;.00nan;0;0
48150;5497;135;56;26;3;23;.885;3554000;0
48150;6187;134;96;29;1;28;.966;3600000;0
48150;6545;135;0;0;0;0;.00nan;0;0
48434;2756;131;48;9;2;7;.778;3600000;0
48434;5536;131;0;0;0;0;.00nan;0;0
48434;5970;150;0;0;0;0;.00nan;0;0
48434;6161;150;70;53;6;47;.887;3600000;0
48470;5367;127;0;0;0;0;.00nan;0;0
48470;5481;128;0;0;0;0;.00nan;0;0
48470;6539;127;42;11;2;9;.818;3600000;0
48470;6936;128;72;46;4;42;.913;3574000;0
48933;5423;144;0;0;0;0;.00nan;0;0
48933;5576;138;28;34;7;27;.794;2067000;0
48933;5602;144;68;19;1;18;.947;3600000;0
48933;5631;138;59;20;2;18;.900;1533000;0
48216;5426;149;0;0;0;0;.00nan;0;0
48216;5701;132;66;18;1;17;.944;3600000;0
48216;5739;149;69;40;3;37;.925;3577000;0
48216;6491;132;0;0;0;0;.00nan;0;0
48135;5405;145;43;17;3;14;.824;3600000;0
48135;5481;128;96;54;4;50;.926;3600000;0
48135;5673;145;0;0;0;0;.00nan;0;0
48135;6936;128;0;0;0;0;.00nan;0;0
48207;5451;151;96;45;2;43;.956;3600000;0
48207;5483;151;0;0;0;0;.00nan;0;0
48207;5621;139;0;0;0;0;.00nan;0;0
48207;5821;139;43;21;4;17;.810;3600000;0
48176;5409;136;0;0;0;0;.00nan;0;0
48176;5497;135;0;0;0;0;.00nan;0;0
48176;6180;136;90;44;3;41;.932;3600000;0
48176;6545;135;31;16;4;12;.750;3544000;0
48208;3318;148;37;21;4;17;.810;3600000;0
48208;3904;140;0;0;0;0;.00nan;0;0
48208;5455;140;99;46;1;45;.978;3600000;0
48208;6184;148;0;0;0;0;.00nan;0;0
48231;5621;139;85;47;3;44;.936;3600000;0
48231;5666;142;0;0;0;0;.00nan;0;0
48231;5711;142;62;12;1;11;.917;3600000;0
48231;5821;139;0;0;0;0;.00nan;0;0
48202;5409;136;30;28;7;21;.750;1916000;0
48202;5423;144;88;12;0;12;1.000;3600000;0
48202;5602;144;0;0;0;0;.00nan;0;0
48202;6180;136;81;35;2;33;.943;1684000;0
48937;5481;128;0;0;0;0;.00nan;0;0
48937;5732;146;54;25;3;22;.880;3600000;0
48937;6870;146;0;0;0;0;.00nan;0;0
48937;6936;128;54;31;4;27;.871;3545000;0
48212;5576;138;0;0;0;0;.00nan;0;0
48212;5631;138;55;32;4;28;.875;3531000;0
48212;5810;126;69;22;2;20;.909;3600000;0
48212;6495;126;0;0;0;0;.00nan;0;0
48211;3894;147;70;21;1;20;.952;3600000;0
48211;5405;145;84;39;3;36;.923;3525000;0
48211;5542;147;0;0;0;0;.00nan;0;0
48211;5673;145;0;0;0;0;.00nan;0;0
48210;2896;133;60;20;2;18;.900;3600000;0
48210;5454;141;61;51;6;45;.882;3242000;0
48210;5462;141;46;6;1;5;.833;358000;0
48210;5541;133;0;0;0;0;.00nan;0;0
48185;2756;131;49;19;3;16;.842;3600000;0
48185;5434;134;79;48;5;43;.896;3596000;0
48185;5536;131;0;0;0;0;.00nan;0;0
48185;6187;134;0;0;0;0;.00nan;0;0
48357;5367;127;0;0;0;0;.00nan;0;0
48357;5556;137;91;50;2;48;.960;3600000;0
48357;5723;137;0;0;0;0;.00nan;0;0
48357;6539;127;80;13;0;13;1.000;3600000;0
48284;5398;143;85;36;2;34;.944;3600000;0
48284;5451;151;52;37;6;31;.838;3600000;0
48284;5483;151;0;0;0;0;.00nan;0;0
48284;5974;143;0;0;0;0;.00nan;0;0
48240;3220;130;62;28;3;25;.893;3900000;0
48240;5693;130;0;0;0;0;.00nan;0;0
48240;5970;150;69;36;3;33;.917;3900000;0
48240;6161;150;0;0;0;0;.00nan;0;0
48172;3109;129;100;35;2;33;.943;3600000;0
48172;5385;129;0;0;0;0;.00nan;0;0
48172;5405;145;0;0;0;0;.00nan;0;0
48172;5673;145;55;38;5;33;.868;3600000;0
48183;5497;135;0;0;0;0;.00nan;0;0
48183;5621;139;47;44;6;38;.864;2488000;0
48183;5821;139;23;12;4;8;.667;1112000;0
48183;6545;135;83;12;0;12;1.000;3600000;0
48562;3904;140;0;0;0;0;.00nan;0;0
48562;5455;140;66;21;2;19;.905;3600000;0
48562;5481;128;0;0;0;0;.00nan;0;0
48562;6936;128;87;52;4;48;.923;3578000;0
48223;3894;147;0;0;0;0;.00nan;0;0
48223;5426;149;74;44;5;39;.886;3086000;0
48223;5542;147;76;19;1;18;.947;3600000;0
48223;5739;149;22;11;4;7;.636;514000;0
48215;5434;134;0;0;0;0;.00nan;0;0
48215;5576;138;0;0;0;0;.00nan;0;0
48215;5631;138;45;30;5;25;.833;3900000;0
48215;6187;134;51;34;5;29;.853;3900000;0
48156;3318;148;45;16;3;13;.813;3600000;0
48156;5732;146;0;0;0;0;.00nan;0;0
48156;6184;148;0;0;0;0;.00nan;0;0
48156;6870;146;78;56;5;51;.911;3583000;0
48225;2756;131;93;33;1;32;.970;3600000;0
48225;5536;131;0;0;0;0;.00nan;0;0
48225;5701;132;0;0;0;0;.00nan;0;0
48225;6491;132;56;26;3;23;.885;3539000;0
48192;5423;144;77;30;2;28;.933;3544000;0
48192;5602;144;0;0;0;0;.00nan;0;0
48192;5666;142;0;0;0;0;.00nan;0;0
48192;5711;142;56;12;1;11;.917;3600000;0
48961;3109;129;0;0;0;0;.00nan;0;0
48961;3220;130;44;22;4;18;.818;3600000;0
48961;5385;129;100;40;0;40;1.000;3600000;0
48961;5693;130;0;0;0;0;.00nan;0;0
48523;3904;140;95;24;0;24;1.000;3600000;0
48523;5455;140;0;0;0;0;.00nan;0;0
48523;5556;137;88;37;2;35;.946;3557000;0
48523;5723;137;0;0;0;0;.00nan;0;0
48260;2896;133;69;35;4;31;.886;3567000;0
48260;5541;133;0;0;0;0;.00nan;0;0
48260;5701;132;68;26;2;24;.923;3600000;0
48260;6491;132;0;0;0;0;.00nan;0;0
48226;5409;136;0;0;0;0;.00nan;0;0
48226;5810;126;0;0;0;0;.00nan;0;0
48226;6180;136;66;43;4;39;.907;3600000;0
48226;6495;126;72;8;0;8;1.000;3600000;0
48205;3318;148;77;41;4;37;.902;3600000;0
48205;5497;135;0;0;0;0;.00nan;0;0
48205;6184;148;0;0;0;0;.00nan;0;0
48205;6545;135;68;19;1;18;.947;3600000;0
48214;5451;151;78;36;3;33;.917;3900000;0
48214;5483;151;0;0;0;0;.00nan;0;0
48214;5732;146;68;34;3;31;.912;3900000;0
48214;6870;146;0;0;0;0;.00nan;0;0
48250;5409;136;72;22;2;20;.909;3600000;0
48250;5454;141;0;0;0;0;.00nan;0;0
48250;5462;141;51;34;4;30;.882;3587000;0
48250;6180;136;0;0;0;0;.00nan;0;0
48847;5367;127;0;0;0;0;.00nan;0;0
48847;5621;139;0;0;0;0;.00nan;0;0
48847;5821;139;91;39;2;37;.949;3600000;0
48847;6539;127;75;8;0;8;1.000;3600000;0
48198;5405;145;0;0;0;0;.00nan;0;0
48198;5576;138;52;33;5;28;.848;3572000;0
48198;5631;138;0;0;0;0;.00nan;0;0
48198;5673;145;65;35;4;31;.886;3600000;0
48247;5426;149;42;3;1;2;.667;399000;0
48247;5666;142;0;0;0;0;.00nan;0;0
48247;5711;142;56;19;3;16;.842;3600000;0
48247;5739;149;58;57;7;50;.877;3201000;0
48283;2896;133;54;17;3;14;.824;3600000;0
48283;5481;128;24;12;4;8;.667;995000;0
48283;5541;133;0;0;0;0;.00nan;0;0
48283;6936;128;98;53;2;51;.962;2605000;0
48232;3894;147;71;32;2;30;.938;3900000;0
48232;5542;147;0;0;0;0;.00nan;0;0
48232;5970;150;92;40;2;38;.950;3900000;0
48232;6161;150;0;0;0;0;.00nan;0;0
48233;5451;151;52;11;1;10;.909;568000;0
48233;5483;151;55;45;7;38;.844;3032000;0
48233;5701;132;0;0;0;0;.00nan;0;0
48233;6491;132;55;13;2;11;.846;3600000;0
48237;5454;141;59;38;5;33;.868;3600000;0
48237;5462;141;0;0;0;0;.00nan;0;0
48237;5621;139;0;0;0;0;.00nan;0;0
48237;5821;139;61;20;2;18;.900;3600000;0
48222;5423;144;53;23;3;20;.870;3600000;0
48222;5602;144;0;0;0;0;.00nan;0;0
48222;5970;150;0;0;0;0;.00nan;0;0
48222;6161;150;53;28;4;24;.857;3600000;0
48934;3904;140;68;7;0;7;1.000;3600000;0
48934;5455;140;0;0;0;0;.00nan;0;0
48934;5481;128;73;33;2;31;.939;3546000;0
48934;6936;128;0;0;0;0;.00nan;0;0
48165;5732;146;63;14;1;13;.929;894000;0
48165;5810;126;0;0;0;0;.00nan;0;0
48165;6495;126;72;9;0;9;1.000;3600000;0
48165;6870;146;47;44;6;38;.864;2706000;0
48277;3318;148;82;27;1;26;.963;3600000;0
48277;5367;127;0;0;0;0;.00nan;0;0
48277;6184;148;0;0;0;0;.00nan;0;0
48277;6539;127;88;36;2;34;.944;3576000;0
48188;3220;130;0;0;0;0;.00nan;0;0
48188;5426;149;17;26;6;20;.769;2607000;0
48188;5693;130;54;18;2;16;.889;3600000;0
48188;5739;149;61;6;0;6;1.000;993000;0
48253;5497;135;0;0;0;0;.00nan;0;0
48253;5556;137;92;52;3;49;.942;3900000;0
48253;5723;137;0;0;0;0;.00nan;0;0
48253;6545;135;61;23;3;20;.870;3900000;0
48203;2756;131;41;8;2;6;.750;3600000;0
48203;3109;129;0;0;0;0;.00nan;0;0
48203;5385;129;58;50;6;44;.880;3600000;0
48203;5536;131;0;0;0;0;.00nan;0;0
48976;5666;142;0;0;0;0;.00nan;0;0
48976;5701;132;61;23;3;20;.870;3702000;0
48976;5711;142;67;22;2;20;.909;3702000;0
48976;6491;132;0;0;0;0;.00nan;0;0
48235;3220;130;73;36;3;33;.917;3600000;0
48235;5434;134;7;22;7;15;.682;3094000;0
48235;5693;130;0;0;0;0;.00nan;0;0
48235;6187;134;56;5;0;5;1.000;506000;0
48962;2756;131;0;0;0;0;.00nan;0;0
48962;5409;136;35;10;3;7;.700;600000;0
48962;5536;131;73;15;1;14;.933;3600000;0
48962;6180;136;69;47;5;42;.894;3000000;0
48213;3109;129;29;30;7;23;.767;3342000;0
48213;5385;129;53;3;0;3;1.000;258000;0
48213;5398;143;80;29;1;28;.966;3600000;0
48213;5974;143;0;0;0;0;.00nan;0;0
48957;2896;133;56;12;1;11;.917;3600000;0
48957;5405;145;41;25;5;20;.800;3600000;0
48957;5541;133;0;0;0;0;.00nan;0;0
48957;5673;145;0;0;0;0;.00nan;0;0
48452;5367;127;88;34;2;32;.941;3900000;0
48452;5398;143;0;0;0;0;.00nan;0;0
48452;5974;143;81;42;2;40;.952;3900000;0
48452;6539;127;0;0;0;0;.00nan;0;0
48242;2756;131;68;19;2;17;.895;3900000;0
48242;5423;144;74;36;2;34;.944;3900000;0
48242;5536;131;0;0;0;0;.00nan;0;0
48242;5602;144;0;0;0;0;.00nan;0;0
48243;3318;148;73;20;1;19;.950;3600000;0
48243;5970;150;91;38;2;36;.947;3600000;0
48243;6161;150;0;0;0;0;.00nan;0;0
48243;6184;148;0;0;0;0;.00nan;0;0
48305;5481;128;55;19;2;17;.895;1142000;0
48305;5701;132;0;0;0;0;.00nan;0;0
48305;6491;132;87;24;1;23;.958;3600000;0
48305;6936;128;32;30;6;24;.800;2458000;0
48254;5434;134;33;22;5;17;.773;3600000;0
48254;5576;138;0;0;0;0;.00nan;0;0
48254;5631;138;86;36;2;34;.944;3600000;0
48254;6187;134;0;0;0;0;.00nan;0;0
48269;5367;127;0;0;0;0;.00nan;0;0
48269;5621;139;86;29;1;28;.966;3600000;0
48269;5821;139;0;0;0;0;.00nan;0;0
48269;6539;127;71;32;3;29;.906;3590000;0
48975;3220;130;72;21;1;20;.952;3600000;0
48975;5451;151;51;35;5;30;.857;3600000;0
48975;5483;151;0;0;0;0;.00nan;0;0
48975;5693;130;0;0;0;0;.00nan;0;0
48234;5405;145;0;0;0;0;.00nan;0;0
48234;5426;149;0;0;0;0;.00nan;0;0
48234;5673;145;60;25;3;22;.880;3900000;0
48234;5739;149;66;29;3;26;.897;3900000;0
48281;2896;133;47;14;3;11;.786;3600000;0
48281;5409;136;45;9;2;7;.778;904000;0
48281;5541;133;0;0;0;0;.00nan;0;0
48281;6180;136;41;41;7;34;.829;2696000;0
48278;5423;144;0;0;0;0;.00nan;0;0
48278;5602;144;53;40;6;34;.850;3600000;0
48278;5666;142;0;0;0;0;.00nan;0;0
48278;5711;142;61;25;3;22;.880;3600000;0
48379;5398;143;69;27;2;25;.926;3600000;0
48379;5451;151;53;3;0;3;1.000;299000;0
48379;5483;151;75;47;5;42;.894;3301000;0
48379;5974;143;0;0;0;0;.00nan;0;0
48256;5454;141;95;49;3;46;.939;3600000;0
48256;5462;141;0;0;0;0;.00nan;0;0
48256;5576;138;0;0;0;0;.00nan;0;0
48256;5631;138;26;21;5;16;.762;3566000;0
48257;2896;133;65;37;4;33;.892;3600000;0
48257;5434;134;0;0;0;0;.00nan;0;0
48257;5541;133;0;0;0;0;.00nan;0;0
48257;6187;134;100;45;1;44;.978;3600000;0
48261;3318;148;57;19;2;17;.895;3600000;0
48261;5970;150;0;0;0;0;.00nan;0;0
48261;6161;150;46;35;5;30;.857;3600000;0
48261;6184;148;0;0;0;0;.00nan;0;0
48238;5405;145;36;21;4;17;.810;3570000;0
48238;5426;149;81;32;2;30;.938;3600000;0
48238;5673;145;0;0;0;0;.00nan;0;0
48238;5739;149;0;0;0;0;.00nan;0;0
48236;5497;135;0;0;0;0;.00nan;0;0
48236;5732;146;35;22;4;18;.818;901000;0
48236;6545;135;70;17;1;16;.941;3600000;0
48236;6870;146;49;47;7;40;.851;2699000;0
48239;3109;129;79;40;4;36;.900;3588000;0
48239;5385;129;0;0;0;0;.00nan;0;0
48239;5810;126;0;0;0;0;.00nan;0;0
48239;6495;126;57;18;2;16;.889;3600000;0
48248;3894;147;62;15;1;14;.933;3600000;0
48248;3904;140;91;45;3;42;.933;3600000;0
48248;5455;140;0;0;0;0;.00nan;0;0
48248;5542;147;0;0;0;0;.00nan;0;0
48320;5409;136;90;38;2;36;.947;3568000;0
48320;5556;137;0;0;0;0;.00nan;0;0
48320;5723;137;99;26;0;26;1.000;3600000;0
48320;6180;136;0;0;0;0;.00nan;0;0
48280;3904;140;0;0;0;0;.00nan;0;0
48280;5455;140;86;38;2;36;.947;3526000;0
48280;5701;132;0;0;0;0;.00nan;0;0
48280;6491;132;92;17;0;17;1.000;3600000;0
48262;5367;127;0;0;0;0;.00nan;0;0
48262;5426;149;0;0;0;0;.00nan;0;0
48262;5739;149;84;40;3;37;.925;3559000;0
48262;6539;127;65;15;1;14;.933;3600000;0
48390;5398;143;49;12;2;10;.833;3600000;0
48390;5451;151;37;36;6;30;.833;2350000;0
48390;5483;151;50;23;3;20;.870;1250000;0
48390;5974;143;0;0;0;0;.00nan;0;0
48952;3220;130;71;30;2;28;.933;3600000;0
48952;5434;134;55;42;5;37;.881;3600000;0
48952;5693;130;0;0;0;0;.00nan;0;0
48952;6187;134;0;0;0;0;.00nan;0;0
48217;2756;131;65;13;1;12;.923;3600000;0
48217;5405;145;32;8;3;5;.625;585000;0
48217;5536;131;0;0;0;0;.00nan;0;0
48217;5673;145;89;66;6;60;.909;3015000;0
48244;5556;137;0;0;0;0;.00nan;0;0
48244;5723;137;49;22;3;19;.864;3580000;0
48244;5810;126;0;0;0;0;.00nan;0;0
48244;6495;126;69;24;2;22;.917;3600000;0
48224;3109;129;78;31;2;29;.935;3704000;0
48224;5385;129;0;0;0;0;.00nan;0;0
48224;5732;146;76;28;1;27;.964;3704000;0
48224;6870;146;0;0;0;0;.00nan;0;0
48268;5621;139;0;0;0;0;.00nan;0;0
48268;5821;139;90;38;2;36;.947;3600000;0
48268;5970;150;50;22;3;19;.864;3536000;0
48268;6161;150;0;0;0;0;.00nan;0;0
48275;3894;147;66;11;1;10;.909;3600000;0
48275;5481;128;54;4;0;4;1.000;351000;0
48275;5542;147;0;0;0;0;.00nan;0;0
48275;6936;128;57;41;6;35;.854;3249000;0
48313;5666;142;49;22;3;19;.864;3563000;0
48313;5701;132;0;0;0;0;.00nan;0;0
48313;5711;142;0;0;0;0;.00nan;0;0
48313;6491;132;73;26;2;24;.923;3600000;0
48264;5367;127;97;33;1;32;.970;3600000;0
48264;5434;134;0;0;0;0;.00nan;0;0
48264;6187;134;73;31;2;29;.935;3600000;0
48264;6539;127;0;0;0;0;.00nan;0;0
48288;3894;147;0;0;0;0;.00nan;0;0
48288;5451;151;89;67;3;64;.955;3573000;0
48288;5483;151;0;0;0;0;.00nan;0;0
48288;5542;147;64;14;1;13;.929;3600000;0
48572;3904;140;0;0;0;0;.00nan;0;0
48572;5398;143;0;0;0;0;.00nan;0;0
48572;5455;140;73;41;3;38;.927;3900000;0
48572;5974;143;53;20;3;17;.850;3874000;0
48440;3220;130;0;0;0;0;.00nan;0;0
48440;5556;137;49;43;6;37;.860;2940000;0
48440;5693;130;61;22;2;20;.909;3600000;0
48440;5723;137;46;12;2;10;.833;660000;0
48246;5454;141;56;26;3;23;.885;3600000;0
48246;5462;141;0;0;0;0;.00nan;0;0
48246;5732;146;0;0;0;0;.00nan;0;0
48246;6870;146;100;33;0;33;1.000;3600000;0
48245;5497;135;0;0;0;0;.00nan;0;0
48245;5810;126;25;12;4;8;.667;1189000;0
48245;6495;126;71;31;2;29;.935;2411000;0
48245;6545;135;69;21;1;20;.952;3600000;0
48241;2756;131;57;16;2;14;.875;3600000;0
48241;3109;129;49;1;0;1;1.000;246000;0
48241;5385;129;76;58;6;52;.897;3354000;0
48241;5536;131;0;0;0;0;.00nan;0;0
48337;2896;133;75;12;0;12;1.000;3600000;0
48337;5409;136;97;38;1;37;.974;3576000;0
48337;5541;133;0;0;0;0;.00nan;0;0
48337;6180;136;0;0;0;0;.00nan;0;0
48327;3318;148;100;46;2;44;.957;3600000;0
48327;5497;135;0;0;0;0;.00nan;0;0
48327;6184;148;0;0;0;0;.00nan;0;0
48327;6545;135;49;19;3;16;.842;3600000;0
48369;5621;139;81;47;4;43;.915;3600000;0
48369;5666;142;0;0;0;0;.00nan;0;0
48369;5711;142;55;10;1;9;.900;3600000;0
48369;5821;139;0;0;0;0;.00nan;0;0
48295;5423;144;71;6;0;6;1.000;3600000;0
48295;5481;128;84;51;4;47;.922;3600000;0
48295;5602;144;0;0;0;0;.00nan;0;0
48295;6936;128;0;0;0;0;.00nan;0;0
48259;5454;141;81;47;4;43;.915;3600000;0
48259;5462;141;0;0;0;0;.00nan;0;0
48259;5576;138;0;0;0;0;.00nan;0;0
48259;5631;138;69;19;1;18;.947;3600000;0
48971;3318;148;58;15;2;13;.867;3600000;0
48971;5621;139;0;0;0;0;.00nan;0;0
48971;5821;139;58;48;5;43;.896;3600000;0
48971;6184;148;0;0;0;0;.00nan;0;0
48267;2896;133;72;27;2;25;.926;3600000;0
48267;3109;129;43;30;5;25;.833;2994000;0
48267;5385;129;56;7;0;7;1.000;606000;0
48267;5541;133;0;0;0;0;.00nan;0;0
48296;2756;131;76;11;0;11;1.000;3600000;0
48296;5536;131;0;0;0;0;.00nan;0;0
48296;5732;146;95;49;3;46;.939;3600000;0
48296;6870;146;0;0;0;0;.00nan;0;0
48316;5423;144;72;8;0;8;1.000;3600000;0
48316;5556;137;76;37;2;35;.946;3600000;0
48316;5602;144;0;0;0;0;.00nan;0;0
48316;5723;137;0;0;0;0;.00nan;0;0
48456;5451;151;67;54;8;46;.852;3600000;0
48456;5483;151;0;0;0;0;.00nan;0;0
48456;5539;142;0;0;0;0;.00nan;0;0
48456;5711;142;44;16;3;13;.813;3600000;0
48273;5701;132;0;0;0;0;.00nan;0;0
48273;5970;150;0;0;0;0;.00nan;0;0
48273;6161;150;75;45;4;41;.911;3559000;0
48273;6491;132;60;18;2;16;.889;3600000;0
48279;3904;140;0;0;0;0;.00nan;0;0
48279;5426;149;88;32;1;31;.969;3600000;0
48279;5455;140;62;22;2;20;.909;3600000;0
48279;5739;149;0;0;0;0;.00nan;0;0
48255;3894;147;78;22;1;21;.955;3600000;0
48255;5405;145;48;31;4;27;.871;3600000;0
48255;5542;147;0;0;0;0;.00nan;0;0
48255;5673;145;0;0;0;0;.00nan;0;0
48317;3220;130;74;51;5;46;.902;3619000;0
48317;5367;127;0;0;0;0;.00nan;0;0
48317;5693;130;0;0;0;0;.00nan;0;0
48317;6539;127;55;27;4;23;.852;3619000;0
48394;3894;147;0;0;0;0;.00nan;0;0
48394;5409;136;0;0;0;0;.00nan;0;0
48394;5542;147;45;29;4;25;.862;3521000;0
48394;6180;136;82;28;2;26;.929;3600000;0
48263;3318;148;83;15;0;15;1.000;3600000;0
48263;5426;149;0;0;0;0;.00nan;0;0
48263;5739;149;67;43;5;38;.884;3600000;0
48263;6184;148;0;0;0;0;.00nan;0;0
48265;2756;131;62;20;2;18;.900;3647000;0
48265;5536;131;0;0;0;0;.00nan;0;0
48265;5810;126;0;0;0;0;.00nan;0;0
48265;6495;126;92;45;3;42;.933;3647000;0
48368;2896;133;75;28;2;26;.929;3600000;0
48368;5423;144;60;29;4;25;.862;3520000;0
48368;5541;133;0;0;0;0;.00nan;0;0
48368;5602;144;0;0;0;0;.00nan;0;0
48481;5497;135;0;0;0;0;.00nan;0;0
48481;5556;137;75;19;0;19;1.000;1140000;0
48481;5723;137;33;30;6;24;.800;2460000;0
48481;6545;135;62;11;1;10;.909;3600000;0
48289;5434;134;99;42;1;41;.976;3600000;0
48289;5539;142;59;23;2;21;.913;3544000;0
48289;5711;142;0;0;0;0;.00nan;0;0
48289;6187;134;0;0;0;0;.00nan;0;0
48287;3904;140;33;33;6;27;.818;3600000;0
48287;5455;140;0;0;0;0;.00nan;0;0
48287;5576;138;0;0;0;0;.00nan;0;0
48287;5631;138;64;19;2;17;.895;3600000;0
48251;5405;145;0;0;0;0;.00nan;0;0
48251;5621;139;73;31;1;30;.968;3600000;0
48251;5673;145;41;26;5;21;.808;3600000;0
48251;5821;139;0;0;0;0;.00nan;0;0
48276;3109;129;0;0;0;0;.00nan;0;0
48276;5367;127;46;15;2;13;.867;3600000;0
48276;5385;129;54;38;5;33;.868;3600000;0
48276;6539;127;0;0;0;0;.00nan;0;0
48314;5454;141;64;46;5;41;.891;3600000;0
48314;5462;141;0;0;0;0;.00nan;0;0
48314;5481;128;0;0;0;0;.00nan;0;0
48314;6936;128;63;24;2;22;.917;3600000;0
48285;5732;146;0;0;0;0;.00nan;0;0
48285;5970;150;61;14;1;13;.929;3600000;0
48285;6161;150;0;0;0;0;.00nan;0;0
48285;6870;146;84;69;7;62;.899;3600000;0
48266;5398;143;83;31;2;29;.935;3600000;0
48266;5810;126;65;32;3;29;.906;3557000;0
48266;5974;143;0;0;0;0;.00nan;0;0
48266;6495;126;0;0;0;0;.00nan;0;0
48258;3109;129;70;44;5;39;.886;3600000;0
48258;3318;148;76;12;0;12;1.000;3600000;0
48258;5385;129;0;0;0;0;.00nan;0;0
48258;6184;148;0;0;0;0;.00nan;0;0
48252;5398;143;0;0;0;0;.00nan;0;0
48252;5405;145;70;27;2;25;.926;3600000;0
48252;5673;145;0;0;0;0;.00nan;0;0
48252;5974;143;56;35;4;31;.886;3543000;0
48298;2896;133;32;27;6;21;.778;3600000;0
48298;5541;133;0;0;0;0;.00nan;0;0
48298;5970;150;19;10;4;6;.600;1314000;0
48298;6161;150;53;27;4;23;.852;2243000;0
48304;5409;136;0;0;0;0;.00nan;0;0
48304;5732;146;100;40;1;39;.975;3900000;0
48304;6180;136;67;22;1;21;.955;3900000;0
48304;6870;146;0;0;0;0;.00nan;0;0
48356;3220;130;88;17;0;17;1.000;3600000;0
48356;5367;127;0;0;0;0;.00nan;0;0
48356;5693;130;0;0;0;0;.00nan;0;0
48356;6539;127;78;38;4;34;.895;3600000;0
48272;5576;138;0;0;0;0;.00nan;0;0
48272;5631;138;50;34;5;29;.853;3600000;0
48272;5701;132;0;0;0;0;.00nan;0;0
48272;6491;132;64;22;2;20;.909;3600000;0
48293;3904;140;0;0;0;0;.00nan;0;0
48293;5434;134;49;31;4;27;.871;3865000;0
48293;5455;140;60;33;4;29;.879;3900000;0
48293;6187;134;0;0;0;0;.00nan;0;0
48748;5367;127;0;0;0;0;.00nan;0;0
48748;5810;126;0;0;0;0;.00nan;0;0
48748;6495;126;71;27;2;25;.926;3600000;0
48748;6539;127;44;24;4;20;.833;3554000;0
48383;5497;135;0;0;0;0;.00nan;0;0
48383;5539;142;0;0;0;0;.00nan;0;0
48383;5711;142;60;29;3;26;.897;3570000;0
48383;6545;135;85;27;1;26;.963;3600000;0
48297;5423;144;54;13;2;11;.846;3600000;0
48297;5454;141;64;45;5;40;.889;3600000;0
48297;5462;141;0;0;0;0;.00nan;0;0
48297;5602;144;0;0;0;0;.00nan;0;0
48286;5426;149;82;32;2;30;.938;3600000;0
48286;5481;128;46;18;3;15;.833;3600000;0
48286;5739;149;0;0;0;0;.00nan;0;0
48286;6936;128;0;0;0;0;.00nan;0;0
48292;2756;131;60;15;1;14;.933;3600000;0
48292;5434;134;78;24;1;23;.958;1349000;0
48292;5536;131;0;0;0;0;.00nan;0;0
48292;6187;134;37;31;6;25;.806;2251000;0
48319;5409;136;42;22;4;18;.818;3900000;0
48319;5701;132;52;26;4;22;.846;3900000;0
48319;6180;136;0;0;0;0;.00nan;0;0
48319;6491;132;0;0;0;0;.00nan;0;0
48300;3318;148;71;24;2;22;.917;3600000;0
48300;3894;147;61;37;4;33;.892;3584000;0
48300;5542;147;0;0;0;0;.00nan;0;0
48300;6184;148;0;0;0;0;.00nan;0;0
48359;5451;151;47;30;5;25;.833;3882000;0
48359;5483;151;0;0;0;0;.00nan;0;0
48359;5621;139;0;0;0;0;.00nan;0;0
48359;5821;139;56;31;4;27;.871;3882000;0
48325;5398;143;82;15;0;15;1.000;3600000;0
48325;5454;141;0;0;0;0;.00nan;0;0
48325;5462;141;90;57;5;52;.912;3600000;0
48325;5974;143;0;0;0;0;.00nan;0;0
48249;5576;138;93;33;2;31;.939;3600000;0
48249;5631;138;0;0;0;0;.00nan;0;0
48249;5810;126;68;29;3;26;.897;3600000;0
48249;6495;126;0;0;0;0;.00nan;0;0
48306;5481;128;0;0;0;0;.00nan;0;0
48306;5621;139;28;27;6;21;.778;2269000;0
48306;5821;139;63;11;0;11;1.000;1331000;0
48306;6936;128;67;25;3;22;.880;3600000;0
48380;3220;130;88;47;3;44;.936;3641000;0
48380;5497;135;0;0;0;0;.00nan;0;0
48380;5693;130;0;0;0;0;.00nan;0;0
48380;6545;135;59;19;2;17;.895;3641000;0
48326;5405;145;81;23;1;22;.957;3600000;0
48326;5556;137;48;26;3;23;.885;3515000;0
48326;5673;145;0;0;0;0;.00nan;0;0
48326;5723;137;0;0;0;0;.00nan;0;0
48424;5497;135;0;0;0;0;.00nan;0;0
48424;5621;139;97;62;4;58;.935;3600000;0
48424;5821;139;0;0;0;0;.00nan;0;0
48424;6545;135;74;10;0;10;1.000;3600000;0
48328;2756;131;38;22;4;18;.818;3556000;0
48328;5536;131;0;0;0;0;.00nan;0;0
48328;5539;142;0;0;0;0;.00nan;0;0
48328;5711;142;73;29;3;26;.897;3600000;0
48964;5367;127;0;0;0;0;.00nan;0;0
48964;5409;136;71;35;3;32;.914;3900000;0
48964;6180;136;0;0;0;0;.00nan;0;0
48964;6539;127;75;32;3;29;.906;3900000;0
48338;5426;149;0;0;0;0;.00nan;0;0
48338;5739;149;67;45;5;40;.889;3600000;0
48338;5970;150;56;23;2;21;.913;3600000;0
48338;6161;150;0;0;0;0;.00nan;0;0
48332;5398;143;100;26;0;26;1.000;3600000;0
48332;5434;134;51;32;4;28;.875;3600000;0
48332;5974;143;0;0;0;0;.00nan;0;0
48332;6187;134;0;0;0;0;.00nan;0;0
48282;5481;128;49;38;6;32;.842;3600000;0
48282;5810;126;0;0;0;0;.00nan;0;0
48282;6495;126;69;23;2;21;.913;3600000;0
48282;6936;128;0;0;0;0;.00nan;0;0
48331;3318;148;16;6;4;2;.333;879000;0
48331;5451;151;0;0;0;0;.00nan;0;0
48331;5483;151;41;40;6;34;.850;3600000;0
48331;6184;148;72;9;0;9;1.000;2721000;0
48271;5426;149;67;33;3;30;.909;3561000;0
48271;5739;149;0;0;0;0;.00nan;0;0
48271;5810;126;64;21;2;19;.905;3600000;0
48271;6495;126;0;0;0;0;.00nan;0;0
48270;5405;145;0;0;0;0;.00nan;0;0
48270;5673;145;51;15;2;13;.867;3600000;0
48270;5732;146;49;32;5;27;.844;3600000;0
48270;6870;146;0;0;0;0;.00nan;0;0
48453;5556;137;0;0;0;0;.00nan;0;0
48453;5576;138;0;0;0;0;.00nan;0;0
48453;5631;138;85;42;2;40;.952;3569000;0
48453;5723;137;79;26;1;25;.962;3600000;0
48663;5367;127;71;30;2;28;.933;3600000;0
48663;5539;142;64;25;3;22;.880;3562000;0
48663;5711;142;0;0;0;0;.00nan;0;0
48663;6539;127;0;0;0;0;.00nan;0;0
48299;2756;131;59;13;1;12;.923;3600000;0
48299;3904;140;0;0;0;0;.00nan;0;0
48299;5455;140;67;41;4;37;.902;3600000;0
48299;5536;131;0;0;0;0;.00nan;0;0
48318;3109;129;100;28;0;28;1.000;3600000;0
48318;5385;129;0;0;0;0;.00nan;0;0
48318;5409;136;54;4;0;4;1.000;405000;0
48318;6180;136;12;25;7;18;.720;3195000;0
48329;5423;144;65;19;1;18;.947;3600000;0
48329;5602;144;0;0;0;0;.00nan;0;0
48329;5970;150;0;0;0;0;.00nan;0;0
48329;6161;150;63;35;5;30;.857;3600000;0
48322;2896;133;83;25;1;24;.960;3600000;0
48322;5541;133;0;0;0;0;.00nan;0;0
48322;5701;132;57;6;0;6;1.000;411000;0
48322;6491;132;56;45;6;39;.867;3189000;0
48333;3318;148;57;13;1;12;.923;3600000;0
48333;5454;141;34;22;5;17;.773;1366000;0
48333;5462;141;28;31;6;25;.806;2234000;0
48333;6184;148;0;0;0;0;.00nan;0;0
48315;3894;147;60;13;1;12;.923;3600000;0
48315;5542;147;0;0;0;0;.00nan;0;0
48315;5621;139;0;0;0;0;.00nan;0;0
48315;5821;139;97;45;2;43;.956;3546000;0
48350;3220;130;39;21;4;17;.810;3600000;0
48350;5481;128;39;15;3;12;.800;1626000;0
48350;5693;130;0;0;0;0;.00nan;0;0
48350;6936;128;29;29;6;23;.793;1974000;0
48324;5434;134;94;35;1;34;.971;3600000;0
48324;5701;132;0;0;0;0;.00nan;0;0
48324;6187;134;0;0;0;0;.00nan;0;0
48324;6491;132;66;25;2;23;.920;3564000;0
48291;5398;143;80;15;0;15;1.000;3600000;0
48291;5732;146;86;37;3;34;.919;3221000;0
48291;5974;143;0;0;0;0;.00nan;0;0
48291;6870;146;32;9;3;6;.667;379000;0
48387;2896;133;0;0;0;0;.00nan;0;0
48387;5541;133;59;15;2;13;.867;3600000;0
48387;5576;138;90;45;3;42;.933;3577000;0
48387;5631;138;0;0;0;0;.00nan;0;0
48310;3318;148;81;37;3;34;.919;3600000;0
48310;3894;147;52;25;4;21;.840;3600000;0
48310;5542;147;0;0;0;0;.00nan;0;0
48310;6184;148;0;0;0;0;.00nan;0;0
48417;3220;130;61;39;5;34;.872;3858000;0
48417;5409;136;55;39;6;33;.846;3858000;0
48417;5693;130;0;0;0;0;.00nan;0;0
48417;6180;136;0;0;0;0;.00nan;0;0
48353;5497;135;0;0;0;0;.00nan;0;0
48353;5970;150;0;0;0;0;.00nan;0;0
48353;6161;150;76;41;3;38;.927;3583000;0
48353;6545;135;82;18;1;17;.944;3600000;0
48336;5451;151;69;21;2;19;.905;3600000;0
48336;5454;141;59;38;4;34;.895;3595000;0
48336;5462;141;0;0;0;0;.00nan;0;0
48336;5483;151;0;0;0;0;.00nan;0;0
48425;5434;134;0;0;0;0;.00nan;0;0
48425;5556;137;57;34;4;30;.882;3513000;0
48425;5723;137;0;0;0;0;.00nan;0;0
48425;6187;134;74;31;2;29;.935;3600000;0
48274;5367;127;0;0;0;0;.00nan;0;0
48274;5810;126;64;12;0;12;1.000;1459000;0
48274;6495;126;55;26;4;22;.846;2141000;0
48274;6539;127;68;31;3;28;.903;3600000;0
48309;5423;144;68;20;1;19;.950;3600000;0
48309;5426;149;0;0;0;0;.00nan;0;0
48309;5602;144;0;0;0;0;.00nan;0;0
48309;5739;149;83;46;3;43;.935;3534000;0
48430;5539;142;0;0;0;0;.00nan;0;0
48430;5621;139;0;0;0;0;.00nan;0;0
48430;5711;142;70;18;1;17;.944;3600000;0
48430;5821;139;53;64;8;56;.875;3600000;0
48301;2756;131;83;10;0;10;1.000;3600000;0
48301;3109;129;58;33;4;29;.879;2161000;0
48301;5385;129;22;18;5;13;.722;1439000;0
48301;5536;131;0;0;0;0;.00nan;0;0
48520;3220;130;0;0;0;0;.00nan;0;0
48520;5621;139;89;37;3;34;.919;3900000;0
48520;5693;130;49;19;3;16;.842;3900000;0
48520;5821;139;0;0;0;0;.00nan;0;0
48421;3904;140;0;0;0;0;.00nan;0;0
48421;5451;151;0;0;0;0;.00nan;0;0
48421;5455;140;72;28;2;26;.929;3600000;0
48421;5483;151;67;33;3;30;.909;3600000;0
48443;2896;133;70;12;1;11;.917;3600000;0
48443;5481;128;0;0;0;0;.00nan;0;0
48443;5541;133;0;0;0;0;.00nan;0;0
48443;6936;128;44;40;6;34;.850;3600000;0
48335;5405;145;57;10;1;9;.900;3600000;0
48335;5454;141;91;38;2;36;.947;3600000;0
48335;5462;141;0;0;0;0;.00nan;0;0
48335;5673;145;0;0;0;0;.00nan;0;0
48330;5497;135;35;18;4;14;.778;3600000;0
48330;5701;132;0;0;0;0;.00nan;0;0
48330;6491;132;98;39;1;38;.974;3600000;0
48330;6545;135;0;0;0;0;.00nan;0;0
48974;3318;148;55;23;3;20;.870;3576000;0
48974;5970;150;90;49;2;47;.959;3600000;0
48974;6161;150;0;0;0;0;.00nan;0;0
48974;6184;148;0;0;0;0;.00nan;0;0
48294;3904;140;99;37;2;35;.946;3900000;0
48294;5455;140;0;0;0;0;.00nan;0;0
48294;5576;138;0;0;0;0;.00nan;0;0
48294;5631;138;65;25;2;23;.920;3900000;0
48307;5423;144;47;7;1;6;.857;3580000;0
48307;5602;144;0;0;0;0;.00nan;0;0
48307;5732;146;0;0;0;0;.00nan;0;0
48307;6870;146;100;40;0;40;1.000;3600000;0
48311;3109;129;61;43;6;37;.860;3600000;0
48311;3894;147;58;18;2;16;.889;3600000;0
48311;5385;129;0;0;0;0;.00nan;0;0
48311;5542;147;0;0;0;0;.00nan;0;0
48344;5398;143;76;29;2;27;.931;3600000;0
48344;5409;136;0;0;0;0;.00nan;0;0
48344;5974;143;0;0;0;0;.00nan;0;0
48344;6180;136;48;23;4;19;.826;3528000;0
48972;2756;131;47;13;3;10;.769;3600000;0
48972;5454;141;65;51;6;45;.882;2576000;0
48972;5462;141;37;16;3;13;.813;1024000;0
48972;5536;131;0;0;0;0;.00nan;0;0
48466;5409;136;52;39;6;33;.846;3155000;0
48466;5556;137;0;0;0;0;.00nan;0;0
48466;5723;137;58;23;3;20;.870;3600000;0
48466;6180;136;53;3;0;3;1.000;445000;0
48323;3904;140;0;0;0;0;.00nan;0;0
48323;5423;144;42;23;4;19;.826;3600000;0
48323;5455;140;100;44;1;43;.977;3600000;0
48323;5602;144;0;0;0;0;.00nan;0;0
48464;5481;128;96;44;1;43;.977;3900000;0
48464;5497;135;0;0;0;0;.00nan;0;0
48464;6545;135;69;17;1;16;.941;3900000;0
48464;6936;128;0;0;0;0;.00nan;0;0
48312;5539;142;0;0;0;0;.00nan;0;0
48312;5711;142;47;13;2;11;.846;3600000;0
48312;5732;146;78;56;5;51;.911;3600000;0
48312;6870;146;0;0;0;0;.00nan;0;0
48341;5621;139;0;0;0;0;.00nan;0;0
48341;5701;132;0;0;0;0;.00nan;0;0
48341;5821;139;67;33;3;30;.909;3900000;0
48341;6491;132;65;27;3;24;.889;3900000;0
48339;5405;145;54;22;3;19;.864;3600000;0
48339;5673;145;0;0;0;0;.00nan;0;0
48339;5970;150;0;0;0;0;.00nan;0;0
48339;6161;150;42;29;5;24;.828;3560000;0
48343;3318;148;90;11;0;11;1.000;3600000;0
48343;5426;149;0;0;0;0;.00nan;0;0
48343;5739;149;72;40;3;37;.925;3600000;0
48343;6184;148;0;0;0;0;.00nan;0;0
48508;5367;127;0;0;0;0;.00nan;0;0
48508;5481;128;0;0;0;0;.00nan;0;0
48508;6539;127;54;21;3;18;.857;3600000;0
48508;6936;128;60;47;5;42;.894;3599000;0
48354;5398;143;100;28;0;28;1.000;3600000;0
48354;5423;144;87;23;2;21;.913;3558000;0
48354;5602;144;0;0;0;0;.00nan;0;0
48354;5974;143;0;0;0;0;.00nan;0;0
48420;2896;133;43;21;4;17;.810;3676000;0
48420;3109;129;73;45;5;40;.889;3676000;0
48420;5385;129;0;0;0;0;.00nan;0;0
48420;5541;133;0;0;0;0;.00nan;0;0
48377;5434;134;48;19;3;16;.842;3600000;0
48377;5732;146;71;44;5;39;.886;3337000;0
48377;6187;134;0;0;0;0;.00nan;0;0
48377;6870;146;29;7;3;4;.571;263000;0
48334;2756;131;55;10;1;9;.900;3600000;0
48334;3904;140;83;62;6;56;.903;3600000;0
48334;5455;140;0;0;0;0;.00nan;0;0
48334;5536;131;0;0;0;0;.00nan;0;0
48302;5454;141;45;27;4;23;.852;2232000;0
48302;5462;141;72;14;0;14;1.000;1368000;0
48302;5810;126;0;0;0;0;.00nan;0;0
48302;6495;126;82;13;0;13;1.000;3600000;0
48349;3894;147;75;21;1;20;.952;3600000;0
48349;5454;141;90;59;3;56;.949;3578000;0
48349;5462;141;0;0;0;0;.00nan;0;0
48349;5542;147;0;0;0;0;.00nan;0;0
48524;5367;127;0;0;0;0;.00nan;0;0
48524;5497;135;0;0;0;0;.00nan;0;0
48524;6539;127;81;41;3;38;.927;3563000;0
48524;6545;135;84;34;2;32;.941;3600000;0
48389;5405;145;0;0;0;0;.00nan;0;0
48389;5621;139;0;0;0;0;.00nan;0;0
48389;5673;145;47;14;2;12;.857;3547000;0
48389;5821;139;81;27;1;26;.963;3600000;0
48448;5451;151;66;31;3;28;.903;3600000;0
48448;5483;151;0;0;0;0;.00nan;0;0
48448;5970;150;68;19;1;18;.947;3600000;0
48448;6161;150;0;0;0;0;.00nan;0;0
48444;2896;133;50;29;4;25;.862;3546000;0
48444;3220;130;70;26;2;24;.923;3600000;0
48444;5541;133;0;0;0;0;.00nan;0;0
48444;5693;130;0;0;0;0;.00nan;0;0
48308;2756;131;44;23;4;19;.826;3600000;0
48308;5536;131;0;0;0;0;.00nan;0;0
48308;5810;126;0;0;0;0;.00nan;0;0
48308;6495;126;57;37;5;32;.865;3600000;0
48352;3894;147;0;0;0;0;.00nan;0;0
48352;5426;149;90;35;2;33;.943;3600000;0
48352;5542;147;66;30;3;27;.900;3553000;0
48352;5739;149;0;0;0;0;.00nan;0;0
48528;5497;135;51;17;3;14;.824;3600000;0
48528;5556;137;58;38;6;32;.842;2176000;0
48528;5723;137;40;20;4;16;.800;1424000;0
48528;6545;135;0;0;0;0;.00nan;0;0
48365;5398;143;68;20;2;18;.900;3544000;0
48365;5576;138;0;0;0;0;.00nan;0;0
48365;5631;138;82;28;1;27;.964;3600000;0
48365;5974;143;0;0;0;0;.00nan;0;0
48346;5434;134;79;29;2;27;.931;3600000;0
48346;5701;132;0;0;0;0;.00nan;0;0
48346;6187;134;0;0;0;0;.00nan;0;0
48346;6491;132;48;31;4;27;.871;3553000;0
48816;5451;151;50;21;3;18;.857;3556000;0
48816;5483;151;0;0;0;0;.00nan;0;0
48816;5621;139;88;29;1;28;.966;3600000;0
48816;5821;139;0;0;0;0;.00nan;0;0
48388;3904;140;0;0;0;0;.00nan;0;0
48388;5455;140;69;50;6;44;.880;3600000;0
48388;5666;142;0;0;0;0;.00nan;0;0
48388;5711;142;89;19;0;19;1.000;3600000;0
48381;3318;148;0;0;0;0;.00nan;0;0
48381;5732;146;60;48;6;42;.875;2427000;0
48381;6184;148;58;8;1;7;.875;3600000;0
48381;6870;146;28;15;4;11;.733;1173000;0
48366;5423;144;0;0;0;0;.00nan;0;0
48366;5454;141;89;53;4;49;.925;3600000;0
48366;5462;141;0;0;0;0;.00nan;0;0
48366;5602;144;94;17;0;17;1.000;3600000;0
48360;2896;133;58;16;2;14;.875;3600000;0
48360;5426;149;0;0;0;0;.00nan;0;0
48360;5541;133;0;0;0;0;.00nan;0;0
48360;5739;149;71;46;5;41;.891;3600000;0
48340;2756;131;0;0;0;0;.00nan;0;0
48340;3109;129;28;15;4;11;.733;612000;0
48340;5385;129;79;55;4;51;.927;2988000;0
48340;5536;131;34;7;3;4;.571;3600000;0
48463;3220;130;72;31;2;29;.935;3600000;0
48463;5481;128;39;38;6;32;.842;3600000;0
48463;5693;130;0;0;0;0;.00nan;0;0
48463;6936;128;0;0;0;0;.00nan;0;0
48385;5398;143;0;0;0;0;.00nan;0;0
48385;5405;145;61;29;3;26;.897;3600000;0
48385;5673;145;0;0;0;0;.00nan;0;0
48385;5974;143;44;33;5;28;.848;3600000;0
48465;5666;142;0;0;0;0;.00nan;0;0
48465;5711;142;71;13;1;12;.923;3600000;0
48465;5970;150;0;0;0;0;.00nan;0;0
48465;6161;150;98;49;2;47;.959;3600000;0
48321;5409;136;94;41;2;39;.951;3900000;0
48321;5810;126;67;27;2;25;.926;3900000;0
48321;6180;136;0;0;0;0;.00nan;0;0
48321;6495;126;0;0;0;0;.00nan;0;0
48355;5576;138;69;40;4;36;.900;3573000;0
48355;5631;138;0;0;0;0;.00nan;0;0
48355;5701;132;47;20;3;17;.850;3600000;0
48355;6491;132;0;0;0;0;.00nan;0;0
48393;3318;148;89;21;1;20;.952;3600000;0
48393;5451;151;0;0;0;0;.00nan;0;0
48393;5483;151;91;36;2;34;.944;3560000;0
48393;6184;148;0;0;0;0;.00nan;0;0
48753;5367;127;0;0;0;0;.00nan;0;0
48753;5556;137;0;0;0;0;.00nan;0;0
48753;5723;137;40;25;5;20;.800;3600000;0
48753;6539;127;53;26;4;22;.846;3600000;0
48367;3109;129;0;0;0;0;.00nan;0;0
48367;3894;147;70;33;3;30;.909;3549000;0
48367;5385;129;86;28;1;27;.964;3600000;0
48367;5542;147;0;0;0;0;.00nan;0;0
48409;5434;134;0;0;0;0;.00nan;0;0
48409;5576;138;0;0;0;0;.00nan;0;0
48409;5631;138;88;44;2;42;.955;3600000;0
48409;6187;134;71;23;1;22;.957;3600000;0
48536;3220;130;78;24;1;23;.958;3600000;0
48536;5409;136;0;0;0;0;.00nan;0;0
48536;5693;130;0;0;0;0;.00nan;0;0
48536;6180;136;76;40;4;36;.900;3600000;0
48376;3894;147;51;26;4;22;.846;3585000;0
48376;5542;147;0;0;0;0;.00nan;0;0
48376;5732;146;85;47;3;44;.936;3600000;0
48376;6870;146;0;0;0;0;.00nan;0;0
48351;3109;129;78;25;1;24;.960;3600000;0
48351;5385;129;0;0;0;0;.00nan;0;0
48351;5810;126;0;0;0;0;.00nan;0;0
48351;6495;126;69;25;2;23;.920;3576000;0
48373;5423;144;0;0;0;0;.00nan;0;0
48373;5556;137;92;32;1;31;.969;3600000;0
48373;5602;144;87;34;2;32;.941;3558000;0
48373;5723;137;0;0;0;0;.00nan;0;0
48455;2896;133;52;31;5;26;.839;3600000;0
48455;5367;127;0;0;0;0;.00nan;0;0
48455;5541;133;0;0;0;0;.00nan;0;0
48455;6539;127;78;30;2;28;.933;3600000;0
48364;5398;143;55;36;5;31;.861;3561000;0
48364;5405;145;0;0;0;0;.00nan;0;0
48364;5673;145;46;19;3;16;.842;3600000;0
48364;5974;143;0;0;0;0;.00nan;0;0
48564;5481;128;0;0;0;0;.00nan;0;0
48564;5556;137;0;0;0;0;.00nan;0;0
48564;5723;137;60;13;1;12;.923;3600000;0
48564;6936;128;51;35;5;30;.857;3600000;0
48358;5701;132;0;0;0;0;.00nan;0;0
48358;5810;126;42;36;6;30;.833;3227000;0
48358;6491;132;57;22;3;19;.864;3600000;0
48358;6495;126;53;3;0;3;1.000;373000;0
48512;5409;136;83;51;4;47;.922;3544000;0
48512;5576;138;54;25;3;22;.880;3600000;0
48512;5631;138;0;0;0;0;.00nan;0;0
48512;6180;136;0;0;0;0;.00nan;0;0
48431;3904;140;0;0;0;0;.00nan;0;0
48431;5451;151;85;34;2;32;.941;3600000;0
48431;5455;140;45;27;5;22;.815;3600000;0
48431;5483;151;0;0;0;0;.00nan;0;0
48371;5398;143;0;0;0;0;.00nan;0;0
48371;5454;141;0;0;0;0;.00nan;0;0
48371;5462;141;71;34;3;31;.912;3600000;0
48371;5974;143;83;25;1;24;.960;3600000;0
48480;2756;131;66;4;0;4;1.000;3600000;0
48480;5536;131;0;0;0;0;.00nan;0;0
48480;5621;139;0;0;0;0;.00nan;0;0
48480;5821;139;88;53;4;49;.925;3600000;0
48372;3220;130;72;46;3;43;.935;3600000;0
48372;5423;144;46;12;2;10;.833;3600000;0
48372;5602;144;0;0;0;0;.00nan;0;0
48372;5693;130;0;0;0;0;.00nan;0;0
48391;5426;149;61;49;6;43;.878;3600000;0
48391;5497;135;0;0;0;0;.00nan;0;0
48391;5739;149;0;0;0;0;.00nan;0;0
48391;6545;135;44;9;2;7;.778;3600000;0
48447;3109;129;76;40;4;36;.900;3600000;0
48447;5385;129;0;0;0;0;.00nan;0;0
48447;5666;142;0;0;0;0;.00nan;0;0
48447;5711;142;58;13;1;12;.923;3600000;0
48438;2896;133;86;22;0;22;1.000;2861000;0
48438;5434;134;69;34;4;30;.882;3900000;0
48438;5541;133;28;15;4;11;.733;1039000;0
48438;6187;134;0;0;0;0;.00nan;0;0
48419;5434;134;0;0;0;0;.00nan;0;0
48419;5454;141;73;33;3;30;.909;3600000;0
48419;5462;141;0;0;0;0;.00nan;0;0
48419;6187;134;54;29;4;25;.862;3600000;0
48825;3220;130;50;25;4;21;.840;3900000;0
48825;5693;130;0;0;0;0;.00nan;0;0
48825;5970;150;0;0;0;0;.00nan;0;0
48825;6161;150;80;41;4;37;.902;3900000;0
48408;3894;147;56;17;2;15;.882;3561000;0
48408;5481;128;100;35;0;35;1.000;3600000;0
48408;5542;147;0;0;0;0;.00nan;0;0
48408;6936;128;0;0;0;0;.00nan;0;0
48399;5621;139;89;19;0;19;1.000;3600000;0
48399;5732;146;54;43;5;38;.884;3600000;0
48399;5821;139;0;0;0;0;.00nan;0;0
48399;6870;146;0;0;0;0;.00nan;0;0
48386;2896;133;80;26;1;25;.962;3600000;0
48386;5398;143;37;33;6;27;.818;3600000;0
48386;5541;133;0;0;0;0;.00nan;0;0
48386;5974;143;0;0;0;0;.00nan;0;0
48370;3318;148;63;22;2;20;.909;3600000;0
48370;5810;126;0;0;0;0;.00nan;0;0
48370;6184;148;0;0;0;0;.00nan;0;0
48370;6495;126;71;50;5;45;.900;3600000;0
48361;5497;135;0;0;0;0;.00nan;0;0
48361;5701;132;0;0;0;0;.00nan;0;0
48361;6491;132;76;30;2;28;.933;3600000;0
48361;6545;135;53;23;3;20;.870;3586000;0
48541;5367;127;0;0;0;0;.00nan;0;0
48541;5409;136;94;45;2;43;.956;3600000;0
48541;6180;136;0;0;0;0;.00nan;0;0
48541;6539;127;51;23;4;19;.826;3516000;0
48433;3904;140;82;28;1;27;.964;3600000;0
48433;5451;151;32;27;6;21;.778;3600000;0
48433;5455;140;0;0;0;0;.00nan;0;0
48433;5483;151;0;0;0;0;.00nan;0;0
48497;5434;134;88;47;4;43;.915;3900000;0
48497;5481;128;75;49;4;45;.918;3900000;0
48497;6187;134;0;0;0;0;.00nan;0;0
48497;6936;128;0;0;0;0;.00nan;0;0
48397;3318;148;70;26;3;23;.885;3599000;0
48397;5423;144;0;0;0;0;.00nan;0;0
48397;5430;144;65;22;2;20;.909;3600000;0
48397;6184;148;0;0;0;0;.00nan;0;0
48401;2756;131;53;10;1;9;.900;3600000;0
48401;5536;131;0;0;0;0;.00nan;0;0
48401;5732;146;66;45;6;39;.867;2738000;0
48401;6870;146;39;8;2;6;.750;862000;0
48416;3109;129;47;30;5;25;.833;3600000;0
48416;5385;129;0;0;0;0;.00nan;0;0
48416;5576;138;0;0;0;0;.00nan;0;0
48416;5631;138;96;23;0;23;1.000;3600000;0
48395;5405;145;0;0;0;0;.00nan;0;0
48395;5497;135;0;0;0;0;.00nan;0;0
48395;5673;145;86;57;5;52;.912;3552000;0
48395;6545;135;46;17;4;13;.765;3600000;0
48451;5426;149;62;34;4;30;.882;3600000;0
48451;5451;151;0;0;0;0;.00nan;0;0
48451;5483;151;73;22;1;21;.955;3600000;0
48451;5739;149;0;0;0;0;.00nan;0;0
48439;3904;140;0;0;0;0;.00nan;0;0
48439;5455;140;89;53;3;50;.943;3550000;0
48439;5666;142;0;0;0;0;.00nan;0;0
48439;5711;142;52;10;2;8;.800;3600000;0
48442;3894;147;78;29;2;27;.931;2755000;0
48442;5367;127;25;17;5;12;.706;3600000;0
48442;5542;147;26;10;4;6;.600;841000;0
48442;6539;127;0;0;0;0;.00nan;0;0
48342;2756;131;72;20;1;19;.950;3600000;0
48342;5536;131;0;0;0;0;.00nan;0;0
48342;5621;139;26;6;3;3;.500;394000;0
48342;5821;139;44;39;6;33;.846;3206000;0
48826;5409;136;67;29;4;25;.862;3600000;0
48826;5970;150;26;17;5;12;.706;3557000;0
48826;6161;150;0;0;0;0;.00nan;0;0
48826;6180;136;0;0;0;0;.00nan;0;0
48561;5454;141;92;46;3;43;.935;3600000;0
48561;5462;141;0;0;0;0;.00nan;0;0
48561;5666;142;0;0;0;0;.00nan;0;0
48561;5711;142;58;13;1;12;.923;3600000;0
48423;5426;149;0;0;0;0;.00nan;0;0
48423;5576;138;0;0;0;0;.00nan;0;0
48423;5631;138;57;26;3;23;.885;3576000;0
48423;5739;149;72;26;2;24;.923;3600000;0
48375;5405;145;67;40;4;36;.900;3600000;0
48375;5673;145;0;0;0;0;.00nan;0;0
48375;5701;132;47;5;1;4;.800;440000;0
48375;6491;132;8;16;6;10;.625;3160000;0
48641;5454;141;0;0;0;0;.00nan;0;0
48641;5462;141;86;53;4;49;.925;3600000;0
48641;5701;132;70;19;1;18;.947;3600000;0
48641;6491;132;0;0;0;0;.00nan;0;0
48398;3318;148;64;14;1;13;.929;3600000;0
48398;5556;137;86;41;3;38;.927;3565000;0
48398;5723;137;0;0;0;0;.00nan;0;0
48398;6184;148;0;0;0;0;.00nan;0;0
48534;5367;127;0;0;0;0;.00nan;0;0
48534;5426;149;1;10;6;4;.400;942000;0
48534;5739;149;75;32;2;30;.938;2658000;0
48534;6539;127;48;14;2;12;.857;3600000;0
48533;3894;147;98;42;2;40;.952;3600000;0
48533;3904;140;0;0;0;0;.00nan;0;0
48533;5455;140;74;40;4;36;.900;3600000;0
48533;5542;147;0;0;0;0;.00nan;0;0
48432;3220;130;0;0;0;0;.00nan;0;0
48432;5423;144;65;28;3;25;.893;3600000;0
48432;5430;144;0;0;0;0;.00nan;0;0
48432;5693;130;72;38;4;34;.895;3574000;0
48400;5451;151;91;29;1;28;.966;3600000;0
48400;5483;151;0;0;0;0;.00nan;0;0
48400;5810;126;0;0;0;0;.00nan;0;0
48400;6495;126;69;28;2;26;.929;3591000;0
48472;2896;133;67;24;2;22;.917;3900000;0
48472;5541;133;0;0;0;0;.00nan;0;0
48472;5556;137;76;28;2;26;.929;3900000;0
48472;5723;137;0;0;0;0;.00nan;0;0
48414;5434;134;56;14;2;12;.857;3600000;0
48414;5732;146;44;41;6;35;.854;2331000;0
48414;6187;134;0;0;0;0;.00nan;0;0
48414;6870;146;85;30;1;29;.967;1269000;0
48411;5398;143;57;26;3;23;.885;3600000;0
48411;5497;135;0;0;0;0;.00nan;0;0
48411;5974;143;0;0;0;0;.00nan;0;0
48411;6545;135;84;17;0;17;1.000;3600000;0
48374;5454;141;67;38;3;35;.921;3568000;0
48374;5462;141;0;0;0;0;.00nan;0;0
48374;5810;126;61;12;1;11;.917;3600000;0
48374;6495;126;0;0;0;0;.00nan;0;0
48422;2756;131;86;26;1;25;.962;3600000;0
48422;5536;131;0;0;0;0;.00nan;0;0
48422;5666;142;0;0;0;0;.00nan;0;0
48422;5711;142;45;27;4;23;.852;3600000;0
48624;5367;127;34;24;5;19;.792;3600000;0
48624;5481;128;0;0;0;0;.00nan;0;0
48624;6539;127;0;0;0;0;.00nan;0;0
48624;6936;128;84;28;1;27;.964;3600000;0
48382;5701;132;0;0;0;0;.00nan;0;0
48382;5970;150;0;0;0;0;.00nan;0;0
48382;6161;150;40;32;5;27;.844;3600000;0
48382;6491;132;76;21;1;20;.952;3600000;0
48436;3318;148;99;21;0;21;1.000;3600000;0
48436;5576;138;0;0;0;0;.00nan;0;0
48436;5631;138;44;41;6;35;.854;3600000;0
48436;6184;148;0;0;0;0;.00nan;0;0
48402;3220;130;35;31;6;25;.806;3600000;0
48402;5405;145;44;17;3;14;.824;3600000;0
48402;5673;145;0;0;0;0;.00nan;0;0
48402;5693;130;0;0;0;0;.00nan;0;0
48493;5426;149;49;27;4;23;.852;3600000;0
48493;5621;139;77;26;1;25;.962;3600000;0
48493;5739;149;0;0;0;0;.00nan;0;0
48493;5821;139;0;0;0;0;.00nan;0;0
48551;3894;147;43;30;6;24;.800;2733000;0
48551;5542;147;51;2;0;2;1.000;867000;0
48551;5556;137;0;0;0;0;.00nan;0;0
48551;5723;137;82;30;2;28;.933;3600000;0
48392;3109;129;65;46;5;41;.891;3852000;0
48392;5385;129;0;0;0;0;.00nan;0;0
48392;5701;132;57;31;4;27;.871;3852000;0
48392;6491;132;0;0;0;0;.00nan;0;0
48412;3894;147;0;0;0;0;.00nan;0;0
48412;5398;143;49;32;5;27;.844;3900000;0
48412;5542;147;55;35;5;30;.857;3900000;0
48412;5974;143;0;0;0;0;.00nan;0;0
48487;3904;140;0;0;0;0;.00nan;0;0
48487;5454;141;91;51;4;47;.922;3900000;0
48487;5455;140;47;26;4;22;.846;3900000;0
48487;5462;141;0;0;0;0;.00nan;0;0
48404;5405;145;0;0;0;0;.00nan;0;0
48404;5497;135;0;0;0;0;.00nan;0;0
48404;5673;145;67;16;1;15;.938;3600000;0
48404;6545;135;69;34;4;30;.882;3600000;0
48488;2756;131;61;15;2;13;.867;3600000;0
48488;5409;136;69;45;5;40;.889;3600000;0
48488;5536;131;0;0;0;0;.00nan;0;0
48488;6180;136;0;0;0;0;.00nan;0;0
48418;5732;146;97;59;4;55;.932;3600000;0
48418;5970;150;0;0;0;0;.00nan;0;0
48418;6161;150;86;15;0;15;1.000;3600000;0
48418;6870;146;0;0;0;0;.00nan;0;0
48450;3109;129;0;0;0;0;.00nan;0;0
48450;5385;129;70;23;1;22;.957;3600000;0
48450;5426;149;0;0;0;0;.00nan;0;0
48450;5739;149;51;41;5;36;.878;3600000;0
48459;5423;144;60;19;2;17;.895;3600000;0
48459;5430;144;0;0;0;0;.00nan;0;0
48459;5451;151;0;0;0;0;.00nan;0;0
48459;5483;151;77;43;4;39;.907;3519000;0
48457;3318;148;80;33;2;31;.939;3829000;0
48457;5576;138;77;28;1;27;.964;3829000;0
48457;5631;138;0;0;0;0;.00nan;0;0
48457;6184;148;0;0;0;0;.00nan;0;0
48591;3904;140;100;26;0;26;1.000;3600000;0
48591;5367;127;0;0;0;0;.00nan;0;0
48591;5455;140;0;0;0;0;.00nan;0;0
48591;6539;127;97;33;1;32;.970;3545000;0
48429;3220;130;70;41;4;37;.902;3571000;0
48429;5434;134;70;30;2;28;.933;3600000;0
48429;5693;130;0;0;0;0;.00nan;0;0
48429;6187;134;0;0;0;0;.00nan;0;0
48396;5666;142;0;0;0;0;.00nan;0;0
48396;5711;142;58;19;2;17;.895;3600000;0
48396;5810;126;0;0;0;0;.00nan;0;0
48396;6495;126;80;50;5;45;.900;3600000;0
48471;2896;133;73;19;1;18;.947;3600000;0
48471;5541;133;0;0;0;0;.00nan;0;0
48471;5970;150;0;0;0;0;.00nan;0;0
48471;6161;150;56;32;4;28;.875;3600000;0
48935;5556;137;51;30;4;26;.867;3532000;0
48935;5621;139;81;33;2;31;.939;3600000;0
48935;5723;137;0;0;0;0;.00nan;0;0
48935;5821;139;0;0;0;0;.00nan;0;0
48473;2756;131;100;25;0;25;1.000;3600000;0
48473;5451;151;86;43;3;40;.930;3600000;0
48473;5483;151;0;0;0;0;.00nan;0;0
48473;5536;131;0;0;0;0;.00nan;0;0
48378;5701;132;0;0;0;0;.00nan;0;0
48378;5732;146;46;51;7;44;.863;3600000;0
48378;6491;132;55;11;1;10;.909;3600000;0
48378;6870;146;0;0;0;0;.00nan;0;0
48446;5423;144;0;0;0;0;.00nan;0;0
48446;5430;144;95;22;0;22;1.000;3600000;0
48446;5576;138;0;0;0;0;.00nan;0;0
48446;5631;138;69;39;4;35;.897;3600000;0
48482;3318;148;0;0;0;0;.00nan;0;0
48482;5481;128;0;0;0;0;.00nan;0;0
48482;6184;148;37;27;5;22;.815;3600000;0
48482;6936;128;97;40;1;39;.975;3600000;0
48479;3109;129;77;47;4;43;.915;3600000;0
48479;5385;129;0;0;0;0;.00nan;0;0
48479;5481;128;62;24;2;22;.917;3600000;0
48479;6936;128;0;0;0;0;.00nan;0;0
48578;5409;136;71;24;2;22;.917;3600000;0
48578;5434;134;0;0;0;0;.00nan;0;0
48578;6180;136;0;0;0;0;.00nan;0;0
48578;6187;134;77;24;1;23;.958;3600000;0
48704;5621;139;0;0;0;0;.00nan;0;0
48704;5810;126;51;22;3;19;.864;3600000;0
48704;5821;139;78;28;2;26;.929;3600000;0
48704;6495;126;0;0;0;0;.00nan;0;0
48406;5405;145;0;0;0;0;.00nan;0;0
48406;5666;142;60;26;3;23;.885;3600000;0
48406;5673;145;71;35;4;31;.886;3600000;0
48406;5711;142;0;0;0;0;.00nan;0;0
48454;2896;133;67;46;6;40;.870;3770000;0
48454;5497;135;0;0;0;0;.00nan;0;0
48454;5541;133;0;0;0;0;.00nan;0;0
48454;6545;135;27;19;5;14;.737;3770000;0
48468;5398;143;54;17;2;15;.882;3600000;0
48468;5454;141;88;42;3;39;.929;3600000;0
48468;5462;141;0;0;0;0;.00nan;0;0
48468;5974;143;0;0;0;0;.00nan;0;0
48794;3220;130;71;23;1;22;.957;3600000;0
48794;5693;130;0;0;0;0;.00nan;0;0
48794;5810;126;0;0;0;0;.00nan;0;0
48794;6495;126;94;34;2;32;.941;3600000;0
48639;5367;127;0;0;0;0;.00nan;0;0
48639;5409;136;0;0;0;0;.00nan;0;0
48639;6180;136;85;47;4;43;.915;3693000;0
48639;6539;127;61;24;3;21;.875;3693000;0
48547;5426;149;0;0;0;0;.00nan;0;0
48547;5576;138;0;0;0;0;.00nan;0;0
48547;5631;138;91;22;0;22;1.000;3600000;0
48547;5739;149;47;28;4;24;.857;3600000;0
48558;5434;134;76;20;1;19;.950;3600000;0
48558;5970;150;68;32;4;28;.875;3600000;0
48558;6161;150;0;0;0;0;.00nan;0;0
48558;6187;134;0;0;0;0;.00nan;0;0
48552;5621;139;0;0;0;0;.00nan;0;0
48552;5666;142;0;0;0;0;.00nan;0;0
48552;5711;142;47;17;3;14;.824;3900000;0
48552;5821;139;92;47;3;44;.936;3900000;0
48428;5405;145;0;0;0;0;.00nan;0;0
48428;5423;144;0;0;0;0;.00nan;0;0
48428;5430;144;61;24;3;21;.875;3600000;0
48428;5673;145;53;33;4;29;.879;3600000;0
48502;3109;129;82;43;4;39;.907;3600000;0
48502;5385;129;0;0;0;0;.00nan;0;0
48502;5451;151;0;0;0;0;.00nan;0;0
48502;5483;151;33;21;5;16;.762;3556000;0
48499;2756;131;65;28;3;25;.893;3567000;0
48499;3318;148;96;38;1;37;.974;3600000;0
48499;5536;131;0;0;0;0;.00nan;0;0
48499;6184;148;0;0;0;0;.00nan;0;0
48507;5398;143;0;0;0;0;.00nan;0;0
48507;5732;146;0;0;0;0;.00nan;0;0
48507;5974;143;73;10;0;10;1.000;3600000;0
48507;6870;146;80;46;4;42;.913;3600000;0
48415;5556;137;0;0;0;0;.00nan;0;0
48415;5701;132;0;0;0;0;.00nan;0;0
48415;5723;137;72;33;3;30;.909;3588000;0
48415;6491;132;55;11;1;10;.909;3600000;0
48553;5367;127;77;37;3;34;.919;3530000;0
48553;5497;135;0;0;0;0;.00nan;0;0
48553;6539;127;0;0;0;0;.00nan;0;0
48553;6545;135;80;22;1;21;.955;3600000;0
48475;5451;151;78;39;2;37;.949;3600000;0
48475;5454;141;55;37;5;32;.865;3600000;0
48475;5462;141;0;0;0;0;.00nan;0;0
48475;5483;151;0;0;0;0;.00nan;0;0
48504;3904;140;43;30;6;24;.800;3600000;0
48504;5455;140;0;0;0;0;.00nan;0;0
48504;5970;150;0;0;0;0;.00nan;0;0
48504;6161;150;62;15;1;14;.933;3600000;0
48469;3318;148;65;45;5;40;.889;3600000;0
48469;5666;142;0;0;0;0;.00nan;0;0
48469;5711;142;71;20;1;19;.950;3600000;0
48469;6184;148;0;0;0;0;.00nan;0;0
48477;2896;133;9;22;7;15;.682;3211000;0
48477;5541;133;47;5;1;4;.800;389000;0
48477;5576;138;0;0;0;0;.00nan;0;0
48477;5631;138;65;24;2;22;.917;3600000;0
48410;3109;129;0;0;0;0;.00nan;0;0
48410;5385;129;88;45;3;42;.933;3900000;0
48410;5810;126;76;27;3;24;.889;3900000;0
48410;6495;126;0;0;0;0;.00nan;0;0
48621;5409;136;78;24;1;23;.958;3600000;0
48621;5556;137;48;19;2;17;.895;3600000;0
48621;5723;137;0;0;0;0;.00nan;0;0
48621;6180;136;0;0;0;0;.00nan;0;0
48522;5426;149;73;38;3;35;.921;3826000;0
48522;5481;128;0;0;0;0;.00nan;0;0
48522;5739;149;0;0;0;0;.00nan;0;0
48522;6936;128;43;23;4;19;.826;3826000;0
48485;3220;130;40;30;5;25;.833;3557000;0
48485;3894;147;56;26;3;23;.885;3600000;0
48485;5542;147;0;0;0;0;.00nan;0;0
48485;5693;130;0;0;0;0;.00nan;0;0
48407;5405;145;69;38;3;35;.921;3900000;0
48407;5673;145;0;0;0;0;.00nan;0;0
48407;5701;132;62;32;3;29;.906;3900000;0
48407;6491;132;0;0;0;0;.00nan;0;0
48662;5423;144;81;26;1;25;.962;3600000;0
48662;5430;144;0;0;0;0;.00nan;0;0
48662;5481;128;65;32;4;28;.875;3600000;0
48662;6936;128;0;0;0;0;.00nan;0;0
48519;5398;143;0;0;0;0;.00nan;0;0
48519;5621;139;68;50;6;44;.880;3600000;0
48519;5821;139;0;0;0;0;.00nan;0;0
48519;5974;143;52;9;1;8;.889;3600000;0
48478;2756;131;57;11;1;10;.909;3600000;0
48478;2896;133;80;35;3;32;.914;3600000;0
48478;5536;131;0;0;0;0;.00nan;0;0
48478;5541;133;0;0;0;0;.00nan;0;0
48535;5434;134;82;43;3;40;.930;3600000;0
48535;5497;135;65;16;1;15;.938;3600000;0
48535;6187;134;0;0;0;0;.00nan;0;0
48535;6545;135;0;0;0;0;.00nan;0;0
48427;3220;130;87;29;1;28;.966;3600000;0
48427;5693;130;0;0;0;0;.00nan;0;0
48427;5701;132;0;0;0;0;.00nan;0;0
48427;6491;132;28;28;6;22;.786;3600000;0
48567;3904;140;0;0;0;0;.00nan;0;0
48567;5455;140;81;27;1;26;.963;3600000;0
48567;5970;150;0;0;0;0;.00nan;0;0
48567;6161;150;56;27;3;24;.889;3528000;0
48514;2756;131;59;20;2;18;.900;3550000;0
48514;5367;127;0;0;0;0;.00nan;0;0
48514;5536;131;0;0;0;0;.00nan;0;0
48514;6539;127;83;27;1;26;.963;3600000;0
48435;5405;145;0;0;0;0;.00nan;0;0
48435;5451;151;0;0;0;0;.00nan;0;0
48435;5483;151;57;26;3;23;.885;3566000;0
48435;5673;145;74;27;2;25;.926;3600000;0
48413;3109;129;64;41;4;37;.902;3600000;0
48413;5385;129;0;0;0;0;.00nan;0;0
48413;5810;126;0;0;0;0;.00nan;0;0
48413;6495;126;67;17;1;16;.941;3600000;0
48538;3318;148;79;29;2;27;.931;3600000;0
48538;5426;149;67;20;1;19;.950;2434000;0
48538;5739;149;28;14;4;10;.714;1166000;0
48538;6184;148;0;0;0;0;.00nan;0;0
48492;5454;141;45;23;4;19;.826;3600000;0
48492;5462;141;0;0;0;0;.00nan;0;0
48492;5732;146;0;0;0;0;.00nan;0;0
48492;6870;146;100;33;1;32;.970;3600000;0
48490;3894;147;89;40;2;38;.950;3585000;0
48490;5423;144;0;0;0;0;.00nan;0;0
48490;5430;144;73;19;1;18;.947;3600000;0
48490;5542;147;0;0;0;0;.00nan;0;0
48736;5434;134;0;0;0;0;.00nan;0;0
48736;5556;137;0;0;0;0;.00nan;0;0
48736;5723;137;86;29;1;28;.966;3600000;0
48736;6187;134;71;31;3;28;.903;3600000;0
48745;5398;143;53;19;3;16;.842;3600000;0
48745;5409;136;44;33;5;28;.848;3517000;0
48745;5974;143;0;0;0;0;.00nan;0;0
48745;6180;136;0;0;0;0;.00nan;0;0
48529;5621;139;0;0;0;0;.00nan;0;0
48529;5666;142;0;0;0;0;.00nan;0;0
48529;5711;142;74;9;0;9;1.000;3600000;0
48529;5821;139;71;48;5;43;.896;3600000;0
48495;2896;133;48;28;4;24;.857;3600000;0
48495;3894;147;64;37;5;32;.865;3569000;0
48495;5541;133;0;0;0;0;.00nan;0;0
48495;5542;147;0;0;0;0;.00nan;0;0
48733;5367;127;0;0;0;0;.00nan;0;0
48733;5398;143;50;32;5;27;.844;3900000;0
48733;5974;143;0;0;0;0;.00nan;0;0
48733;6539;127;51;28;5;23;.821;3900000;0
48403;5434;134;53;29;4;25;.862;3600000;0
48403;5701;132;97;23;0;23;1.000;3600000;0
48403;6187;134;0;0;0;0;.00nan;0;0
48403;6491;132;0;0;0;0;.00nan;0;0
48545;5576;138;0;0;0;0;.00nan;0;0
48545;5621;139;54;29;4;25;.862;3600000;0
48545;5631;138;46;38;6;32;.842;3541000;0
48545;5821;139;0;0;0;0;.00nan;0;0
48647;3220;130;49;34;5;29;.853;3600000;0
48647;5666;142;0;0;0;0;.00nan;0;0
48647;5693;130;0;0;0;0;.00nan;0;0
48647;5711;142;56;18;2;16;.889;3600000;0
48666;3318;148;50;10;2;8;.800;3600000;0
48666;5732;146;0;0;0;0;.00nan;0;0
48666;6184;148;0;0;0;0;.00nan;0;0
48666;6870;146;82;42;4;38;.905;3547000;0
48458;5405;145;0;0;0;0;.00nan;0;0
48458;5673;145;56;22;3;19;.864;3600000;0
48458;5970;150;100;29;0;29;1.000;3600000;0
48458;6161;150;0;0;0;0;.00nan;0;0
48842;5367;127;73;9;0;9;1.000;3600000;0
48842;5732;146;43;48;7;41;.854;2810000;0
48842;6539;127;0;0;0;0;.00nan;0;0
48842;6870;146;48;13;2;11;.846;790000;0
48441;5423;144;55;24;3;21;.875;3523000;0
48441;5430;144;0;0;0;0;.00nan;0;0
48441;5666;142;0;0;0;0;.00nan;0;0
48441;5711;142;66;21;1;20;.952;3600000;0
48513;2756;131;68;19;2;17;.895;3600000;0
48513;5536;131;0;0;0;0;.00nan;0;0
48513;5970;150;86;49;4;45;.918;3593000;0
48513;6161;150;0;0;0;0;.00nan;0;0
48437;5409;136;0;0;0;0;.00nan;0;0
48437;5810;126;0;0;0;0;.00nan;0;0
48437;6180;136;71;24;1;23;.958;3600000;0
48437;6495;126;11;22;7;15;.682;3600000;0
48426;5405;145;64;34;4;30;.882;3600000;0
48426;5481;128;0;0;0;0;.00nan;0;0
48426;5673;145;0;0;0;0;.00nan;0;0
48426;6936;128;48;44;5;39;.886;3566000;0
48500;3109;129;54;41;6;35;.854;2934000;0
48500;5385;129;67;9;0;9;1.000;634000;0
48500;5497;135;0;0;0;0;.00nan;0;0
48500;6545;135;34;19;4;15;.789;3600000;0
48494;5434;134;0;0;0;0;.00nan;0;0
48494;5451;151;38;20;4;16;.800;3536000;0
48494;5483;151;0;0;0;0;.00nan;0;0
48494;6187;134;92;47;2;45;.957;3600000;0
48483;3894;147;19;18;5;13;.722;3600000;0
48483;5542;147;0;0;0;0;.00nan;0;0
48483;5701;132;58;19;2;17;.895;3600000;0
48483;6491;132;0;0;0;0;.00nan;0;0
48496;3904;140;0;0;0;0;.00nan;0;0
48496;5454;141;0;0;0;0;.00nan;0;0
48496;5455;140;53;21;3;18;.857;3600000;0
48496;5462;141;80;30;2;28;.933;3600000;0
48476;3220;130;62;28;3;25;.893;3566000;0
48476;5426;149;80;33;2;31;.939;3600000;0
48476;5693;130;0;0;0;0;.00nan;0;0
48476;5739;149;0;0;0;0;.00nan;0;0
48489;2896;133;0;0;0;0;.00nan;0;0
48489;5541;133;56;19;2;17;.895;3600000;0
48489;5556;137;70;14;0;14;1.000;1750000;0
48489;5723;137;28;22;5;17;.773;1850000;0
48505;3904;140;54;33;5;28;.848;3600000;0
48505;5423;144;0;0;0;0;.00nan;0;0
48505;5430;144;49;27;4;23;.852;3600000;0
48505;5455;140;0;0;0;0;.00nan;0;0
48449;5621;139;0;0;0;0;.00nan;0;0
48449;5810;126;67;20;2;18;.900;3600000;0
48449;5821;139;58;25;3;22;.880;3600000;0
48449;6495;126;0;0;0;0;.00nan;0;0
48503;3318;148;72;25;1;24;.960;3600000;0
48503;5454;141;58;39;4;35;.897;3600000;0
48503;5462;141;0;0;0;0;.00nan;0;0
48503;6184;148;0;0;0;0;.00nan;0;0
48474;5481;128;80;26;2;24;.923;3600000;0
48474;5701;132;25;14;4;10;.714;2437000;0
48474;6491;132;22;17;5;12;.706;1163000;0
48474;6936;128;0;0;0;0;.00nan;0;0
48772;5367;127;63;20;2;18;.900;3600000;0
48772;5732;146;0;0;0;0;.00nan;0;0
48772;6539;127;0;0;0;0;.00nan;0;0
48772;6870;146;67;37;4;33;.892;3585000;0
48491;3220;130;0;0;0;0;.00nan;0;0
48491;3894;147;0;0;0;0;.00nan;0;0
48491;5542;147;62;37;4;33;.892;3600000;0
48491;5693;130;44;16;3;13;.813;3600000;0
48582;5576;138;0;0;0;0;.00nan;0;0
48582;5621;139;89;41;3;38;.927;3566000;0
48582;5631;138;59;19;2;17;.895;3600000;0
48582;5821;139;0;0;0;0;.00nan;0;0
48530;5405;145;0;0;0;0;.00nan;0;0
48530;5409;136;63;37;4;33;.892;3600000;0
48530;5673;145;67;29;3;26;.897;3600000;0
48530;6180;136;0;0;0;0;.00nan;0;0
48517;3109;129;57;30;4;26;.867;3600000;0
48517;5385;129;0;0;0;0;.00nan;0;0
48517;5970;150;0;0;0;0;.00nan;0;0
48517;6161;150;46;30;5;25;.833;3583000;0
48521;2756;131;72;18;1;17;.944;3600000;0
48521;5497;135;0;0;0;0;.00nan;0;0
48521;5536;131;0;0;0;0;.00nan;0;0
48521;6545;135;74;40;4;36;.900;3600000;0
48515;2896;133;83;32;2;30;.938;3600000;0
48515;5451;151;39;24;5;19;.792;3600000;0
48515;5483;151;0;0;0;0;.00nan;0;0
48515;5541;133;0;0;0;0;.00nan;0;0
48540;5426;149;0;0;0;0;.00nan;0;0
48540;5451;151;0;0;0;0;.00nan;0;0
48540;5483;151;93;31;1;30;.968;3600000;0
48540;5739;149;69;32;3;29;.906;3538000;0
48575;5556;137;0;0;0;0;.00nan;0;0
48575;5666;142;0;0;0;0;.00nan;0;0
48575;5711;142;45;12;2;10;.833;3600000;0
48575;5723;137;88;48;4;44;.917;3574000;0
48627;3318;148;53;23;3;20;.870;3600000;0
48627;5409;136;0;0;0;0;.00nan;0;0
48627;6180;136;46;34;5;29;.853;3540000;0
48627;6184;148;0;0;0;0;.00nan;0;0
48539;3109;129;0;0;0;0;.00nan;0;0
48539;5385;129;47;30;5;25;.833;3600000;0
48539;5576;138;60;19;2;17;.895;3600000;0
48539;5631;138;0;0;0;0;.00nan;0;0
48525;2756;131;62;14;1;13;.929;3600000;0
48525;5481;128;0;0;0;0;.00nan;0;0
48525;5536;131;0;0;0;0;.00nan;0;0
48525;6936;128;92;63;5;58;.921;3600000;0
48445;5405;145;62;46;5;41;.891;3812000;0
48445;5423;144;0;0;0;0;.00nan;0;0
48445;5430;144;38;33;6;27;.818;3812000;0
48445;5673;145;0;0;0;0;.00nan;0;0
48570;5426;149;78;45;4;41;.911;3557000;0
48570;5434;134;50;17;3;14;.824;3600000;0
48570;5739;149;0;0;0;0;.00nan;0;0
48570;6187;134;0;0;0;0;.00nan;0;0
48509;5454;141;75;42;5;37;.881;3600000;0
48509;5462;141;0;0;0;0;.00nan;0;0
48509;5497;135;0;0;0;0;.00nan;0;0
48509;6545;135;29;29;6;23;.793;3600000;0
48597;5556;137;48;24;3;21;.875;3600000;0
48597;5723;137;0;0;0;0;.00nan;0;0
48597;5810;126;0;0;0;0;.00nan;0;0
48597;6495;126;77;26;2;24;.923;3600000;0
48589;3904;140;0;0;0;0;.00nan;0;0
48589;5398;143;68;27;3;24;.889;3900000;0
48589;5455;140;90;43;3;40;.930;3900000;0
48589;5974;143;0;0;0;0;.00nan;0;0
48510;5423;144;0;0;0;0;.00nan;0;0
48510;5430;144;54;14;2;12;.857;3600000;0
48510;5732;146;80;48;4;44;.917;3600000;0
48510;6870;146;0;0;0;0;.00nan;0;0
48657;5666;142;0;0;0;0;.00nan;0;0
48657;5711;142;67;23;1;22;.957;3900000;0
48657;5970;150;96;38;1;37;.974;3900000;0
48657;6161;150;0;0;0;0;.00nan;0;0
48531;2756;131;53;9;1;8;.889;3600000;0
48531;5536;131;0;0;0;0;.00nan;0;0
48531;5556;137;0;0;0;0;.00nan;0;0
48531;5723;137;79;66;7;59;.894;3600000;0
48613;3109;129;75;44;5;39;.886;3600000;0
48613;5367;127;0;0;0;0;.00nan;0;0
48613;5385;129;0;0;0;0;.00nan;0;0
48613;6539;127;89;19;0;19;1.000;3600000;0
48518;2896;133;67;28;4;24;.857;3572000;0
48518;3220;130;86;41;3;38;.927;3600000;0
48518;5541;133;0;0;0;0;.00nan;0;0
48518;5693;130;0;0;0;0;.00nan;0;0
48556;5409;136;75;45;4;41;.911;3600000;0
48556;5701;132;0;0;0;0;.00nan;0;0
48556;6180;136;0;0;0;0;.00nan;0;0
48556;6491;132;70;20;1;19;.950;3600000;0
48619;3904;140;0;0;0;0;.00nan;0;0
48619;5455;140;38;18;4;14;.778;3600000;0
48619;5732;146;0;0;0;0;.00nan;0;0
48619;6870;146;91;40;3;37;.925;3600000;0
48543;5423;144;71;19;1;18;.947;3600000;0
48543;5430;144;0;0;0;0;.00nan;0;0
48543;5621;139;0;0;0;0;.00nan;0;0
48543;5821;139;81;37;2;35;.946;3583000;0
48581;5398;143;70;28;3;25;.893;3793000;0
48581;5970;150;57;32;4;28;.875;3793000;0
48581;5974;143;0;0;0;0;.00nan;0;0
48581;6161;150;0;0;0;0;.00nan;0;0
48554;5497;135;0;0;0;0;.00nan;0;0
48554;5576;138;0;0;0;0;.00nan;0;0
48554;5631;138;69;45;5;40;.889;3576000;0
48554;6545;135;57;18;3;15;.833;3600000;0
48555;5426;149;45;41;7;34;.829;3083000;0
48555;5454;141;41;15;3;12;.800;3600000;0
48555;5462;141;0;0;0;0;.00nan;0;0
48555;5739;149;47;6;1;5;.833;517000;0
48537;3109;129;0;0;0;0;.00nan;0;0
48537;5385;129;90;24;1;23;.958;3900000;0
48537;5481;128;100;31;1;30;.968;3900000;0
48537;6936;128;0;0;0;0;.00nan;0;0
48498;3894;147;48;21;3;18;.857;3600000;0
48498;5542;147;0;0;0;0;.00nan;0;0
48498;5810;126;0;0;0;0;.00nan;0;0
48498;6495;126;62;39;4;35;.897;3571000;0
48727;5409;136;92;60;5;55;.917;3600000;0
48727;5434;134;66;20;2;18;.900;3600000;0
48727;6180;136;0;0;0;0;.00nan;0;0
48727;6187;134;0;0;0;0;.00nan;0;0
48460;2756;131;65;12;1;11;.917;3600000;0
48460;5405;145;49;1;0;1;1.000;488000;0
48460;5536;131;0;0;0;0;.00nan;0;0
48460;5673;145;82;54;6;48;.889;3112000;0
48569;5454;141;0;0;0;0;.00nan;0;0
48569;5462;141;78;31;2;29;.935;3900000;0
48569;5556;137;0;0;0;0;.00nan;0;0
48569;5723;137;72;30;2;28;.933;3900000;0
48506;5576;138;47;26;4;22;.846;3600000;0
48506;5631;138;0;0;0;0;.00nan;0;0
48506;5701;132;0;0;0;0;.00nan;0;0
48506;6491;132;100;26;0;26;1.000;3600000;0
48532;5451;151;50;34;5;29;.853;3518000;0
48532;5481;128;0;0;0;0;.00nan;0;0
48532;5483;151;0;0;0;0;.00nan;0;0
48532;6936;128;76;40;3;37;.925;3600000;0
48831;5409;136;20;33;7;26;.788;2176000;0
48831;5666;142;0;0;0;0;.00nan;0;0
48831;5711;142;78;22;2;20;.909;3600000;0
48831;6180;136;57;22;2;20;.909;1424000;0
48612;3904;140;58;28;3;25;.893;3600000;0
48612;5398;143;17;29;7;22;.759;2113000;0
48612;5455;140;0;0;0;0;.00nan;0;0
48612;5974;143;39;12;3;9;.750;1487000;0
48501;3894;147;27;43;8;35;.814;3600000;0
48501;5542;147;0;0;0;0;.00nan;0;0
48501;5810;126;0;0;0;0;.00nan;0;0
48501;6495;126;58;21;2;19;.905;3600000;0
48526;2896;133;94;22;0;22;1.000;3600000;0
48526;5541;133;0;0;0;0;.00nan;0;0
48526;5556;137;52;49;7;42;.857;3600000;0
48526;5723;137;0;0;0;0;.00nan;0;0
48462;5405;145;76;11;0;11;1.000;3600000;0
48462;5426;149;0;0;0;0;.00nan;0;0
48462;5673;145;0;0;0;0;.00nan;0;0
48462;5739;149;68;45;5;40;.889;3600000;0
48550;3109;129;77;35;2;33;.943;3600000;0
48550;5367;127;0;0;0;0;.00nan;0;0
48550;5385;129;0;0;0;0;.00nan;0;0
48550;6539;127;56;21;3;18;.857;3549000;0
48516;3894;147;0;0;0;0;.00nan;0;0
48516;5497;135;0;0;0;0;.00nan;0;0
48516;5542;147;55;39;5;34;.872;3600000;0
48516;6545;135;51;9;1;8;.889;3600000;0
48560;5701;132;0;0;0;0;.00nan;0;0
48560;5732;146;82;55;5;50;.909;3600000;0
48560;6491;132;51;16;2;14;.875;3600000;0
48560;6870;146;0;0;0;0;.00nan;0;0
48549;5423;144;0;0;0;0;.00nan;0;0
48549;5430;144;33;28;5;23;.821;3537000;0
48549;5621;139;0;0;0;0;.00nan;0;0
48549;5821;139;65;27;3;24;.889;3600000;0
48559;2896;133;55;24;3;21;.875;3810000;0
48559;5541;133;0;0;0;0;.00nan;0;0
48559;5576;138;0;0;0;0;.00nan;0;0
48559;5631;138;79;36;2;34;.944;3810000;0
48527;2756;131;82;15;0;15;1.000;3600000;0
48527;3220;130;60;48;6;42;.875;3600000;0
48527;5536;131;0;0;0;0;.00nan;0;0
48527;5693;130;0;0;0;0;.00nan;0;0
48467;5405;145;0;0;0;0;.00nan;0;0
48467;5451;151;53;24;4;20;.833;3553000;0
48467;5483;151;0;0;0;0;.00nan;0;0
48467;5673;145;61;30;3;27;.900;3600000;0
48732;3318;148;59;36;5;31;.861;3541000;0
48732;5434;134;93;43;3;40;.930;3600000;0
48732;6184;148;0;0;0;0;.00nan;0;0
48732;6187;134;0;0;0;0;.00nan;0;0
48601;5367;127;55;22;3;19;.864;3600000;0
48601;5810;126;20;10;4;6;.600;1067000;0
48601;6495;126;70;26;2;24;.923;2533000;0
48601;6539;127;0;0;0;0;.00nan;0;0
48883;5666;142;0;0;0;0;.00nan;0;0
48883;5711;142;55;18;2;16;.889;3600000;0
48883;5970;150;60;46;6;40;.870;3600000;0
48883;6161;150;0;0;0;0;.00nan;0;0
48654;3220;130;79;24;1;23;.958;3600000;0
48654;5398;143;84;39;3;36;.923;3600000;0
48654;5693;130;0;0;0;0;.00nan;0;0
48654;5974;143;0;0;0;0;.00nan;0;0
48565;5434;134;19;23;6;17;.739;2601000;0
48565;5481;128;0;0;0;0;.00nan;0;0
48565;6187;134;40;9;2;7;.778;999000;0
48565;6936;128;64;23;2;21;.913;3600000;0
48568;3904;140;0;0;0;0;.00nan;0;0
48568;5455;140;78;51;5;46;.902;3600000;0
48568;5497;135;100;24;0;24;1.000;3600000;0
48568;6545;135;0;0;0;0;.00nan;0;0
48557;5426;149;0;0;0;0;.00nan;0;0
48557;5451;151;0;0;0;0;.00nan;0;0
48557;5483;151;75;20;1;19;.950;3600000;0
48557;5739;149;65;49;6;43;.878;3600000;0
48573;5454;141;79;33;3;30;.909;3900000;0
48573;5462;141;0;0;0;0;.00nan;0;0
48573;5621;139;45;16;3;13;.813;3900000;0
48573;5821;139;0;0;0;0;.00nan;0;0
48585;5454;141;83;48;5;43;.896;3764000;0
48585;5462;141;0;0;0;0;.00nan;0;0
48585;5666;142;0;0;0;0;.00nan;0;0
48585;5711;142;27;11;4;7;.636;3764000;0
48484;3904;140;0;0;0;0;.00nan;0;0
48484;5405;145;56;23;3;20;.870;3600000;0
48484;5455;140;50;28;4;24;.857;3559000;0
48484;5673;145;0;0;0;0;.00nan;0;0
48730;5423;144;0;0;0;0;.00nan;0;0
48730;5430;144;50;15;2;13;.867;3600000;0
48730;5434;134;44;35;6;29;.829;2337000;0
48730;6187;134;59;11;1;10;.909;1263000;0
48586;5409;136;53;33;5;28;.848;3600000;0
48586;5426;149;53;47;6;41;.872;3571000;0
48586;5739;149;0;0;0;0;.00nan;0;0
48586;6180;136;0;0;0;0;.00nan;0;0
48579;5451;151;66;18;1;17;.944;3600000;0
48579;5483;151;0;0;0;0;.00nan;0;0
48579;5732;146;72;45;5;40;.889;3600000;0
48579;6870;146;0;0;0;0;.00nan;0;0
48563;2896;133;99;42;1;41;.976;3600000;0
48563;5541;133;0;0;0;0;.00nan;0;0
48563;5810;126;0;0;0;0;.00nan;0;0
48563;6495;126;65;25;2;23;.920;3563000;0
48592;3220;130;88;26;1;25;.962;3590000;0
48592;5497;135;100;26;0;26;1.000;3600000;0
48592;5693;130;0;0;0;0;.00nan;0;0
48592;6545;135;0;0;0;0;.00nan;0;0
48544;2756;131;68;25;2;23;.920;3600000;0
48544;5536;131;0;0;0;0;.00nan;0;0
48544;5556;137;80;33;2;31;.939;1924000;0
48544;5723;137;11;27;8;19;.704;1676000;0
48611;3109;129;75;37;3;34;.919;3600000;0
48611;5385;129;0;0;0;0;.00nan;0;0
48611;5423;144;100;20;0;20;1.000;3600000;0
48611;5430;144;0;0;0;0;.00nan;0;0
48614;5434;134;80;21;1;20;.952;3600000;0
48614;5621;139;0;0;0;0;.00nan;0;0
48614;5821;139;79;39;4;35;.897;3600000;0
48614;6187;134;0;0;0;0;.00nan;0;0
48631;5367;127;0;0;0;0;.00nan;0;0
48631;5970;150;41;24;4;20;.833;1994000;0
48631;6161;150;56;22;2;20;.909;1606000;0
48631;6539;127;60;19;2;17;.895;3600000;0
48486;3318;148;74;18;1;17;.944;3600000;0
48486;5405;145;0;0;0;0;.00nan;0;0
48486;5673;145;80;45;5;40;.889;3600000;0
48486;6184;148;0;0;0;0;.00nan;0;0
48571;5426;149;0;0;0;0;.00nan;0;0
48571;5666;142;60;13;1;12;.923;3600000;0
48571;5711;142;0;0;0;0;.00nan;0;0
48571;5739;149;54;44;6;38;.864;3600000;0
48604;5398;143;89;21;0;21;1.000;3600000;0
48604;5576;138;0;0;0;0;.00nan;0;0
48604;5631;138;51;41;6;35;.854;3600000;0
48604;5974;143;0;0;0;0;.00nan;0;0
48596;5454;141;82;46;5;41;.891;3600000;0
48596;5462;141;0;0;0;0;.00nan;0;0
48596;5481;128;74;24;1;23;.958;3600000;0
48596;6936;128;0;0;0;0;.00nan;0;0
48752;3894;147;45;20;3;17;.850;3600000;0
48752;5542;147;0;0;0;0;.00nan;0;0
48752;5970;150;0;0;0;0;.00nan;0;0
48752;6161;150;66;38;4;34;.895;3600000;0
48580;3894;147;0;0;0;0;.00nan;0;0
48580;5497;135;19;19;5;14;.737;3544000;0
48580;5542;147;78;35;3;32;.914;3600000;0
48580;6545;135;0;0;0;0;.00nan;0;0
48628;2896;133;36;24;5;19;.792;3600000;0
48628;3318;148;56;26;4;22;.846;3600000;0
48628;5541;133;0;0;0;0;.00nan;0;0
48628;6184;148;0;0;0;0;.00nan;0;0
48645;5398;143;33;27;5;22;.815;3600000;0
48645;5621;139;0;0;0;0;.00nan;0;0
48645;5821;139;42;48;7;41;.854;3532000;0
48645;5974;143;0;0;0;0;.00nan;0;0
48511;5367;127;0;0;0;0;.00nan;0;0
48511;5405;145;41;42;7;35;.833;3600000;0
48511;5673;145;0;0;0;0;.00nan;0;0
48511;6539;127;49;26;4;22;.846;3600000;0
48546;2756;131;63;13;1;12;.923;3600000;0
48546;5481;128;0;0;0;0;.00nan;0;0
48546;5536;131;0;0;0;0;.00nan;0;0
48546;6936;128;91;45;2;43;.956;3547000;0
48584;5576;138;0;0;0;0;.00nan;0;0
48584;5631;138;52;24;3;21;.875;3583000;0
48584;5701;132;100;36;1;35;.972;3600000;0
48584;6491;132;0;0;0;0;.00nan;0;0
48599;3109;129;56;33;4;29;.879;3600000;0
48599;5385;129;0;0;0;0;.00nan;0;0
48599;5556;137;0;0;0;0;.00nan;0;0
48599;5723;137;67;19;1;18;.947;3600000;0
48615;3904;140;0;0;0;0;.00nan;0;0
48615;5455;140;56;39;5;34;.872;3600000;0
48615;5810;126;0;0;0;0;.00nan;0;0
48615;6495;126;84;18;0;18;1.000;3600000;0
48606;5426;149;0;0;0;0;.00nan;0;0
48606;5451;151;0;0;0;0;.00nan;0;0
48606;5483;151;97;17;0;17;1.000;3600000;0
48606;5739;149;44;40;6;34;.850;3600000;0
48674;3109;129;0;0;0;0;.00nan;0;0
48674;5385;129;50;34;5;29;.853;3600000;0
48674;5621;139;54;16;2;14;.875;3600000;0
48674;5821;139;0;0;0;0;.00nan;0;0
48675;5556;137;100;28;0;28;1.000;3600000;0
48675;5723;137;0;0;0;0;.00nan;0;0
48675;5970;150;58;19;2;17;.895;3549000;0
48675;6161;150;0;0;0;0;.00nan;0;0
48603;2896;133;52;16;2;14;.875;3600000;0
48603;5541;133;0;0;0;0;.00nan;0;0
48603;5732;146;74;49;5;44;.898;3600000;0
48603;6870;146;0;0;0;0;.00nan;0;0
48656;5409;136;100;40;0;40;1.000;3600000;0
48656;5451;151;58;21;3;18;.857;3600000;0
48656;5483;151;0;0;0;0;.00nan;0;0
48656;6180;136;0;0;0;0;.00nan;0;0
48658;3220;130;99;43;1;42;.977;3600000;0
48658;5398;143;0;0;0;0;.00nan;0;0
48658;5693;130;0;0;0;0;.00nan;0;0
48658;5974;143;64;26;2;24;.923;3543000;0
48618;5434;134;67;37;4;33;.892;3566000;0
48618;5810;126;0;0;0;0;.00nan;0;0
48618;6187;134;0;0;0;0;.00nan;0;0
48618;6495;126;71;26;2;24;.923;3600000;0
48588;5367;127;57;18;2;16;.889;3600000;0
48588;5454;141;36;28;5;23;.821;2449000;0
48588;5462;141;16;9;4;5;.556;1151000;0
48588;6539;127;0;0;0;0;.00nan;0;0
48626;3904;140;94;66;6;60;.909;3600000;0
48626;5423;144;52;20;3;17;.850;3600000;0
48626;5430;144;0;0;0;0;.00nan;0;0
48626;5455;140;0;0;0;0;.00nan;0;0
48692;3220;130;0;0;0;0;.00nan;0;0
48692;5409;136;77;34;2;32;.941;3573000;0
48692;5693;130;67;21;1;20;.952;3600000;0
48692;6180;136;0;0;0;0;.00nan;0;0
48548;2756;131;68;25;2;23;.920;3600000;0
48548;5497;135;0;0;0;0;.00nan;0;0
48548;5536;131;0;0;0;0;.00nan;0;0
48548;6545;135;57;34;4;30;.882;3545000;0
48602;5576;138;64;41;5;36;.878;3600000;0
48602;5631;138;0;0;0;0;.00nan;0;0
48602;5701;132;0;0;0;0;.00nan;0;0
48602;6491;132;98;30;1;29;.967;3600000;0
48600;5481;128;38;29;5;24;.828;3600000;0
48600;5732;146;48;9;1;8;.889;796000;0
48600;6870;146;35;29;6;23;.793;2719000;0
48600;6936;128;0;0;0;0;.00nan;0;0
48590;3318;148;52;26;4;22;.846;3546000;0
48590;3894;147;61;30;3;27;.900;3600000;0
48590;5542;147;0;0;0;0;.00nan;0;0
48590;6184;148;0;0;0;0;.00nan;0;0
48598;3220;130;36;24;5;19;.792;3512000;0
48598;5454;141;76;40;3;37;.925;3600000;0
48598;5462;141;0;0;0;0;.00nan;0;0
48598;5693;130;0;0;0;0;.00nan;0;0
48608;5367;127;0;0;0;0;.00nan;0;0
48608;5576;138;0;0;0;0;.00nan;0;0
48608;5631;138;53;47;7;40;.851;3600000;0
48608;6539;127;94;37;1;36;.973;3600000;0
48594;5497;135;0;0;0;0;.00nan;0;0
48594;5701;132;83;36;2;34;.944;3585000;0
48594;6491;132;0;0;0;0;.00nan;0;0
48594;6545;135;82;29;1;28;.966;3600000;0
48738;3109;129;93;32;1;31;.969;3671000;0
48738;5385;129;0;0;0;0;.00nan;0;0
48738;5409;136;0;0;0;0;.00nan;0;0
48738;6180;136;72;23;2;21;.913;3671000;0
48583;2756;131;64;15;1;14;.933;3600000;0
48583;3318;148;72;38;4;34;.895;3600000;0
48583;5536;131;0;0;0;0;.00nan;0;0
48583;6184;148;0;0;0;0;.00nan;0;0
48635;3894;147;0;0;0;0;.00nan;0;0
48635;3904;140;0;0;0;0;.00nan;0;0
48635;5455;140;69;27;2;25;.926;3600000;0
48635;5542;147;23;35;7;28;.800;3600000;0
48630;5481;128;0;0;0;0;.00nan;0;0
48630;5621;139;0;0;0;0;.00nan;0;0
48630;5821;139;78;44;4;40;.909;3578000;0
48630;6936;128;64;23;2;21;.913;3600000;0
48542;5405;145;0;0;0;0;.00nan;0;0
48542;5409;136;85;57;5;52;.912;3538000;0
48542;5673;145;54;23;3;20;.870;3600000;0
48542;6180;136;0;0;0;0;.00nan;0;0
48574;2756;131;0;0;0;0;.00nan;0;0
48574;5426;149;88;52;3;49;.942;3203000;0
48574;5536;131;61;12;1;11;.917;3600000;0
48574;5739;149;15;7;4;3;.429;397000;0
48648;5434;134;0;0;0;0;.00nan;0;0
48648;5810;126;0;0;0;0;.00nan;0;0
48648;6187;134;51;34;5;29;.853;3600000;0
48648;6495;126;84;26;2;24;.923;3600000;0
48622;5423;144;61;24;3;21;.875;3900000;0
48622;5430;144;0;0;0;0;.00nan;0;0
48622;5451;151;72;40;3;37;.925;3900000;0
48622;5483;151;0;0;0;0;.00nan;0;0
48819;5732;146;29;8;3;5;.625;387000;0
48819;5970;150;88;14;0;14;1.000;3600000;0
48819;6161;150;0;0;0;0;.00nan;0;0
48819;6870;146;78;47;5;42;.894;3213000;0
48633;2896;133;45;19;3;16;.842;3547000;0
48633;5541;133;0;0;0;0;.00nan;0;0
48633;5556;137;74;31;2;29;.935;3600000;0
48633;5723;137;0;0;0;0;.00nan;0;0
48593;3220;130;63;36;4;32;.889;3600000;0
48593;5576;138;62;26;3;23;.885;3600000;0
48593;5631;138;0;0;0;0;.00nan;0;0
48593;5693;130;0;0;0;0;.00nan;0;0
48642;3904;140;82;36;2;34;.944;3600000;0
48642;5398;143;54;24;3;21;.875;3575000;0
48642;5455;140;0;0;0;0;.00nan;0;0
48642;5974;143;0;0;0;0;.00nan;0;0
48625;3318;148;62;13;1;12;.923;3600000;0
48625;5810;126;82;28;2;26;.929;3544000;0
48625;6184;148;0;0;0;0;.00nan;0;0
48625;6495;126;0;0;0;0;.00nan;0;0
48577;2756;131;55;14;1;13;.929;3600000;0
48577;5536;131;0;0;0;0;.00nan;0;0
48577;5701;132;0;0;0;0;.00nan;0;0
48577;6491;132;86;60;5;55;.917;3600000;0
48664;5398;143;80;28;2;26;.929;3600000;0
48664;5621;139;0;0;0;0;.00nan;0;0
48664;5821;139;63;47;6;41;.872;3600000;0
48664;5974;143;0;0;0;0;.00nan;0;0
48609;5426;149;0;0;0;0;.00nan;0;0
48609;5732;146;97;33;1;32;.970;3600000;0
48609;5739;149;54;26;3;23;.885;3583000;0
48609;6870;146;0;0;0;0;.00nan;0;0
48637;5576;138;69;48;5;43;.896;3128000;0
48637;5631;138;41;11;3;8;.727;472000;0
48637;5666;142;0;0;0;0;.00nan;0;0
48637;5711;142;70;13;1;12;.923;3600000;0
48607;5405;145;48;22;4;18;.818;3553000;0
48607;5673;145;0;0;0;0;.00nan;0;0
48607;5970;150;72;34;3;31;.912;3600000;0
48607;6161;150;0;0;0;0;.00nan;0;0
48643;3894;147;0;0;0;0;.00nan;0;0
48643;5542;147;64;29;3;26;.897;3574000;0
48643;5556;137;0;0;0;0;.00nan;0;0
48643;5723;137;83;25;1;24;.960;3600000;0
48669;3109;129;56;30;4;26;.867;3600000;0
48669;5385;129;0;0;0;0;.00nan;0;0
48669;5454;141;63;18;1;17;.944;3600000;0
48669;5462;141;0;0;0;0;.00nan;0;0
48644;5423;144;46;31;4;27;.871;3543000;0
48644;5430;144;0;0;0;0;.00nan;0;0
48644;5497;135;0;0;0;0;.00nan;0;0
48644;6545;135;60;23;3;20;.870;3600000;0
48711;3318;148;56;17;2;15;.882;3600000;0
48711;5398;143;74;34;3;31;.912;3570000;0
48711;5974;143;0;0;0;0;.00nan;0;0
48711;6184;148;0;0;0;0;.00nan;0;0
48661;5367;127;0;0;0;0;.00nan;0;0
48661;5434;134;50;35;5;30;.857;3600000;0
48661;6187;134;0;0;0;0;.00nan;0;0
48661;6539;127;89;30;1;29;.967;3600000;0
48659;5481;128;73;47;4;43;.915;3600000;0
48659;5497;135;20;30;7;23;.767;3600000;0
48659;6545;135;0;0;0;0;.00nan;0;0
48659;6936;128;0;0;0;0;.00nan;0;0
48695;5409;136;67;43;5;38;.884;3600000;0
48695;5423;144;0;0;0;0;.00nan;0;0
48695;5430;144;100;21;0;21;1.000;3600000;0
48695;6180;136;0;0;0;0;.00nan;0;0
48636;5556;137;52;27;3;24;.889;3900000;0
48636;5723;137;0;0;0;0;.00nan;0;0
48636;5732;146;0;0;0;0;.00nan;0;0
48636;6870;146;73;35;3;32;.914;3900000;0
48605;3109;129;0;0;0;0;.00nan;0;0
48605;5385;129;60;38;4;34;.895;3600000;0
48605;5701;132;64;23;2;21;.913;3600000;0
48605;6491;132;0;0;0;0;.00nan;0;0
48687;5451;151;0;0;0;0;.00nan;0;0
48687;5454;141;0;0;0;0;.00nan;0;0
48687;5462;141;67;46;5;41;.891;3600000;0
48687;5483;151;89;33;2;31;.939;3600000;0
48672;2896;133;88;41;3;38;.927;3600000;0
48672;3904;140;0;0;0;0;.00nan;0;0
48672;5455;140;42;26;4;22;.846;3600000;0
48672;5541;133;0;0;0;0;.00nan;0;0
48576;5405;145;0;0;0;0;.00nan;0;0
48576;5666;142;0;0;0;0;.00nan;0;0
48576;5673;145;74;41;4;37;.902;3516000;0
48576;5711;142;80;24;2;22;.917;3600000;0
48638;5367;127;0;0;0;0;.00nan;0;0
48638;5481;128;0;0;0;0;.00nan;0;0
48638;6539;127;88;28;1;27;.964;3600000;0
48638;6936;128;78;44;4;40;.909;3600000;0
48684;2896;133;0;0;0;0;.00nan;0;0
48684;5541;133;71;32;3;29;.906;3552000;0
48684;5621;139;73;31;2;29;.935;3600000;0
48684;5821;139;0;0;0;0;.00nan;0;0
48702;3894;147;53;25;3;22;.880;3600000;0
48702;5451;151;96;34;2;32;.941;3600000;0
48702;5483;151;0;0;0;0;.00nan;0;0
48702;5542;147;0;0;0;0;.00nan;0;0
48610;5426;149;93;46;3;43;.935;3565000;0
48610;5666;142;0;0;0;0;.00nan;0;0
48610;5711;142;61;19;2;17;.895;3600000;0
48610;5739;149;0;0;0;0;.00nan;0;0
48677;5434;134;80;38;3;35;.921;3600000;0
48677;5810;126;0;0;0;0;.00nan;0;0
48677;6187;134;0;0;0;0;.00nan;0;0
48677;6495;126;62;29;4;25;.862;3543000;0
48814;5367;127;0;0;0;0;.00nan;0;0
48814;5701;132;0;0;0;0;.00nan;0;0
48814;6491;132;67;26;2;24;.923;3556000;0
48814;6539;127;79;24;1;23;.958;3600000;0
48683;5434;134;0;0;0;0;.00nan;0;0
48683;5451;151;0;0;0;0;.00nan;0;0
48683;5483;151;57;16;2;14;.875;3600000;0
48683;6187;134;40;33;5;28;.848;3600000;0
48617;5426;149;0;0;0;0;.00nan;0;0
48617;5739;149;73;30;2;28;.933;3572000;0
48617;5970;150;0;0;0;0;.00nan;0;0
48617;6161;150;90;23;0;23;1.000;3600000;0
48616;5405;145;65;25;3;22;.880;3600000;0
48616;5673;145;0;0;0;0;.00nan;0;0
48616;5732;146;39;36;6;30;.833;2541000;0
48616;6870;146;65;18;1;17;.944;1059000;0
48688;3220;130;68;18;1;17;.944;3600000;0
48688;5481;128;54;35;5;30;.857;3600000;0
48688;5693;130;0;0;0;0;.00nan;0;0
48688;6936;128;0;0;0;0;.00nan;0;0
48587;2756;131;93;18;0;18;1.000;3600000;0
48587;3109;129;55;51;7;44;.863;3600000;0
48587;5385;129;0;0;0;0;.00nan;0;0
48587;5536;131;0;0;0;0;.00nan;0;0
48703;3904;140;0;0;0;0;.00nan;0;0
48703;5398;143;32;32;6;26;.813;3359000;0
48703;5455;140;63;28;3;25;.893;3600000;0
48703;5974;143;51;2;0;2;1.000;241000;0
48706;5423;144;0;0;0;0;.00nan;0;0
48706;5430;144;61;16;2;14;.875;3600000;0
48706;5621;139;0;0;0;0;.00nan;0;0
48706;5821;139;84;32;3;29;.906;3581000;0
48660;5666;142;0;0;0;0;.00nan;0;0
48660;5711;142;62;15;1;14;.933;3600000;0
48660;5732;146;39;19;3;16;.842;1535000;0
48660;6870;146;41;23;4;19;.826;2065000;0
48696;5454;141;48;36;5;31;.861;3600000;0
48696;5462;141;0;0;0;0;.00nan;0;0
48696;5556;137;61;21;2;19;.905;3600000;0
48696;5723;137;0;0;0;0;.00nan;0;0
48634;5405;145;0;0;0;0;.00nan;0;0
48634;5451;151;65;17;1;16;.941;3600000;0
48634;5483;151;0;0;0;0;.00nan;0;0
48634;5673;145;45;39;6;33;.846;3600000;0
48595;2756;131;59;16;2;14;.875;3600000;0
48595;5536;131;0;0;0;0;.00nan;0;0
48595;5810;126;0;0;0;0;.00nan;0;0
48595;6495;126;73;44;5;39;.886;3600000;0
48629;3318;148;76;38;4;34;.895;3600000;0
48629;5701;132;32;35;6;29;.829;3298000;0
48629;6184;148;0;0;0;0;.00nan;0;0
48629;6491;132;48;0;0;0;.00nan;237000;0
48751;5409;136;23;30;7;23;.767;1678000;0
48751;5497;135;0;0;0;0;.00nan;0;0
48751;6180;136;63;21;2;19;.905;1922000;0
48751;6545;135;57;17;2;15;.882;3600000;0
48717;5621;139;20;10;4;6;.600;906000;0
48717;5666;142;0;0;0;0;.00nan;0;0
48717;5711;142;54;18;2;16;.889;3600000;0
48717;5821;139;66;36;4;32;.889;2694000;0
48667;2896;133;36;27;5;22;.815;3550000;0
48667;5367;127;0;0;0;0;.00nan;0;0
48667;5541;133;0;0;0;0;.00nan;0;0
48667;6539;127;45;24;4;20;.833;3600000;0
48685;5810;126;66;20;2;18;.900;3564000;0
48685;5970;150;0;0;0;0;.00nan;0;0
48685;6161;150;79;27;1;26;.963;3600000;0
48685;6495;126;0;0;0;0;.00nan;0;0
48646;3894;147;72;27;2;25;.926;3545000;0
48646;5426;149;100;43;1;42;.977;3600000;0
48646;5542;147;0;0;0;0;.00nan;0;0
48646;5739;149;0;0;0;0;.00nan;0;0
48686;3109;129;0;0;0;0;.00nan;0;0
48686;5385;129;100;41;2;39;.951;3900000;0
48686;5451;151;0;0;0;0;.00nan;0;0
48686;5483;151;98;37;2;35;.946;3900000;0
48691;2896;133;48;30;4;26;.867;3600000;0
48691;5434;134;67;30;3;27;.900;3600000;0
48691;5541;133;0;0;0;0;.00nan;0;0
48691;6187;134;0;0;0;0;.00nan;0;0
48632;3904;140;35;30;6;24;.800;3600000;0
48632;5405;145;93;32;1;31;.969;3600000;0
48632;5455;140;0;0;0;0;.00nan;0;0
48632;5673;145;0;0;0;0;.00nan;0;0
48653;5497;135;0;0;0;0;.00nan;0;0
48653;5701;132;0;0;0;0;.00nan;0;0
48653;6491;132;51;30;4;26;.867;3600000;0
48653;6545;135;68;20;1;19;.950;3600000;0
48714;3318;148;100;30;0;30;1.000;3600000;0
48714;5423;144;0;0;0;0;.00nan;0;0
48714;5430;144;43;39;6;33;.846;3600000;0
48714;6184;148;0;0;0;0;.00nan;0;0
48649;5576;138;0;0;0;0;.00nan;0;0
48649;5631;138;75;24;1;23;.958;3600000;0
48649;5970;150;82;30;2;28;.933;3589000;0
48649;6161;150;0;0;0;0;.00nan;0;0
48699;3109;129;81;24;2;22;.917;3600000;0
48699;5385;129;0;0;0;0;.00nan;0;0
48699;5454;141;69;42;4;38;.905;3514000;0
48699;5462;141;0;0;0;0;.00nan;0;0
48778;3894;147;79;28;2;26;.929;3600000;0
48778;5434;134;28;33;7;26;.788;3198000;0
48778;5542;147;0;0;0;0;.00nan;0;0
48778;6187;134;52;2;0;2;1.000;402000;0
48678;3904;140;0;0;0;0;.00nan;0;0
48678;5455;140;70;46;5;41;.891;3600000;0
48678;5666;142;0;0;0;0;.00nan;0;0
48678;5711;142;81;10;0;10;1.000;3600000;0
48655;3318;148;58;22;3;19;.864;3554000;0
48655;5556;137;87;38;2;36;.947;3600000;0
48655;5723;137;0;0;0;0;.00nan;0;0
48655;6184;148;0;0;0;0;.00nan;0;0
48673;5701;132;50;18;3;15;.833;3600000;0
48673;5810;126;0;0;0;0;.00nan;0;0
48673;6491;132;0;0;0;0;.00nan;0;0
48673;6495;126;55;44;6;38;.864;3600000;0
48889;5398;143;55;18;2;16;.889;3600000;0
48889;5621;139;57;40;6;34;.850;3600000;0
48889;5821;139;0;0;0;0;.00nan;0;0
48889;5974;143;0;0;0;0;.00nan;0;0
48694;5367;127;0;0;0;0;.00nan;0;0
48694;5481;128;0;0;0;0;.00nan;0;0
48694;6539;127;86;32;2;30;.938;3600000;0
48694;6936;128;44;20;4;16;.800;3550000;0
48651;5576;138;55;16;2;14;.875;3600000;0
48651;5631;138;0;0;0;0;.00nan;0;0
48651;5732;146;71;35;4;31;.886;3530000;0
48651;6870;146;0;0;0;0;.00nan;0;0
48834;3894;147;0;0;0;0;.00nan;0;0
48834;5542;147;93;35;1;34;.971;3600000;0
48834;5621;139;0;0;0;0;.00nan;0;0
48834;5821;139;58;27;3;24;.889;3532000;0
48741;5367;127;70;14;1;13;.929;3600000;0
48741;5454;141;0;0;0;0;.00nan;0;0
48741;5462;141;94;53;3;50;.943;3576000;0
48741;6539;127;0;0;0;0;.00nan;0;0
48712;2896;133;80;38;4;34;.895;3520000;0
48712;5423;144;0;0;0;0;.00nan;0;0
48712;5430;144;62;22;2;20;.909;3600000;0
48712;5541;133;0;0;0;0;.00nan;0;0
48721;5409;136;89;48;4;44;.917;3600000;0
48721;5497;135;0;0;0;0;.00nan;0;0
48721;6180;136;0;0;0;0;.00nan;0;0
48721;6545;135;87;16;0;16;1.000;3600000;0
48623;2756;131;75;22;1;21;.955;3900000;0
48623;5481;128;83;31;1;30;.968;3900000;0
48623;5536;131;0;0;0;0;.00nan;0;0
48623;6936;128;0;0;0;0;.00nan;0;0
48676;5556;137;53;24;4;20;.833;3600000;0
48676;5576;138;0;0;0;0;.00nan;0;0
48676;5631;138;44;36;5;31;.861;3548000;0
48676;5723;137;0;0;0;0;.00nan;0;0
48652;5398;143;0;0;0;0;.00nan;0;0
48652;5426;149;70;41;4;37;.902;3600000;0
48652;5739;149;0;0;0;0;.00nan;0;0
48652;5974;143;36;12;3;9;.750;3600000;0
48818;5556;137;0;0;0;0;.00nan;0;0
48818;5723;137;64;25;3;22;.880;3600000;0
48818;5810;126;0;0;0;0;.00nan;0;0
48818;6495;126;58;30;4;26;.867;3546000;0
48679;3894;147;45;20;3;17;.850;3555000;0
48679;5542;147;0;0;0;0;.00nan;0;0
48679;5576;138;79;31;2;29;.935;3600000;0
48679;5631;138;0;0;0;0;.00nan;0;0
48668;2756;131;77;9;0;9;1.000;3600000;0
48668;3109;129;0;0;0;0;.00nan;0;0
48668;5385;129;96;50;3;47;.940;3600000;0
48668;5536;131;0;0;0;0;.00nan;0;0
48640;5405;145;0;0;0;0;.00nan;0;0
48640;5434;134;80;33;3;30;.909;3600000;0
48640;5673;145;57;34;4;30;.882;3600000;0
48640;6187;134;0;0;0;0;.00nan;0;0
48769;3318;148;62;32;4;28;.875;3516000;0
48769;5398;143;86;35;2;33;.943;3600000;0
48769;5974;143;0;0;0;0;.00nan;0;0
48769;6184;148;0;0;0;0;.00nan;0;0
48665;5423;144;65;22;2;20;.909;3836000;0
48665;5426;149;0;0;0;0;.00nan;0;0
48665;5430;144;0;0;0;0;.00nan;0;0
48665;5739;149;63;31;3;28;.903;3836000;0
48689;5367;127;0;0;0;0;.00nan;0;0
48689;5701;132;0;0;0;0;.00nan;0;0
48689;6491;132;74;22;1;21;.955;3600000;0
48689;6539;127;44;25;4;21;.840;3600000;0
48715;2896;133;52;23;3;20;.870;3600000;0
48715;5481;128;0;0;0;0;.00nan;0;0
48715;5541;133;0;0;0;0;.00nan;0;0
48715;6936;128;100;26;0;26;1.000;3600000;0
48729;5497;135;0;0;0;0;.00nan;0;0
48729;5732;146;97;73;5;68;.932;3600000;0
48729;6545;135;62;14;1;13;.929;3600000;0
48729;6870;146;0;0;0;0;.00nan;0;0
48734;3220;130;100;27;0;27;1.000;3600000;0
48734;5693;130;0;0;0;0;.00nan;0;0
48734;5810;126;93;33;1;32;.970;3582000;0
48734;6495;126;0;0;0;0;.00nan;0;0
48763;5451;151;70;17;0;17;1.000;844000;0
48763;5483;151;41;36;6;30;.833;2751000;0
48763;5666;142;0;0;0;0;.00nan;0;0
48763;5711;142;40;20;4;16;.800;3600000;0
48707;3904;140;0;0;0;0;.00nan;0;0
48707;5409;136;41;30;5;25;.833;3563000;0
48707;5455;140;84;48;3;45;.938;3600000;0
48707;6180;136;0;0;0;0;.00nan;0;0
48757;3894;147;0;0;0;0;.00nan;0;0
48757;5454;141;58;24;3;21;.875;3600000;0
48757;5462;141;0;0;0;0;.00nan;0;0
48757;5542;147;65;39;4;35;.897;3541000;0
48671;2756;131;65;16;1;15;.938;3600000;0
48671;5367;127;68;40;5;35;.875;3600000;0
48671;5536;131;0;0;0;0;.00nan;0;0
48671;6539;127;0;0;0;0;.00nan;0;0
48785;5423;144;0;0;0;0;.00nan;0;0
48785;5430;144;74;8;0;8;1.000;3600000;0
48785;5970;150;0;0;0;0;.00nan;0;0
48785;6161;150;38;49;8;41;.837;3600000;0
48767;3220;130;88;35;2;33;.943;3804000;0
48767;3318;148;53;24;3;21;.875;3804000;0
48767;5693;130;0;0;0;0;.00nan;0;0
48767;6184;148;0;0;0;0;.00nan;0;0
48895;5434;134;0;0;0;0;.00nan;0;0
48895;5621;139;0;0;0;0;.00nan;0;0
48895;5821;139;62;38;5;33;.868;3546000;0
48895;6187;134;62;29;4;25;.862;3600000;0
48693;3894;147;57;31;3;28;.903;3600000;0
48693;5542;147;0;0;0;0;.00nan;0;0
48693;5576;138;66;37;4;33;.892;3600000;0
48693;5631;138;0;0;0;0;.00nan;0;0
48650;5405;145;58;24;3;21;.875;3600000;0
48650;5454;141;0;0;0;0;.00nan;0;0
48650;5462;141;82;46;4;42;.913;3580000;0
48650;5673;145;0;0;0;0;.00nan;0;0
48724;3109;129;65;33;3;30;.909;3523000;0
48724;3904;140;0;0;0;0;.00nan;0;0
48724;5385;129;0;0;0;0;.00nan;0;0
48724;5455;140;83;35;2;33;.943;3600000;0
48680;5556;137;86;37;2;35;.946;3600000;0
48680;5723;137;0;0;0;0;.00nan;0;0
48680;5970;150;24;25;6;19;.760;3600000;0
48680;6161;150;0;0;0;0;.00nan;0;0
48709;5398;143;44;31;5;26;.839;3600000;0
48709;5701;132;30;7;3;4;.571;510000;0
48709;5974;143;0;0;0;0;.00nan;0;0
48709;6491;132;43;22;3;19;.864;3043000;0
48670;5426;149;75;46;5;41;.891;3600000;0
48670;5497;135;0;0;0;0;.00nan;0;0
48670;5739;149;0;0;0;0;.00nan;0;0
48670;6545;135;71;22;1;21;.955;3600000;0
48726;5409;136;0;0;0;0;.00nan;0;0
48726;5732;146;15;13;5;8;.615;1146000;0
48726;6180;136;59;18;2;16;.889;3600000;0
48726;6870;146;75;26;2;24;.923;2454000;0
48708;5405;145;0;0;0;0;.00nan;0;0
48708;5454;141;80;53;6;47;.887;3600000;0
48708;5462;141;0;0;0;0;.00nan;0;0
48708;5673;145;88;15;0;15;1.000;3600000;0
48701;5621;139;68;34;3;31;.912;3562000;0
48701;5701;132;63;12;1;11;.917;3600000;0
48701;5821;139;0;0;0;0;.00nan;0;0
48701;6491;132;0;0;0;0;.00nan;0;0
48705;5481;128;0;0;0;0;.00nan;0;0
48705;5576;138;0;0;0;0;.00nan;0;0
48705;5631;138;78;20;1;19;.950;3600000;0
48705;6936;128;80;39;3;36;.923;3566000;0
48789;5367;127;0;0;0;0;.00nan;0;0
48789;5810;126;0;0;0;0;.00nan;0;0
48789;6495;126;60;33;4;29;.879;3600000;0
48789;6539;127;74;22;1;21;.955;3600000;0
48740;5497;135;89;38;1;37;.974;3600000;0
48740;5666;142;0;0;0;0;.00nan;0;0
48740;5711;142;72;30;2;28;.933;3553000;0
48740;6545;135;0;0;0;0;.00nan;0;0
48718;5409;136;69;29;2;27;.931;3600000;0
48718;5451;151;0;0;0;0;.00nan;0;0
48718;5483;151;93;20;0;20;1.000;3600000;0
48718;6180;136;0;0;0;0;.00nan;0;0
48722;3220;130;69;19;1;18;.947;3600000;0
48722;5693;130;0;0;0;0;.00nan;0;0
48722;5732;146;70;59;6;53;.898;3600000;0
48722;6870;146;0;0;0;0;.00nan;0;0
48836;5423;144;0;0;0;0;.00nan;0;0
48836;5430;144;23;18;5;13;.722;3600000;0
48836;5434;134;95;32;1;31;.969;3600000;0
48836;6187;134;0;0;0;0;.00nan;0;0
48713;3109;129;0;0;0;0;.00nan;0;0
48713;5385;129;53;36;5;31;.861;3588000;0
48713;5556;137;0;0;0;0;.00nan;0;0
48713;5723;137;40;21;4;17;.810;3600000;0
48681;2756;131;56;24;3;21;.875;3900000;0
48681;2896;133;100;49;3;46;.939;3900000;0
48681;5536;131;0;0;0;0;.00nan;0;0
48681;5541;133;0;0;0;0;.00nan;0;0
48720;5481;128;72;53;6;47;.887;2665000;0
48720;5666;142;63;13;1;12;.923;3600000;0
48720;5711;142;0;0;0;0;.00nan;0;0
48720;6936;128;44;18;3;15;.833;935000;0
48762;3904;140;97;42;2;40;.952;3600000;0
48762;5398;143;36;18;4;14;.778;3549000;0
48762;5455;140;0;0;0;0;.00nan;0;0
48762;5974;143;0;0;0;0;.00nan;0;0
48908;5621;139;0;0;0;0;.00nan;0;0
48908;5821;139;61;23;2;21;.913;3543000;0
48908;5970;150;0;0;0;0;.00nan;0;0
48908;6161;150;84;29;1;28;.966;3600000;0
48682;2896;133;0;0;0;0;.00nan;0;0
48682;5426;149;0;0;0;0;.00nan;0;0
48682;5541;133;75;33;3;30;.909;3900000;0
48682;5739;149;77;36;3;33;.917;3900000;0
48771;3318;148;0;0;0;0;.00nan;0;0
48771;5451;151;0;0;0;0;.00nan;0;0
48771;5483;151;66;28;3;25;.893;3600000;0
48771;6184;148;56;30;4;26;.867;3552000;0
48907;3220;130;100;42;2;40;.952;3600000;0
48907;3904;140;0;0;0;0;.00nan;0;0
48907;5455;140;48;35;4;31;.886;3521000;0
48907;5693;130;0;0;0;0;.00nan;0;0
48758;3109;129;98;46;2;44;.957;3600000;0
48758;5385;129;0;0;0;0;.00nan;0;0
48758;5409;136;82;26;1;25;.962;3600000;0
48758;6180;136;0;0;0;0;.00nan;0;0
48770;5732;146;71;69;7;62;.899;3600000;0
48770;5810;126;0;0;0;0;.00nan;0;0
48770;6495;126;54;8;1;7;.875;3600000;0
48770;6870;146;0;0;0;0;.00nan;0;0
48737;2756;131;53;29;4;25;.862;3563000;0
48737;5536;131;0;0;0;0;.00nan;0;0
48737;5576;138;88;43;3;40;.930;3600000;0
48737;5631;138;0;0;0;0;.00nan;0;0
48755;5481;128;87;39;2;37;.949;3885000;0
48755;5556;137;81;28;2;26;.929;3900000;0
48755;5723;137;0;0;0;0;.00nan;0;0
48755;6936;128;0;0;0;0;.00nan;0;0
48747;5434;134;71;21;1;20;.952;3600000;0
48747;5454;141;76;37;4;33;.892;3600000;0
48747;5462;141;0;0;0;0;.00nan;0;0
48747;6187;134;0;0;0;0;.00nan;0;0
48719;5556;137;0;0;0;0;.00nan;0;0
48719;5701;132;0;0;0;0;.00nan;0;0
48719;5723;137;71;40;3;37;.925;3600000;0
48719;6491;132;80;23;1;22;.957;3600000;0
48744;5409;136;0;0;0;0;.00nan;0;0
48744;5481;128;0;0;0;0;.00nan;0;0
48744;6180;136;56;20;3;17;.850;3600000;0
48744;6936;128;53;34;4;30;.882;3570000;0
48773;5423;144;0;0;0;0;.00nan;0;0
48773;5430;144;78;8;0;8;1.000;3600000;0
48773;5454;141;59;36;4;32;.889;1889000;0
48773;5462;141;39;35;6;29;.829;1711000;0
48791;3894;147;0;0;0;0;.00nan;0;0
48791;5451;151;0;0;0;0;.00nan;0;0
48791;5483;151;43;20;4;16;.800;3600000;0
48791;5542;147;65;47;5;42;.894;3575000;0
48690;5426;149;48;35;5;30;.857;3600000;0
48690;5739;149;0;0;0;0;.00nan;0;0
48690;5970;150;100;30;0;30;1.000;3600000;0
48690;6161;150;0;0;0;0;.00nan;0;0
48802;5367;127;0;0;0;0;.00nan;0;0
48802;5576;138;0;0;0;0;.00nan;0;0
48802;5631;138;90;29;1;28;.966;3600000;0
48802;6539;127;75;43;4;39;.907;3600000;0
48790;5497;135;0;0;0;0;.00nan;0;0
48790;5810;126;67;39;4;35;.897;3600000;0
48790;6495;126;0;0;0;0;.00nan;0;0
48790;6545;135;50;20;3;17;.850;3600000;0
48783;3904;140;0;0;0;0;.00nan;0;0
48783;5455;140;56;24;3;21;.875;3600000;0
48783;5621;139;49;44;7;37;.841;3600000;0
48783;5821;139;0;0;0;0;.00nan;0;0
48749;3109;129;0;0;0;0;.00nan;0;0
48749;5385;129;88;25;1;24;.960;3600000;0
48749;5732;146;0;0;0;0;.00nan;0;0
48749;6870;146;74;32;2;30;.938;3589000;0
48710;2896;133;53;34;5;29;.853;3516000;0
48710;5405;145;0;0;0;0;.00nan;0;0
48710;5541;133;0;0;0;0;.00nan;0;0
48710;5673;145;76;29;3;26;.897;3600000;0
48766;3220;130;80;34;3;31;.912;3575000;0
48766;5666;142;0;0;0;0;.00nan;0;0
48766;5693;130;0;0;0;0;.00nan;0;0
48766;5711;142;73;21;1;20;.952;3600000;0
48697;5426;149;0;0;0;0;.00nan;0;0
48697;5434;134;51;33;5;28;.848;3595000;0
48697;5739;149;86;46;4;42;.913;3600000;0
48697;6187;134;0;0;0;0;.00nan;0;0
48898;5451;151;36;32;6;26;.813;2895000;0
48898;5483;151;19;8;4;4;.500;705000;0
48898;5497;135;0;0;0;0;.00nan;0;0
48898;6545;135;83;40;3;37;.925;3600000;0
48809;3894;147;71;43;4;39;.907;3515000;0
48809;5367;127;75;30;2;28;.933;3600000;0
48809;5542;147;0;0;0;0;.00nan;0;0
48809;6539;127;0;0;0;0;.00nan;0;0
48723;2756;131;43;14;3;11;.786;3600000;0
48723;2896;133;50;46;6;40;.870;3313000;0
48723;5536;131;0;0;0;0;.00nan;0;0
48723;5541;133;56;4;0;4;1.000;287000;0
48801;5423;144;0;0;0;0;.00nan;0;0
48801;5430;144;77;27;2;25;.926;3900000;0
48801;5666;142;0;0;0;0;.00nan;0;0
48801;5711;142;77;28;2;26;.929;3900000;0
48774;5409;136;73;52;5;47;.904;3600000;0
48774;5576;138;71;28;2;26;.929;3600000;0
48774;5631;138;0;0;0;0;.00nan;0;0
48774;6180;136;0;0;0;0;.00nan;0;0
48796;3904;140;0;0;0;0;.00nan;0;0
48796;5455;140;92;37;2;35;.946;3549000;0
48796;5810;126;0;0;0;0;.00nan;0;0
48796;6495;126;94;24;0;24;1.000;3600000;0
48735;5481;128;63;40;4;36;.900;3593000;0
48735;5970;150;85;35;3;32;.914;3600000;0
48735;6161;150;0;0;0;0;.00nan;0;0
48735;6936;128;0;0;0;0;.00nan;0;0
48746;3318;148;63;22;2;20;.909;3600000;0
48746;5405;145;62;31;4;27;.871;3543000;0
48746;5673;145;0;0;0;0;.00nan;0;0
48746;6184;148;0;0;0;0;.00nan;0;0
48743;2756;131;0;0;0;0;.00nan;0;0
48743;3220;130;88;42;3;39;.929;3600000;0
48743;5536;131;97;21;0;21;1.000;3600000;0
48743;5693;130;0;0;0;0;.00nan;0;0
48775;5454;141;65;40;5;35;.875;3566000;0
48775;5462;141;0;0;0;0;.00nan;0;0
48775;5621;139;0;0;0;0;.00nan;0;0
48775;5821;139;28;15;4;11;.733;3600000;0
48739;5556;137;66;61;7;54;.885;3600000;0
48739;5701;132;0;0;0;0;.00nan;0;0
48739;5723;137;0;0;0;0;.00nan;0;0
48739;6491;132;69;15;1;14;.933;3600000;0
48780;5398;143;50;24;4;20;.833;3551000;0
48780;5434;134;0;0;0;0;.00nan;0;0
48780;5974;143;0;0;0;0;.00nan;0;0
48780;6187;134;80;37;3;34;.919;3600000;0
48765;3109;129;83;32;2;30;.938;3544000;0
48765;3220;130;0;0;0;0;.00nan;0;0
48765;5385;129;0;0;0;0;.00nan;0;0
48765;5693;130;83;22;1;21;.955;3600000;0
48833;5367;127;0;0;0;0;.00nan;0;0
48833;5497;135;0;0;0;0;.00nan;0;0
48833;6539;127;97;30;1;29;.967;3900000;0
48833;6545;135;95;33;1;32;.970;3900000;0
48760;5732;146;0;0;0;0;.00nan;0;0
48760;5970;150;0;0;0;0;.00nan;0;0
48760;6161;150;64;26;3;23;.885;3600000;0
48760;6870;146;47;40;6;34;.850;3600000;0
48742;5398;143;0;0;0;0;.00nan;0;0
48742;5701;132;58;23;2;21;.913;3600000;0
48742;5974;143;100;45;0;45;1.000;3600000;0
48742;6491;132;0;0;0;0;.00nan;0;0
48940;3904;140;69;30;4;26;.867;3616000;0
48940;5455;140;0;0;0;0;.00nan;0;0
48940;5621;139;73;36;3;33;.917;3616000;0
48940;5821;139;0;0;0;0;.00nan;0;0
48698;3318;148;90;15;0;15;1.000;3600000;0
48698;5426;149;40;37;6;31;.838;3600000;0
48698;5739;149;0;0;0;0;.00nan;0;0
48698;6184;148;0;0;0;0;.00nan;0;0
48958;5423;144;0;0;0;0;.00nan;0;0
48958;5430;144;41;23;4;19;.826;3515000;0
48958;5451;151;0;0;0;0;.00nan;0;0
48958;5483;151;97;48;2;46;.958;3600000;0
48731;2896;133;76;30;3;27;.900;3519000;0
48731;3894;147;0;0;0;0;.00nan;0;0
48731;5541;133;0;0;0;0;.00nan;0;0
48731;5542;147;78;24;1;23;.958;3600000;0
48900;5454;141;66;37;4;33;.892;3682000;0
48900;5462;141;0;0;0;0;.00nan;0;0
48900;5701;132;0;0;0;0;.00nan;0;0
48900;6491;132;40;21;5;16;.762;3682000;0
48782;5398;143;82;55;6;49;.891;3600000;0
48782;5666;142;0;0;0;0;.00nan;0;0
48782;5711;142;90;20;0;20;1.000;3600000;0
48782;5974;143;0;0;0;0;.00nan;0;0
48754;3318;148;65;28;3;25;.893;3542000;0
48754;5405;145;89;34;2;32;.941;3600000;0
48754;5673;145;0;0;0;0;.00nan;0;0
48754;6184;148;0;0;0;0;.00nan;0;0
48855;5423;144;0;0;0;0;.00nan;0;0
48855;5430;144;76;12;0;12;1.000;3600000;0
48855;5454;141;49;15;2;13;.867;721000;0
48855;5462;141;48;38;6;32;.842;2879000;0
48844;2896;133;24;11;4;7;.636;1190000;0
48844;5367;127;0;0;0;0;.00nan;0;0
48844;5541;133;36;14;3;11;.786;2410000;0
48844;6539;127;59;27;3;24;.889;3600000;0
48716;5426;149;0;0;0;0;.00nan;0;0
48716;5732;146;46;29;4;25;.862;3900000;0
48716;5739;149;54;27;4;23;.852;3900000;0
48716;6870;146;0;0;0;0;.00nan;0;0
48768;3318;148;83;27;1;26;.963;3600000;0
48768;5481;128;0;0;0;0;.00nan;0;0
48768;6184;148;0;0;0;0;.00nan;0;0
48768;6936;128;84;49;4;45;.918;3600000;0
48828;5576;138;0;0;0;0;.00nan;0;0
48828;5631;138;42;24;5;19;.792;3600000;0
48828;5810;126;0;0;0;0;.00nan;0;0
48828;6495;126;80;29;2;27;.931;3600000;0
48764;5451;151;65;21;1;20;.952;2418000;0
48764;5483;151;20;11;4;7;.636;1182000;0
48764;5701;132;96;37;1;36;.973;3600000;0
48764;6491;132;0;0;0;0;.00nan;0;0
48804;3220;130;56;30;4;26;.867;2217000;0
48804;5497;135;0;0;0;0;.00nan;0;0
48804;5693;130;72;10;0;10;1.000;1364000;0
48804;6545;135;58;21;3;18;.857;3600000;0
48761;5497;135;0;0;0;0;.00nan;0;0
48761;5970;150;41;36;6;30;.833;2542000;0
48761;6161;150;40;12;3;9;.750;1058000;0
48761;6545;135;97;24;0;24;1.000;3600000;0
48813;5398;143;100;38;1;37;.974;3600000;0
48813;5423;144;0;0;0;0;.00nan;0;0
48813;5430;144;75;31;2;29;.935;3575000;0
48813;5974;143;0;0;0;0;.00nan;0;0
48862;3109;129;0;0;0;0;.00nan;0;0
48862;3904;140;78;27;2;25;.926;3600000;0
48862;5385;129;55;22;3;19;.864;3600000;0
48862;5455;140;0;0;0;0;.00nan;0;0
48788;5621;139;0;0;0;0;.00nan;0;0
48788;5732;146;0;0;0;0;.00nan;0;0
48788;5821;139;54;21;3;18;.857;3900000;0
48788;6870;146;85;44;3;41;.932;3900000;0
48756;2756;131;0;0;0;0;.00nan;0;0
48756;5481;128;71;61;6;55;.902;3600000;0
48756;5536;131;68;15;1;14;.933;3600000;0
48756;6936;128;0;0;0;0;.00nan;0;0
48700;5426;149;81;30;2;28;.933;3600000;0
48700;5556;137;57;30;4;26;.867;3536000;0
48700;5723;137;0;0;0;0;.00nan;0;0
48700;5739;149;0;0;0;0;.00nan;0;0
48795;3220;130;82;32;2;30;.938;3600000;0
48795;5576;138;66;39;4;35;.897;3600000;0
48795;5631;138;0;0;0;0;.00nan;0;0
48795;5693;130;0;0;0;0;.00nan;0;0
48850;3894;147;80;52;5;47;.904;3600000;0
48850;5542;147;0;0;0;0;.00nan;0;0
48850;5666;142;0;0;0;0;.00nan;0;0
48850;5711;142;68;17;1;16;.941;3600000;0
48857;2896;133;100;36;1;35;.972;3600000;0
48857;5434;134;31;29;6;23;.793;3600000;0
48857;5541;133;0;0;0;0;.00nan;0;0
48857;6187;134;0;0;0;0;.00nan;0;0
48799;3904;140;0;0;0;0;.00nan;0;0
48799;5409;136;29;29;6;23;.793;3600000;0
48799;5455;140;74;36;2;34;.944;3600000;0
48799;6180;136;0;0;0;0;.00nan;0;0
48837;5423;144;68;26;2;24;.923;3600000;0
48837;5430;144;0;0;0;0;.00nan;0;0
48837;5701;132;62;12;0;12;1.000;742000;0
48837;6491;132;37;31;6;25;.806;2858000;0
48950;5454;141;55;45;6;39;.867;3183000;0
48950;5462;141;51;8;1;7;.875;417000;0
48950;5666;142;0;0;0;0;.00nan;0;0
48950;5711;142;66;4;0;4;1.000;3600000;0
48759;2756;131;39;22;5;17;.773;3600000;0
48759;5536;131;0;0;0;0;.00nan;0;0
48759;5810;126;54;10;1;9;.900;721000;0
48759;6495;126;39;33;6;27;.818;2879000;0
48781;3318;148;52;17;2;15;.882;3600000;0
48781;5621;139;30;29;6;23;.793;1846000;0
48781;5821;139;54;20;2;18;.900;1754000;0
48781;6184;148;0;0;0;0;.00nan;0;0
48793;3109;129;76;36;3;33;.917;3600000;0
48793;5385;129;0;0;0;0;.00nan;0;0
48793;5398;143;57;22;2;20;.909;3600000;0
48793;5974;143;0;0;0;0;.00nan;0;0
48776;5367;127;64;25;2;23;.920;3600000;0
48776;5556;137;85;43;3;40;.930;3600000;0
48776;5723;137;0;0;0;0;.00nan;0;0
48776;6539;127;0;0;0;0;.00nan;0;0
48797;2896;133;73;29;2;27;.931;3900000;0
48797;5541;133;0;0;0;0;.00nan;0;0
48797;5621;139;0;0;0;0;.00nan;0;0
48797;5821;139;89;38;2;36;.947;3900000;0
48830;5454;141;0;0;0;0;.00nan;0;0
48830;5462;141;60;45;5;40;.889;3600000;0
48830;5970;150;91;22;0;22;1.000;3600000;0
48830;6161;150;0;0;0;0;.00nan;0;0
48810;3109;129;45;44;7;37;.841;3600000;0
48810;5385;129;0;0;0;0;.00nan;0;0
48810;5497;135;0;0;0;0;.00nan;0;0
48810;6545;135;62;19;2;17;.895;3600000;0
48966;5666;142;0;0;0;0;.00nan;0;0
48966;5711;142;56;14;2;12;.857;3900000;0
48966;5732;146;97;52;2;50;.962;3900000;0
48966;6870;146;0;0;0;0;.00nan;0;0
48787;5398;143;58;5;0;5;1.000;546000;0
48787;5481;128;49;6;1;5;.833;614000;0
48787;5974;143;33;27;6;21;.778;3054000;0
48787;6936;128;36;31;6;25;.806;2986000;0
48786;5434;134;51;22;3;19;.864;3600000;0
48786;5556;137;30;23;5;18;.783;2668000;0
48786;5723;137;24;13;4;9;.692;932000;0
48786;6187;134;0;0;0;0;.00nan;0;0
48808;2756;131;0;0;0;0;.00nan;0;0
48808;3894;147;71;55;6;49;.891;3570000;0
48808;5536;131;47;22;4;18;.818;3600000;0
48808;5542;147;0;0;0;0;.00nan;0;0
48800;5367;127;0;0;0;0;.00nan;0;0
48800;5405;145;0;0;0;0;.00nan;0;0
48800;5673;145;100;26;0;26;1.000;3600000;0
48800;6539;127;56;29;3;26;.897;3600000;0
48861;3220;130;63;43;5;38;.884;3600000;0
48861;5693;130;0;0;0;0;.00nan;0;0
48861;5810;126;87;31;1;30;.968;3600000;0
48861;6495;126;0;0;0;0;.00nan;0;0
48792;5409;136;33;30;6;24;.800;3276000;0
48792;5701;132;71;31;2;29;.935;3600000;0
48792;6180;136;57;5;0;5;1.000;324000;0
48792;6491;132;0;0;0;0;.00nan;0;0
48820;5451;151;0;0;0;0;.00nan;0;0
48820;5483;151;59;23;3;20;.870;3600000;0
48820;5576;138;0;0;0;0;.00nan;0;0
48820;5631;138;68;37;4;33;.892;3595000;0
48779;3318;148;76;11;0;11;1.000;3600000;0
48779;5451;151;71;38;4;34;.895;3600000;0
48779;5483;151;0;0;0;0;.00nan;0;0
48779;6184;148;0;0;0;0;.00nan;0;0
48728;5405;145;0;0;0;0;.00nan;0;0
48728;5426;149;0;0;0;0;.00nan;0;0
48728;5673;145;47;24;4;20;.833;3600000;0
48728;5739;149;31;38;8;30;.789;3600000;0
48872;3904;140;0;0;0;0;.00nan;0;0
48872;5434;134;86;20;0;20;1.000;3447000;0
48872;5455;140;92;44;3;41;.932;3900000;0
48872;6187;134;26;5;3;2;.400;453000;0
48806;3894;147;0;0;0;0;.00nan;0;0
48806;5542;147;69;27;2;25;.926;3900000;0
48806;5970;150;76;31;2;29;.935;3900000;0
48806;6161;150;0;0;0;0;.00nan;0;0
48846;3318;148;96;17;0;17;1.000;3600000;0
48846;5454;141;39;42;7;35;.833;3600000;0
48846;5462;141;0;0;0;0;.00nan;0;0
48846;6184;148;0;0;0;0;.00nan;0;0
48953;3904;140;0;0;0;0;.00nan;0;0
48953;5455;140;81;28;3;25;.893;3900000;0
48953;5732;146;72;43;3;40;.930;3900000;0
48953;6870;146;0;0;0;0;.00nan;0;0
48877;2756;131;87;26;1;25;.962;3600000;0
48877;5367;127;81;30;2;28;.933;3548000;0
48877;5536;131;0;0;0;0;.00nan;0;0
48877;6539;127;0;0;0;0;.00nan;0;0
48803;3894;147;71;19;1;18;.947;3600000;0
48803;5426;149;71;50;6;44;.880;3120000;0
48803;5542;147;0;0;0;0;.00nan;0;0
48803;5739;149;43;3;1;2;.667;480000;0
48798;5434;134;0;0;0;0;.00nan;0;0
48798;5481;128;45;18;3;15;.833;1581000;0
48798;6187;134;58;22;3;19;.864;3600000;0
48798;6936;128;1;27;8;19;.704;2019000;0
48852;5576;138;0;0;0;0;.00nan;0;0
48852;5631;138;56;35;5;30;.857;3600000;0
48852;5666;142;0;0;0;0;.00nan;0;0
48852;5711;142;80;11;0;11;1.000;3600000;0
48805;5409;136;64;27;3;24;.889;3600000;0
48805;5556;137;70;25;2;23;.920;3600000;0
48805;5723;137;0;0;0;0;.00nan;0;0
48805;6180;136;0;0;0;0;.00nan;0;0
48979;3898;132;48;29;5;24;.828;3544000;0
48979;5522;132;0;0;0;0;.00nan;0;0
48979;5576;130;94;30;0;30;1.000;2750000;0
48979;5693;130;17;6;4;2;.333;850000;0
48981;3894;128;44;3;1;2;.667;3600000;0
48981;5367;147;0;0;0;0;.00nan;0;0
48981;5481;147;97;72;3;69;.958;3598000;0
48981;5723;128;0;0;0;0;.00nan;0;0
48983;3395;126;87;26;2;24;.923;3900000;0
48983;5542;126;0;0;0;0;.00nan;0;0
48983;5642;133;0;0;0;0;.00nan;0;0
48983;5721;133;62;17;2;15;.882;3900000;0
48985;5081;151;0;0;0;0;.00nan;0;0
48985;5405;135;90;35;2;33;.943;3600000;0
48985;5621;151;46;26;4;22;.846;3516000;0
48985;5970;135;0;0;0;0;.00nan;0;0
48987;5409;146;91;39;2;37;.949;3600000;0
48987;5434;148;0;0;0;0;.00nan;0;0
48987;5497;148;24;22;6;16;.727;3600000;0
48987;5732;146;0;0;0;0;.00nan;0;0
48989;5423;144;61;17;2;15;.882;3600000;0
48989;5454;144;0;0;0;0;.00nan;0;0
48989;5462;142;0;0;0;0;.00nan;0;0
48989;5711;142;74;33;4;29;.879;3545000;0
48991;4721;139;0;0;0;0;.00nan;0;0
48991;5426;138;0;0;0;0;.00nan;0;0
48991;5455;139;69;24;2;22;.917;3600000;0
48991;5776;138;65;36;5;31;.861;3600000;0
48993;3904;137;54;21;3;18;.857;3600000;0
48993;4988;137;0;0;0;0;.00nan;0;0
48993;5739;141;63;40;5;35;.875;3541000;0
48993;6161;141;0;0;0;0;.00nan;0;0
48995;2910;143;0;0;0;0;.00nan;0;0
48995;4960;140;53;27;3;24;.889;3600000;0
48995;5385;140;0;0;0;0;.00nan;0;0
48995;5539;143;70;51;6;45;.882;3600000;0
48997;5320;145;96;54;2;52;.963;3600000;0
48997;5541;145;0;0;0;0;.00nan;0;0
48997;6187;136;84;14;0;14;1.000;3600000;0
48997;6414;136;0;0;0;0;.00nan;0;0
48999;3896;134;100;26;0;26;1.000;3600000;0
48999;5673;134;0;0;0;0;.00nan;0;0
48999;6180;149;0;0;0;0;.00nan;0;0
48999;6936;149;40;20;3;17;.850;3600000;0
49001;5536;127;79;46;4;42;.913;3528000;0
49001;5556;129;64;25;2;23;.920;3600000;0
49001;5567;129;0;0;0;0;.00nan;0;0
49001;6184;127;0;0;0;0;.00nan;0;0
49003;5351;150;92;26;0;26;1.000;3600000;0
49003;5631;131;0;0;0;0;.00nan;0;0
49003;5821;150;0;0;0;0;.00nan;0;0
49003;6283;131;59;19;2;17;.895;3515000;0
49005;2910;143;62;10;0;10;1.000;281000;0
49005;5539;143;69;54;6;48;.889;3319000;0
49005;5631;131;18;14;5;9;.643;3600000;0
49005;6283;131;0;0;0;0;.00nan;0;0
49007;3395;126;11;12;5;7;.583;1076000;0
49007;5542;126;40;11;2;9;.818;2524000;0
49007;6187;136;47;25;4;21;.840;3600000;0
49007;6414;136;0;0;0;0;.00nan;0;0
49009;5462;142;0;0;0;0;.00nan;0;0
49009;5536;127;0;0;0;0;.00nan;0;0
49009;5711;142;66;33;3;30;.909;3585000;0
49009;6539;127;60;16;2;14;.875;3600000;0
49011;3894;128;65;22;2;20;.909;3794000;0
49011;5642;133;77;24;1;23;.958;3794000;0
49011;5721;133;0;0;0;0;.00nan;0;0
49011;5723;128;0;0;0;0;.00nan;0;0
49013;4960;140;56;43;5;38;.884;3600000;0
49013;5385;140;0;0;0;0;.00nan;0;0
49013;5556;129;71;20;1;19;.950;3600000;0
49013;5567;129;0;0;0;0;.00nan;0;0
49015;4721;139;0;0;0;0;.00nan;0;0
49015;5434;148;78;52;5;47;.904;3600000;0
49015;5455;139;44;11;2;9;.818;3600000;0
49015;5497;148;0;0;0;0;.00nan;0;0
49017;5320;145;29;27;6;21;.778;3600000;0
49017;5409;146;0;0;0;0;.00nan;0;0
49017;5541;145;0;0;0;0;.00nan;0;0
49017;5732;146;79;33;3;30;.909;3600000;0
49019;5423;144;80;20;1;19;.950;3600000;0
49019;5426;138;0;0;0;0;.00nan;0;0
49019;5454;144;0;0;0;0;.00nan;0;0
49019;5776;138;53;50;7;43;.860;3600000;0
49021;3904;137;49;34;6;28;.824;3600000;0
49021;4988;137;0;0;0;0;.00nan;0;0
49021;6180;149;70;21;1;20;.952;3600000;0
49021;6936;149;0;0;0;0;.00nan;0;0
49023;3896;134;42;7;2;5;.714;3600000;0
49023;5367;147;97;56;3;53;.946;3597000;0
49023;5481;147;0;0;0;0;.00nan;0;0
49023;5673;134;0;0;0;0;.00nan;0;0
49025;5351;150;89;18;0;18;1.000;3600000;0
49025;5405;135;55;32;4;28;.875;3600000;0
49025;5821;150;0;0;0;0;.00nan;0;0
49025;5970;135;0;0;0;0;.00nan;0;0
49027;3898;132;71;11;0;11;1.000;3600000;0
49027;5522;132;0;0;0;0;.00nan;0;0
49027;5739;141;48;28;4;24;.857;1192000;0
49027;6161;141;76;33;2;31;.939;2408000;0
49029;5081;151;55;32;4;28;.875;3600000;0
49029;5576;130;0;0;0;0;.00nan;0;0
49029;5621;151;0;0;0;0;.00nan;0;0
49029;5693;130;54;35;5;30;.857;3556000;0
49031;3395;126;74;11;0;11;1.000;3600000;0
49031;5367;147;65;26;2;24;.923;1298000;0
49031;5481;147;51;43;6;37;.860;2302000;0
49031;5542;126;0;0;0;0;.00nan;0;0
49033;5351;150;58;39;4;35;.897;3513000;0
49033;5821;150;0;0;0;0;.00nan;0;0
49033;6180;149;0;0;0;0;.00nan;0;0
49033;6936;149;66;23;2;21;.913;3600000;0
49035;5462;142;37;37;6;31;.838;3323000;0
49035;5536;127;76;16;1;15;.938;3600000;0
49035;5711;142;52;2;0;2;1.000;277000;0
49035;6539;127;0;0;0;0;.00nan;0;0
49037;3898;132;86;14;0;14;1.000;3600000;0
49037;5081;151;75;17;0;17;1.000;1179000;0
49037;5522;132;0;0;0;0;.00nan;0;0
49037;5621;151;21;25;6;19;.760;2421000;0
49039;3894;128;0;0;0;0;.00nan;0;0
49039;5642;133;0;0;0;0;.00nan;0;0
49039;5721;133;74;27;2;25;.926;3900000;0
49039;5723;128;65;26;2;24;.923;3900000;0
49041;3318;148;65;44;5;39;.886;3600000;0
49041;3904;137;0;0;0;0;.00nan;0;0
49041;4988;137;61;15;1;14;.933;3600000;0
49041;5434;148;0;0;0;0;.00nan;0;0
49043;3896;134;0;0;0;0;.00nan;0;0
49043;5673;134;41;11;2;9;.818;3600000;0
49043;5739;141;78;49;4;45;.918;3523000;0
49043;6161;141;0;0;0;0;.00nan;0;0
49045;2910;143;45;31;5;26;.839;3600000;0
49045;5426;138;50;21;3;18;.857;3600000;0
49045;5539;143;0;0;0;0;.00nan;0;0
49045;5776;138;0;0;0;0;.00nan;0;0
49047;5409;146;79;78;6;72;.923;3287000;0
49047;5576;130;44;7;2;5;.714;3600000;0
49047;5693;130;0;0;0;0;.00nan;0;0
49047;5732;146;59;7;0;7;1.000;313000;0
49049;5556;129;0;0;0;0;.00nan;0;0
49049;5567;129;55;31;3;28;.903;3600000;0
49049;6187;136;0;0;0;0;.00nan;0;0
49049;6414;136;98;25;0;25;1.000;3600000;0
49051;5423;144;59;15;1;14;.933;2185000;0
49051;5454;144;4;16;6;10;.625;1415000;0
49051;5631;131;0;0;0;0;.00nan;0;0
49051;6283;131;54;24;3;21;.875;3600000;0
49053;4960;140;0;0;0;0;.00nan;0;0
49053;5385;140;49;31;5;26;.839;3625000;0
49053;5405;135;0;0;0;0;.00nan;0;0
49053;5970;135;52;25;4;21;.840;3625000;0
49055;4721;139;74;24;1;23;.958;3600000;0
49055;5320;145;0;0;0;0;.00nan;0;0
49055;5455;139;0;0;0;0;.00nan;0;0
49055;5541;145;74;30;2;28;.933;3571000;0
49057;4960;140;42;22;4;18;.818;3600000;0
49057;5385;140;0;0;0;0;.00nan;0;0
49057;6187;136;0;0;0;0;.00nan;0;0
49057;6414;136;23;19;5;14;.737;3583000;0
49059;3898;132;73;21;1;20;.952;3600000;0
49059;5426;138;0;0;0;0;.00nan;0;0
49059;5522;132;0;0;0;0;.00nan;0;0
49059;5776;138;90;43;3;40;.930;3574000;0
49061;5367;147;0;0;0;0;.00nan;0;0
49061;5481;147;97;86;4;82;.953;3600000;0
49061;5576;130;0;0;0;0;.00nan;0;0
49061;5693;130;63;2;0;2;1.000;3600000;0
49063;3894;128;67;30;4;26;.867;3621000;0
49063;5723;128;0;0;0;0;.00nan;0;0
49063;6180;149;62;38;5;33;.868;3621000;0
49063;6936;149;0;0;0;0;.00nan;0;0
49065;2756;131;79;9;0;9;1.000;3600000;0
49065;4721;139;0;0;0;0;.00nan;0;0
49065;5455;139;70;49;5;44;.898;3600000;0
49065;5631;131;0;0;0;0;.00nan;0;0
49067;5462;142;0;0;0;0;.00nan;0;0
49067;5556;129;50;31;4;27;.871;3600000;0
49067;5567;129;0;0;0;0;.00nan;0;0
49067;5711;142;92;35;1;34;.971;3600000;0
49069;3896;134;42;27;4;23;.852;3600000;0
49069;5081;151;70;20;1;19;.950;3600000;0
49069;5621;151;0;0;0;0;.00nan;0;0
49069;5673;134;0;0;0;0;.00nan;0;0
49071;3395;126;51;35;5;30;.857;3600000;0
49071;5542;126;0;0;0;0;.00nan;0;0
49071;5642;133;51;16;2;14;.875;3600000;0
49071;5721;133;0;0;0;0;.00nan;0;0
49073;3318;148;100;40;2;38;.950;3600000;0
49073;3904;137;0;0;0;0;.00nan;0;0
49073;4988;137;63;32;4;28;.875;3553000;0
49073;5434;148;0;0;0;0;.00nan;0;0
49075;5423;144;64;24;3;21;.875;3521000;0
49075;5454;144;0;0;0;0;.00nan;0;0
49075;5536;127;92;33;1;32;.970;3600000;0
49075;6539;127;0;0;0;0;.00nan;0;0
49077;5351;150;45;19;3;16;.842;3600000;0
49077;5405;135;69;23;2;21;.913;3600000;0
49077;5821;150;0;0;0;0;.00nan;0;0
49077;5970;135;0;0;0;0;.00nan;0;0
49079;2910;143;63;32;4;28;.875;3600000;0
49079;5409;146;61;13;1;12;.923;1330000;0
49079;5497;143;0;0;0;0;.00nan;0;0
49079;5732;146;19;19;6;13;.684;2270000;0
49081;5320;145;46;12;2;10;.833;3600000;0
49081;5541;145;0;0;0;0;.00nan;0;0
49081;5739;141;0;0;0;0;.00nan;0;0
49081;6161;141;79;43;4;39;.907;3516000;0
49083;3896;134;0;0;0;0;.00nan;0;0
49083;5367;147;92;64;4;60;.938;3600000;0
49083;5481;147;0;0;0;0;.00nan;0;0
49083;5673;134;79;8;0;8;1.000;3600000;0
49085;3395;126;0;0;0;0;.00nan;0;0
49085;5542;126;65;22;2;20;.909;3544000;0
49085;5739;141;74;27;1;26;.963;3600000;0
49085;6161;141;0;0;0;0;.00nan;0;0
49087;5576;130;0;0;0;0;.00nan;0;0
49087;5642;133;0;0;0;0;.00nan;0;0
49087;5693;130;58;28;4;24;.857;3600000;0
49087;5721;133;26;35;7;28;.800;3600000;0
49089;3894;128;0;0;0;0;.00nan;0;0
49089;5409;146;84;71;6;65;.915;3600000;0
49089;5723;128;78;9;0;9;1.000;3600000;0
49089;5732;146;0;0;0;0;.00nan;0;0
49091;2756;131;80;12;0;12;1.000;3600000;0
49091;5351;150;0;0;0;0;.00nan;0;0
49091;5631;131;0;0;0;0;.00nan;0;0
49091;5821;150;52;60;8;52;.867;3600000;0
49093;3318;148;0;0;0;0;.00nan;0;0
49093;3898;132;0;0;0;0;.00nan;0;0
49093;5434;148;19;31;6;25;.806;3600000;0
49093;5522;132;80;40;3;37;.925;3600000;0
49095;4721;139;71;39;4;35;.897;3600000;0
49095;5405;135;0;0;0;0;.00nan;0;0
49095;5455;139;0;0;0;0;.00nan;0;0
49095;5970;135;67;16;1;15;.938;3600000;0
49097;5423;144;0;0;0;0;.00nan;0;0
49097;5454;144;62;13;1;12;.923;3600000;0
49097;6180;149;0;0;0;0;.00nan;0;0
49097;6936;149;69;31;3;28;.903;3528000;0
49099;3904;137;58;26;2;24;.923;3900000;0
49099;4988;137;0;0;0;0;.00nan;0;0
49099;5556;129;0;0;0;0;.00nan;0;0
49099;5567;129;98;31;2;29;.935;3900000;0
49101;4960;140;0;0;0;0;.00nan;0;0
49101;5385;140;44;12;2;10;.833;3600000;0
49101;5426;138;28;24;5;19;.792;3600000;0
49101;5776;138;0;0;0;0;.00nan;0;0
49103;5081;151;0;0;0;0;.00nan;0;0
49103;5320;145;0;0;0;0;.00nan;0;0
49103;5541;145;94;39;2;37;.949;3900000;0
49103;5621;151;60;14;2;12;.857;3900000;0
49105;2910;143;74;12;0;12;1.000;717000;0
49105;5497;143;62;46;6;40;.870;2883000;0
49105;6187;136;96;16;0;16;1.000;3600000;0
49105;6414;136;0;0;0;0;.00nan;0;0
49107;5462;142;29;30;6;24;.800;3600000;0
49107;5536;127;0;0;0;0;.00nan;0;0
49107;5711;142;0;0;0;0;.00nan;0;0
49107;6539;127;62;19;2;17;.895;3600000;0
49109;3904;137;0;0;0;0;.00nan;0;0
49109;4960;140;0;0;0;0;.00nan;0;0
49109;4988;137;57;16;1;15;.938;3600000;0
49109;5385;140;58;42;4;38;.905;3600000;0
49111;5576;130;80;32;2;30;.938;3600000;0
49111;5693;130;0;0;0;0;.00nan;0;0
49111;6180;149;0;0;0;0;.00nan;0;0
49111;6936;149;79;32;1;31;.969;3600000;0
49113;5405;135;85;37;2;35;.946;3900000;0
49113;5556;129;85;28;2;26;.929;3900000;0
49113;5567;129;0;0;0;0;.00nan;0;0
49113;5970;135;0;0;0;0;.00nan;0;0
49115;3318;148;60;10;1;9;.900;3600000;0
49115;5351;150;67;60;6;54;.900;3600000;0
49115;5434;148;0;0;0;0;.00nan;0;0
49115;5821;150;0;0;0;0;.00nan;0;0
49117;4721;139;0;0;0;0;.00nan;0;0
49117;5423;144;48;18;3;15;.833;3600000;0
49117;5454;144;0;0;0;0;.00nan;0;0
49117;5455;139;81;52;4;48;.923;3568000;0
49119;5451;151;0;0;0;0;.00nan;0;0
49119;5483;151;99;36;2;34;.944;3600000;0
49119;6187;136;38;16;3;13;.813;3586000;0
49119;6414;136;0;0;0;0;.00nan;0;0
49121;5462;142;63;19;1;18;.947;3035000;0
49121;5701;132;0;0;0;0;.00nan;0;0
49121;5711;142;28;6;3;3;.500;565000;0
49121;6491;132;100;33;0;33;1.000;3600000;0
49123;3395;126;72;8;0;8;1.000;3600000;0
49123;5367;147;0;0;0;0;.00nan;0;0
49123;5481;147;91;76;7;69;.908;3600000;0
49123;5542;126;0;0;0;0;.00nan;0;0
49125;2910;143;0;0;0;0;.00nan;0;0
49125;3896;134;0;0;0;0;.00nan;0;0
49125;5497;143;98;61;4;57;.934;3600000;0
49125;5673;134;35;13;3;10;.769;3600000;0
49127;2756;131;51;9;1;8;.889;3600000;0
49127;5409;146;0;0;0;0;.00nan;0;0
49127;5631;131;0;0;0;0;.00nan;0;0
49127;5732;146;84;72;6;66;.917;3600000;0
49129;5536;127;0;0;0;0;.00nan;0;0
49129;5739;141;58;44;6;38;.864;2745000;0
49129;6161;141;22;18;5;13;.722;855000;0
49129;6539;127;49;7;1;6;.857;3600000;0
49131;3894;128;0;0;0;0;.00nan;0;0
49131;5320;145;72;23;1;22;.957;3600000;0
49131;5541;145;0;0;0;0;.00nan;0;0
49131;5723;128;53;37;5;32;.865;3600000;0
49133;5426;138;39;6;2;4;.667;769000;0
49133;5642;133;70;15;1;14;.933;3600000;0
49133;5721;133;0;0;0;0;.00nan;0;0
49133;5776;138;51;42;6;36;.857;2831000;0
49135;5409;146;43;56;8;48;.857;3050000;0
49135;5732;146;54;6;0;6;1.000;550000;0
49135;6187;136;0;0;0;0;.00nan;0;0
49135;6414;136;63;14;1;13;.929;3600000;0
49137;5405;135;70;42;3;39;.929;3555000;0
49137;5462;142;0;0;0;0;.00nan;0;0
49137;5711;142;92;19;1;18;.947;3600000;0
49137;5970;135;0;0;0;0;.00nan;0;0
49139;5739;141;88;54;4;50;.926;3600000;0
49139;6161;141;0;0;0;0;.00nan;0;0
49139;6180;149;75;7;0;7;1.000;3600000;0
49139;6936;149;0;0;0;0;.00nan;0;0
49141;3896;134;55;20;2;18;.900;3900000;0
49141;4960;140;100;51;2;49;.961;3900000;0
49141;5385;140;0;0;0;0;.00nan;0;0
49141;5673;134;0;0;0;0;.00nan;0;0
49143;3395;126;59;53;7;46;.868;3600000;0
49143;5542;126;0;0;0;0;.00nan;0;0
49143;5576;130;0;0;0;0;.00nan;0;0
49143;5693;130;100;18;0;18;1.000;3600000;0
49145;5351;150;0;0;0;0;.00nan;0;0
49145;5451;151;0;0;0;0;.00nan;0;0
49145;5483;151;60;14;1;13;.929;3900000;0
49145;5821;150;82;32;1;31;.969;3900000;0
49147;2756;131;73;8;0;8;1.000;3600000;0
49147;5426;138;0;0;0;0;.00nan;0;0
49147;5631;131;0;0;0;0;.00nan;0;0
49147;5776;138;85;52;5;47;.904;3600000;0
49149;4721;139;0;0;0;0;.00nan;0;0
49149;5455;139;93;51;4;47;.922;3600000;0
49149;5701;132;0;0;0;0;.00nan;0;0
49149;6491;132;78;12;0;12;1.000;3600000;0
49151;3318;148;94;24;0;24;1.000;3600000;0
49151;3904;137;0;0;0;0;.00nan;0;0
49151;4988;137;46;40;5;35;.875;3600000;0
49151;5434;148;0;0;0;0;.00nan;0;0
49153;5423;144;52;24;3;21;.875;3600000;0
49153;5454;144;0;0;0;0;.00nan;0;0
49153;5642;133;78;31;2;29;.935;3600000;0
49153;5721;133;0;0;0;0;.00nan;0;0
49155;3894;128;67;4;0;4;1.000;3600000;0
49155;5367;147;33;9;3;6;.667;593000;0
49155;5481;147;88;77;5;72;.935;3007000;0
49155;5723;128;0;0;0;0;.00nan;0;0
49157;5320;145;66;42;4;38;.905;3570000;0
49157;5536;127;0;0;0;0;.00nan;0;0
49157;5541;145;0;0;0;0;.00nan;0;0
49157;6539;127;57;18;2;16;.889;3600000;0
49159;2910;143;74;29;2;27;.931;1821000;0
49159;5497;143;11;19;6;13;.684;1779000;0
49159;5556;129;49;7;1;6;.857;3600000;0
49159;5567;129;0;0;0;0;.00nan;0;0
